-------------------------------------------------------------------------S------------------------------?--X------------------------------------------------------------------------------------------------------------------------------------------------------------------------------------------------------------------------------------------------------------------------------------------------------------------------------------------------------------------------------------------------------------------------------------------------------------------------------------------------------------------------------------------------------------------------------------------------------------------------------------------------------------------------------------------------------------------------------------------------------------------------------------------------------------------------------------------------------------------------------------------------------------------------------------------------------------------------------------------------------------------------------------------------------------------------------------------------------------------------------------------------------------------------------------------------------------------------------------------------------------------------------------------------------------------------------------------------------------------------------------------------------------------------------------------------------------
-------------------------------------------------------------Q-XXXX-X-XXX-----XX-------------------------XXX------------------------------------------------------------------------------------------------------------------------------------------------------------------------------------------------------------------------------------------------------------------------------------------------------------------------------------------------------------------------------------------------------------------------------------------------------------------------------------------------------------------------------------------------------------------------------------------------------------------------------------------------------------------------------------------------------------------------------------------------------------------------------------------------------------------------------------------------------------------------------------------------------------------------------------------------------------------------------------------------------------------------------------------------------------------------------------------------------------------------------------------------------------------------------------------------------------------------------------------------------------------------------------------------------------------------------------------------------------------------------------------------------------------------------------------------------------
oo------------------------------------------------------SSSSSS------X----S--------oo-----oo----------SS--------S------------------------------------------------------------------------------------------------------------------------------------------------------------------------------------------------------SSSSSSSSSSSSSSSSSSSSSSSSSS--------------------------------------------------------------------------------------------------------------------------------------------------------------------------------------------------------------------------------------------------------------------------------------------------------------------------------------------------------------------------------------------------------SSSSSSSSSS----------------------------------------------------------------------------------------------------------------------------------------------------------------------------------------------------------------------------------------------------------------------------------------------------------------------------------------------------------------------------------------------SSSSSSSSSSSSSSSSSSSSSSSSSSSS--------------------------------------------------------------------------------------------------------------------------------------------SSSSSSSSSSSSSSSSSS--------------------------------------------------------------------------------------------------------------------------------------------------------------------------------------------------------------
-------------E---------------------------------------------------X-XXXXX------------o--------E--E--------------------------------------------------------------------------------------------------------------------------------------oo-----------------------------------------------------------------------------SSSSSSSSSSSSSSSSS-------------------------------------------------------------------------ooo---------------------------------------------------------------------------------E--E----------------------------------------------------------------------------------------------------------------------------------------------------------------------------------------------------------------------------------------------------S-----------------------------------------------------------------------------------------------------------------------------------------------------------------------------------------------------------------------------------------------------------------------------------------------------------------------------------------------------------------------------------------------------SSS----------------------------------------------------------------------------------------------------------------oo-------?---------------------------------------------------------------------------------------------------------------------------------o---------------------------------------------------------------------------------------------------------------------------------------
------------oXXXo----o------X---E---------------------------------XX-----XX-XXX-------------XXXXXXX-------X--------------------------------------------------------------------------------------------------------------------------------------oo-------oo-----------------------oo-------------------------------X--SSSSSSSSSSSSSSSS-------------------------------------------------------------------------------------------oo---------------------------------------------------------------XXXXXXX---------------------------------------------------------------------------------------------------------------------------------------------------------------------E------------------------------------------------------------E---------------S---E--------------------------------------------------------------------------------------------------------------------------------------------------------------------------------------------------------------------------------------------------E--------------------------------------------------------------------------------------------------------------------E----------E-------------SSSS------------------------------------------------------------------------------------------------------------------Eooo-------------------------------------------------S------------------------o------------oo----------------------------------------------------------------------------------------------ooE-----------------------------------------------------------E-----------------------
XX--------------------------S-SSSS---S------Q-Q--?-QQ-----------------------------SXo-------------------------SSSS--------------------------------------------SSSSS---------------------------Q-Q--------------SSS--SSSSSS---------------XXXX-----oo-----------------------------XXXXX------------------SSS------------SSSSSSSSSSSSSSSSS-QQS-----S?S------------------------SSSSS---------------------------------XXXX-----o-------------S-----SSS--SSS--?SSS---SSSSS-----------SQSSS--------SSS-----------------------S------SSSSS---------XXX----------------SSS------------------------SSS------------------------------------------------------S-------------------------SSQS-------------------SSS---?SSS--------------------E--------SSS---------S---S---SS------------?----------------------SSSS-----SSSS?SSS---?-----------------------------------------------ESSSS--------------o?-----------------------------------------------------------------------------------------------------------SSSSSS---SSSS?SSS-------SSS--SS----Q------SSS-----------------SSSS-------------------------S-------------------SSSSSSS--------SS?SSS-----SSSSSSSS---------S---SSS-------------S----------------------S----SSS--S--------------------------------------------SSSSSS----SS-------XXXXX------E------?--SSQS--------------------------SQQ----------------QQQQ---XXXoo---XXXX----------------------------------oo--------??SSS------SSS---SSSSS-----------o------------oo--------SS--SQS---?-----------------XX-------XXXX----o---o--------SSSS--------SSSSSSSSSSS---
-----XXXX-------XX--------o-------------------------------------------o--E----------XX--o------------oooo-------------------------------------------------------------------------------------------------------------------------XXXX---------------------------------------------------------------------------------S----------------------------------------------------------------------------------XXXXX------------------XXX-------------------------------------------------------------------------ooo----------------------------XXX------------------------------------------------------o---------------------------------------------------E--------------------------S--------------------------------------------<>------------------------S---SSS------------------------------------------------------------------------------------------------------------------------------XX------------------------------oo------ooo-----------------------------------------------------------------------------------------------------------------------------------------------------------------------------------------------------------------------S---SS----------------------------------------------------------------------------------------------------------XXX------------<>----------S----------------------------------------------------------------------XX-----------------------------------------XX---------------------XX----XX-------XX-------------------------------------------------------------------------------------------------
-------------------------XXX--SS---------------------------XXXXXXX---XXX-XX---------XX-XXX------------------------------------------------------------------------------------------------------E-------------------------------------------------------------------------------------X------------------------------S-S-------------------------------------------------------------------------------------------------------------------------------------------------------------------------------------------------------------------XXXX------------------------------------------E--------------------------------------------------------------<>-----------------------------------------------------------------------[]------------------------S---SS-------------------------------------------------------------------------------------------------------------------------------o--------------------------------------------------------------------------------------------------------------------------------------------------------------------------------------------------------------------E-------------------------------------------------S-------------------------------------------------------------------------------------------------------------------------[]----------S---------------------------------------------------------------------oo-----------------------------------------------------------------o-----------------------------------------------------------------------------------------------------------------
------------------------------SS--------------------------------------------oo-------------------------------------------------------------------------o--------------------------------E---E--<>-----------------------------E--------------------XXX----------E-------E------------XXX---------E---------------------So---------------------------------------------------SSSSSS----------------------SSS----------------XXXX--------------E----------------------------S--------------------------------------------------------------XXXXXX-----QSSSSSS------------------------E----<>---------------------------------E----------------------------[]-------------E---------------------E---------------------------E-------[]---------------E--------SoooSS--------o---------------------E---------------X--S--------------E------------------------E---------------SQ--------------------------------------------------------SSSSSS------------------SS-SSSS------------------------------------------------------------------------------------------EE----------------------------E--SSSSSSSS------------------------------------------------------------ooo--SS---------S--S---------------------------------XSS-SSS-------------------o---oo-----------------------E------------------[]-----------?------------ooo----------------------o---------------------------------------------oo-----------S---XXX------SSSSSS-----------------------------------------XXX------------------------SSSSSSSSSS--------------------------------E-----------------------
XXX-----XXXXX-----------------SSSS--SS-----Q--Q--Q-QQ--Q-------------------------------------------------------S--------QQQQQ-----------------------------XXXXX-XXXS-------------SSS---<>--<>--[]-------------------S--------<>---------XXXX-XXXX--------------<>------<>-----------XXX---------<>------SS-----E-------SSS--SSSSS---------QSSSS--SS-------ooo-------S-S----------------------------------------------XXXX-------------------<>------QQ?-----------SSS----------EQQ?--Q-Q------S---E------------------E-SQ---XXXXX-S------XXXXXX--------------------------------X--<>----[]-------E-E-----E-------E--------<>-----------------E-------E--[]------------<>----Q-SS---o--------<>------SQS-----------------<>--X--SS[]-----E--S-----<>---EX---SSS-SS-----S------------S----------<>---S----------XX-----Q--Q-------<>-----------------------<>------------X----------XXXXX-------S------Q---------Q-Q---S-----X-------------------E--S------------------------------------X--------------SSS----S?S-------SSE--Q------QQQQ--QQQQ---------------------XX---------Q------------<>-----------------------E--?SQQ?SSQQQQ--------S-------S----------------SS---SS-S--S---SS--------S---------E----------------XX---------XXXX-------------------------------S--------<>------------S-----XX---------SSSSS-------------------------ESSS---------------QQQQ--------XXXXXXXXXX-------------------------------------------------------XXXX---S-------------XXX------------------SS--S?S---------------------XXXX---XXXXXXXXX-------XXX----SS?S-----XX--XX-XX----S---
-----------------------------S--------------------------------o-----------------------------------------------SS-----------------------------------------------------------------------[]--[]--[]----------------------------[]--------------------------------[]------[]----------XXXX---------[]------------<>-XXX------SSSSSSS---------------------------E----E--E-----------------------------------------------------------------------[]-----------------XE-----E---------------------------------------------<>-S----------------XXXXXXX-------------------------------XX--[]----[]------<><>----<>----------------[]------------------------<>--[]-------E----[]--------------------[]-----------------------X--[]--X----------<>--------[]--<>X--------------------------------------[]-------------XXX----------------[]-----------------------[]-----E-----XX---------------------------------------------------X------------------<>--------------------------------------XX--E---------------------------------------------------------------------X-XX----------------------[]----------------------<>--------------------------------------------------------------------------------<>--------------EXXX---------------E-------------------------------------[]------------------XX--XX------------------E-----------------------------------------------------------------S-S---------------XX--X--------S-------------------------------------------------------------------------------------------------------------------E-------XXX--XX-XX--------
--------------------XXX----------------SS--------------------XXXXX--------------------------------------------SS-----------------------------------------------------------------------[]--[]--------------------------------[]--------------------------------[]------[]---------XXXXXX--------[]------------[]-XXX------SSSSSSS--------------------------XXX----------E-o-----------------------------------------------------------------[]-----X-----------X----------------------------------------------------[]-----------------XXXXXXXX------------------------------XXX--[]----[]------[][]----[]----------------[]------------------------[]--[-------<>----[]--------------------[]----------------------X--X[]--X----------[]--------[]--[]X--------------------------------------[]------------XXXX----------------[]-----------------------[]----------XXX---------------------------------------------------XXX----------------[]-------------------------------------XXX------------------------------------------------------------------------X-XX----------------------[]----------------------[]-------------------------------------------X------------------------------------[]--------------XXXX--------------<>-------------------------------------[]-----------------XXX--XXXX---------------<>----<>---------------------------------------------------------E-----------------XXXXXXXX------------------------------------X-------------------------------------------E-------------------------------------------------XXXX--XX-XX--------
--XXXX--------------------------------E--------E-E-----------------------------------------------------------E-------------------------------------------------------------------------[]--[]----------------E--EE-----------[]-----XXXX--------------------E--[]------[]--------XXXXXX--EE-E-E-[]-----EE-----[]-XXX-------SSSSSS---------E--------------------------------------------------------EE-E------------------------------E-EE---[]---E-X-----------X---------------------E-------E-E-------E-E-E-E------[]----------------XXXXXXXXX--------------E-E------------XXXX--[]----[]------[][]--E-[]---EE---------X-[]-------------EE---------[]--X-----E-[]----[]------------------E-[]---E-E--------------E-X-XX[]-SX-E--E--E--[]---E----[]--[]X----E--------------EE----------EE-E---[]-----------XXXXX-E----------E---[]-----------------------[]----------XXX---------------------------------E-EE-E-----EE-EE--XXXX---------------[]-E---------------------E------------XXXX-------------------------------------------------EE-----E---------------X-XX---EEE-------------E--[]---------------E--E---[]-E--------------------------E-----------E--X--E-E--------E-----------E---E-EE-E-[]-E--E--E-----XXXXX--------------[]---------------------EE-E--E---------[]----------------XXXXE-XXXX---E-----------[]----[]------------------------------------XXXX------------------------------XXXXXXXX----------E-----------------------------XX----ooo----------------------------------------------------X--------------------------------XXXXX--XX-XX---EE---
----------------------------XXXXXXXXXXXXXXXXXXXXXXXXXXXX------------------------XX-XXX-XXXXXXXXXXXXX-----XX--XXXXXXXXXXXXXXXXXXXXXX-XXXXXX--XXXXXXXX-----XX------XXXXXXXXXXXXXXXXXXXXXXXX--XX--XXX-----XXXXXXXXXXXXXXXXXXXXXXXXXXX--------------------------XXXXXXXXXXXXXXXXXXXXXXXXXXXXXXXXXXXXXXXXXXXXXXXXXXXXXXXXXXXXXXXXXXXXXXXXXXXXXXXXXXXXXXXXXXXXXX-----------XX-X-XXXXXXXXXXXXX-XX---XXXXXXXXXXXXXXXXXX---------------------XXXXXXXXXXXXXXXXXXXXXXXXXXXXXXXXXXXXXXXXXXXXXXXXXXXXX-XXXXXXXXXXXXXXXXXXXXXXXXXXXXXXXXXXX-----XXXXXXXXXXXXXXXXXXXXXXXXXXXXXXXXX-----XXXXXXXXXXXXXXXXXXXXXXXXXXXXXXXXXXXXXXXXXXXXXXXXXXXXXXXXXXXXXXXXXXXXXXXXXXXXXXXXXXXXXXXXXXXXXXXXXXXXXXXXXXXXXXXXXXXXXXXXXXXXXXXXXXXXXXXXXXXXXXXXXXXXXXXXXXXXXXXXXXXXXXXXXXXX-XXXXXXXXXXXXXXXXXXXXXXXXXXXXXXXXXXXXXXXXXXXXXXXXXXXXXXXXXXXXXXXXXXXXXXXXXXXXXXXXXXXXXXXXXXXXXXXXXXXXXXXXXXXXXXXXXXXXX---XXXXX-----------XXXXXX--XXXXXXXXXXXXXXXXXXXXXXXXXXXXXXX--XXXXXXXXXXXXXXXXXXXXXXXXXXXXXXXXXXXXXXX-X-XXXXXXXXXXXXXXXXXX--XXXXXXXXXXXXXXXXXXXXXXXXXXXXXXXXXXXXXXXXXX--XXXXXXXXXXX---XX--XXXXXXXXXXXXXXXXXXXXXXXXXXXXXXXXXXXX--XXXXXXXXXXXXXXXXXXXXXXXXXXXXXXXXXXXXXXXXXXXXXXXXXXXXXXXXXXXXXXXXXXXXXXXXXXXXXXXXXXXXXXXXXXXXXXXXXXXXXXXXXXXXXXXXXXXX--XXXXXXXXXXXX----------XXX-XXXXXXXXXXXXXXXXXXXXXXXX----XX--XXXXXXXXXXXXXXXXXXXXXXXXXXXXXXXXXXXXXXXXXXXX-XXXXXXXXXXXXXX---XXXXXXXXXXXX----------------------------XXXX--------------------------XXXXXXXXXXXXX-------XXXXXXXXXX--XXX-X--XXXX-XXXXX-------XXXXXXXXXXXXXXXXXXXXXXXXXXXX----------------------------XXXXXXXXXXXXo-XXXXXXXXXXXXXX