-------------------------------------------------------------------------------------------------------------------------------------------------------------------------------------------------------------------------------------------------------------------------------------------------------------------------------------------------------------------------------------------------------------------------------------------------------------------------------------------------------------------------------------------------------------------------------------------------------------------------------------------------------------------------------------------------------------------------------------------------------------------------------------------------------------------------------------------------------------------------------------------------------------------------------------------------------------------------Q----------------------------------------------------------------------------------------------------------------------------------------------------------------------------------------------------------------------------------------------------------------------------------------------------------------------------------------------------------------------------------------------------------------------------------------------------------------------------------------------------------------------------------------------------------------------------------------------
------------------------------------------------------------------------------------------------------------------------------------------------------------------------------------------------------------------------------------------------------------------------------------------------------------------------------------------------------------------------------------------------------------------------------------------------------------------------------------------------------------------------------------------------------------------------------------------------------------------------------------------------------------------------------------------------------------------------------------------------------------------------------------------------------------------------------------------------------------------------------------------------------------------------------------------------------------------------------------------------------------------------------------------------------------------------------------------------------------------------------------------------------------------------------------------------------------------------------------------------------------------------------------------------------------------------------------------------------------------------------------------------------------------------------------------------------------------------------------------------------------------------------------------------------------------------
-------------------------------------------------------------------------------------------------------------------------------------------------------------------------------------------------------------------------------------------------------------SSSSSSSSSSS--------------------------------------------------------------------------------------------------------------------------------------------------------------------------------------------------------------------------------------------------------------------------------------------------------------------------------------------------------------------------------------------SSSSSSSSSS-----SSSSSSSSSSSSS----------------------------------------------------------------------------------------------------------------------------------------------------------------------------------------------------SSSSSSSSSSSSSSSSSSS-SSSSSSSS---------------------------------o--------------------------------------------------SSSSSSSSSSSS-----------SSSS---------------------------------------------------------oo----------------------------------------------------------------------------------------------------------------------------------------------------------------------------------------------------------------------------------oo----------------------SSSSSSSSSSSSSSSSSSSSSSSSSSSS------------------------------------------------------------------------------------------------------------------------------------------------------------------------
-------------------------------------------------------------------------------------------------------------------------------------------------------------------------------------------------------------------------------------o---------------------------------------------------------------------------------------------------------------------------------------------------------------------------------------------------------------------------------------------------------------------------------------------------------------------------------------------------------------------------------------------------------------------------------------------SSSSSSSSSSS---------------------------------------------------------------------------------------------------------------------------------------------------------------------------------------------------------------------------SSo----------------------------------------E-E--E----------------------------------------------------------------------------------------------------------------------------------E-------------------------------------------------------------------------------------------------------------------------------------------------------------Q------------------------------------------?--------------------------E--E------------------SSSSSSSSSSSSSSSS----------------------------------------------oo----------------------------------------------------------------------------------------------------------------------------------
----------------------------------------------------------oo------------------------------------------------------------------------------------------------------------------------------------------------------------------------E----------------------------------------------------------------------------------------------------------------------------------------------------------------------------------------------------------------------------------------------------------------------------------------------------------------------------------------------------------------------------------------------------------------------------------------------SSSSSSSSSSS-------------------------------------------------------------------------------------E-----------------------------------------------------------------------------------------------------------------------------?-------------------------------------------------XXXXXXXXX------------------------------E-------------------------------------------------------------------------------------------o----XXX-X--------------------------------------------------------------------------------------------------------------------------------------------------------------oo---------------------------------------------------------------XXXXXXX--------------X-SSSSSSSSSSSSSSSSS---------------------------------------------------------------------------------------------------------------------------------------------------------------------------------
--------------------XXX-----------------------------------------------------XXX---------------------E-----------SS--SQS----SS----------SSS------------------------------SSSSS---------------------------------SSSS-SSSS------------SQS-----SSSS-------------------------------------Q------?------------------SSS-------------------------SSS-----------------------------------SQS------------------------------SSQS---------------SSSS-----------------QQQQ-----------SSS-------E-----------------------------------------------------Q------SSSSS-----------QS---SS--------------E------SSS-------------S--------------------------------------------SSS------------S---------SSSSSSSS-SSSS--SSSS-------SSSS-SSSSSSS-----SSQSS----------------------------------QS---SSS-------SSSSSSS-------XXoo-----?-----------------SS---------------------------------------XX----------------SSSSSSSS--------SQQ----------------SS-----------------SSSSSSSSSSSS----------------------------------SS------------SSQSSSSS----SQQQ-------------S---SSS--------------------------------o------------------------EXX-------------X-S----XXX-------SS----------------SSSS---------------SSS-SSSS----------SSS---QQ-----------------------------------SSSSSS---SSSo------------------------XXX-S-?------------XX---------------E-SS---o-oooo-----------------------------------------SSSSSSSSSSSSSSSS--QQ-----o--------------------------------------XX--------------------------------------------S-?-----------------SSSS-----------------------------------------------------------
--------------------------------------------------------o-------------------------------oo-------------------E-------------------------------------------------------------------------------------------------------------------------------------------------------------------------------------------------------------------------------------------------------------------------------------------------------------------------------------------------------------------<>--------------XX--------------------------------------------------------------------------------------------------------------------------------------------------------------------------------------------------------------------------------------------------------------------------------------------------------XXX------------------------------------------o---o------------------------------------------------------------S----------------------------------------------------o-------------------------------------SS---E---------------------------------------------------------------------------------------------------------------------------------------------------------------------------------------------------------------------------------------------------------------------XXX-------------------------------------------------------oo------------------SS-----------------XX--o-----------------------------------------------------------------------------------------------------------------------------------------------------------------Eo
-----------------------------------------------------------------------------------------------------------XXXX------------------------------------------------------------------------------------------------------------------------------------------------------------------------------------------------------------------------------------------------------------------------------------------------------------------------------------------------------------------[]---------------------------------------------------------------------------------------------XX--------------------XS---------------------------------------------------------------S------------------S---------------------------------S--------------------------------------------------------------------------------------------------------------------------XXX-XXX-----XXS---------------------------------------------------S----S-----------------------------XXXXXXXX------------------------------------------------SS-------S------------------------------------o-------------------------------------------------------------------------------------------------------------------------------------------oo-------------------------------E----------------------------------------------XXXX-----------------S-S----SSSSS-------------------------------------S-S------SS-----------------S--XXX---------------------------------------------------------------------------------------------------------------------------------S-----------------------------<>S
----------------------------------------------------------------------------------------------------------------E----------------------SSS-----------------------------X-------------------------------------------------------X----o--------------------------------------------E------XS-SQ----------------------X----------------------------------------------------o--------o--------------SSSSSS-----E---------------------E-----------------------------------------------[]----------------------------------------------E------------SSSSSS------------------------E---S--------------------XXX--------------------------------------------ooo------------------------------------oS--------------------------------E------SSSS--------------------------------------------------------------------------E--------E--------E---E--------------------------XX--------------------------------------------------?-SQ---S----------------------------X-------------------------o-------------------------------E-------SSS----------------------oo--------------------XX------------E------------------------------E--o----------------------------SSS-S--------------------------------------------------------------------------------------XX------------------------------E--S------XXXX----------oo-----SoS---oSSSS-----------------------------E-----E-----------ES----?----------S----------S-------------XSS--------------------------------------------------E----------------------------SS------S-SQS----------------XX-ooo-------------------------[]S
------------------XXX--XX---------------------------XX----------------XXXXXXXXXXX-------XXXX--------------------QS--S?S------------------------------------S----------XX-------E--------?Q-------------E-----Q----------------XX---SSS-----E--------------S-----------------E---<>---Q-----------------E----------XX----------------Q---------XX--------------------E-----------SSSS----------------------<>-----QQQQ--S--------<>----?-S-----------------QQQ------QQQQ--Q-S-----XX-------------------------------XX-------E----<>----E??QQ-----------------Q-------------E-----S---Q-Q----QS-------XXXX-SX---------------------------------------E----------------S---S?S-------------S--SSS---ESSSS---------------SSSS----SSSS--------ES-------------------------E---------------o----------------XXXX---------<>-------<>-------<>--S------E--------------SS----XXX-----------------XXX-SSSS--S----SSS---------------------SS-----------------S----X---XX-------------------E-------------------X--X------------XSSSS------------SQ-----S-----------------------X--------S----E-------<>-----E--S--------------------<>-------XX----------E----<>----------------Q----Q-----S------------------SSS------X-----------X---QQQQ--------------SSS----S--E------------------------o--<>-----E-XXXXXX-------------Q---SSS--SSS-------X-------QQ---SSS--------<>----<>--SSSSSSSSSSSSSS-??QQ--QQ---S-S------E--------------XXX--E--------------XXXXX------------------SS--------<>--------o---S---------------------X---------------------XXX-------<>---------------E----[]S
------------------------------E---------------------XX-------XXXXX--------------------------------------------------------------------------------------------E------XXX------<>----------------------<>---------------------XXX----------<>-------------------------------<>---[]---------------E----<>---------XXX------------------------EXXX-----------E------E<>-------------------------------------[]--------------------[]---------------------------------------E-------XX-SXX-------XXXXXXXXXX------------------<>----[]---------------------------------------<>-----S------------------XXXXX-SX--------------------------------------<>---------------E---E--------------------------------------------E--------E-----------E--E-E--E-----E-----------<>---------------------------------------------[]-------[]-------[]------------XXXXX-------------XXX---------------------E------------------X------------------------------------E--E--XXX---------------E--<>------------------XX--XX-----------XE------E---------------------------------------X------------<>-------[]----<>-----------------------[]------------------<>----[]------------------------------------------------------XXX---------XX----------------X-------------<>---E-----------------------[]----<>-XXXXXX--------------------------------X-----------------------[]----[]--SSSSSSSSSSSSSS--------------------<>-------------XXXXXXX-------------XX-XXX---------------------E------[]---------------------------------XX---E----------------XXX--------[]------E-------<>----[]-
----------------------------------------------------XX-------------------------------------------------------------------------------------------------------<>-----XXXX------[]----------------------[]--------------------XXXX----------[]-------------------------------[]---[]--------------<>----[]--------XXXX-----------------------XXXXX----------<>-----<>[]-------------------------------------[]--------------------[]-------------------------------------------E---XX---------X-----------------------------[]----[]---------------------------------------[]-----S-----------------XXXXXX-SS--------------------------------------[]--------------<>------------XX--X-----------------------------------E----------------------------E-------------[]---------------------------------------------[]-------[]-------[]----------------------------X-XXX-----------------------------------------X---X----------------------------------X-XXXX--------------<>--[]-----------------XXX--XXX------E---X------<>---------------------------------------XX-----------[]-------[]----[]-----------------------[]------------------[]----[]---------------------------------------X-------------XXXX--------XXX----------------X-------------[]---------------------------[]----[]-XXXXXX---------X----------------------X-----------------------[]----[]--SSSSSSSSSSSSSS--------------------[]------------XXXXX----------------XX--XX--------X-----------<>------[]------------------X---X---------X-X--<>---------------XXXX--------[]-----<>-------[]----[]-
------------------------------------E-------EE-EE---XX-----------------------------------------------------E-E---E-E-------E----------E-E------EE------E-----[]----XXXXX--E---[]----------------------[]-----E-E--E--------XXXXX---E------[]---------EE-E------------------[]---[]---------E----[]-E--[]-------XXXXX-EEEE-----------------XXXXXX----------[]-----[][]--------EE---------------------------[]--E-EE-E---------E--[]-----------------------------------------------XX---------------------------------------[]----[]--------------------------E-----E-E----[]-----S-------E--------XXXXXXX--S--------EE-E-E-------------------EE---[]--------------[]------------XXE-X--X------------------------------------X-------------------------------EE-----[]------------E--------------------------------[]-------[]-------[]-----E----------------XEE-EEX-XXXX-------------E----------------E---------X-E-X-E-E-EE-------------XX---E--------XXXXXX--------------[]--[]----------------XXXX--XXXE---------X------[]---------------------------------------X-------X----[]---E---[]----[]-E---------------------[]-----------EE-E---[]-E--[]-E---------X---E-----E--E--------------X------------XXXX--------XXXX---E-----E------X----EE----X--[]---------------------------[]----[]-XXXXXX--------XX--EE-----------EE-EE--X-----------E-----------[]-E--[]-SSSSSSSSSSSSSS---o--E-EE-----------[]-----------XXXXX--------------------XXX---EE--XX-----------[]------[]--------E-E----X--E---X-E-----XXX-X--[]--------------XXXXX-----E--[]-----[]-------[]----[]-
------------------------XXXXXXXXXXXXX-XXXXXXXXXXXXXXX--XXXXX------------------------XX-----------------XXXXXXXXXXXXXXXXXXXXXXXXX-XXXXXXXXXXXXXXXXXXXXXXXXXXXXXXXXXXXXXXXXXXXXXXXXXXXXXXX----XXXXXXXXXXXXXXXXXXXXXXX--XXXXXXXXXXXXXXXXXXXXXXXXXXXXXXXXXXXXXXXXXXXXXXXXXXXXXXXXXXXXXXXXXXXXXXXXXXXXXXXXXXXXXXXXXXXXXXXXXXXXXXXXXXXXXXXXXXXXXXXXXXXXXXXXXXXXXXXXXXXXXXXXXXXXXX-XXXXXXXXXXXXXXXXXXXXXXXXXXXXXXXXXXXXXXXXXXXXXXXXXXXXXXXXXXXXXXXXXX----XXXXX---XXXX-XXXXXXXXXXXXX-XX--XXXXXXXXXXX------------X---XXXXXX------XXXXXXXXXXXXXXXXXXXXXXXXXXXXXXXXXXXXXXXXXXXXXXXXXXXXXXXXX---XXXXXXXXX---XXXXXXX--XXXX--XXXXXXXXXXXXXXXXXXXXXXXXXXXXXXXXXXXXXXXXXXXXXXXXXXXXXXXXXXXXXXXXXXXXXXXXXXXXXXXXXXXXXXXXXXXXXXXXXXXXXXXXX---XXXXXXXXXXXXXXXXXXXXXXXXXXXXXXXXXXXXXXXXXXXXXXXXXXXXXXXXX---XXXXXXXXXXXX--------XXXXXXXXXXXXXXXXXXXXXXXXXXXXXXXXX-X---------XXXXXXXXXXXXXXXXXXX-XXXXXXXXXXXXXXXXXXXXXXXXXXXXXXXXXXXXXXXXXXXXXXXXXXXXX--XXXXXXXXXXXXXXXXXXXXXXXXXX------------XXXXXXXXXXXX---XXXXXXXXXXXXXXXXXXXXXXXXXX--XXXXXXXXXXXXXXXXXXXXXXXXX--XXXXXXXX---XXXX--XXXXXXXXXXXXXXXXXXXXXXXXXXXXXXXXXXXXXXXXX-----XXXXXXXXXXXXXX---XXX---XXXXXXXXXXXXXXXXXXXXXXXXXX-X----XXXXXXXXXXXXXXXXXXXXXXXXXXXXXXXXXXXXXXX---X-XXXXXXXXXXXXXXXXXXXXXX-XXXXXXXXXXXXXXXXXXXXXXXXXXXXXXXXXXXXXX---XXXXXXXXXXXXXXXXXXXXXXXXXXXX-XXXXXXXXXXXXXXXXXXXXXXXXXXX-XXXXXXXXXXXXXXXXXXXXXXXXXXXXXXXXXXXXXXXXXXXXXXXXXXXXXXXXXXXXXXXXXXXXXXXXXXXXXX-----X---XX--XXXXXXX-XXXXXXXXXXXXX--XXXXXXXXXXXXXXXXXXXXXXXXXXXXXXXXXXXXXXXXXXXXXXXXXXXXXXXXXXXXXXXXXXXXXXXXXXXX-----XXXXXXXXXXXXXXXXXXXXXXXXXXXX