------------------------------------------------------------------------------------------------------------------------------------------------------------------------------------------------------------------------------------------------------------------------------------------------------------------------------------------------------------------------------------------------------------------------------------------------------------------------------------------------------------------------------------------------------------------------------------------------------------------------------------------------------------------------------------------------------------------------------------------------------------------------------------------------------------------------------------------------------------------------------------------------------------------------------------------------------------------------------------------------------------------------------------------------------------------------------------------------------------------------------------------------------------------------------------------------------------------------------------------------------------------------------------------------------------------------------------------------------------------------------------------------------------------------------------------------------------------------------------------------------------------------------------------------------------------------
------------------------------------------------------------------------------------------------------------------------------------------------------------------------------------------------------------------------------------------------------------------------------------------------------------------------------------------------------------------------------------------------------------------------------------------------------------------------------------------------------------------------------------------------------------------------------------------------------------------------------------------------------------------------------------------------------------------------------------------------------------------------------------------------------------------------------------------------------------------------------------------------------------------------------------------------------------------------------------------------------------------------------------------------------------------------------------------------------------------------------------------------------------------------------------------------------------------------------------------------------------------------------------------------------------------------------------------------------------------------------------------------------------------------------------------------------------------------------------------------------------------------------------------------------------------------
--------------------------------------------------------SSSSSSSSSSSSSSSSSSSSSSSSSSSS------------------------------------------------------------------------------------SSSSSSSSSSSSSSSSSSSSSSSSSSS--------------------------------------------------------------------------------------------------------------------------------------------------------------------------------------------------------------------------------------------------------------------------------------------------------------------------------------------------------------------------------------------------------------------------------------------------------------------------------------------------------------------------------------------oo---------------------------------------------------------------SSSSSSSSSSSSSSSSSSSSSSSSSSSS--------------------------------------------------------------------------------------------------------------------------------------------SSSSSSSSSS-----SSSSSSSSSSSSS------------------------------------------------------------------------oo--------------------------------------SSSSSSS------------------------------------------------------------------oo---------------------------------------------------------------------------------------------------------------------------------------------------------------------------------------------------------------------------------------------------------------------------------------------------------------------------------------------------------
--------------------------o-------------------------------------------------------------------------------------------------------------------------------------------------------------------------------------------------------------------------------------------------------------------------------------------------------------------------------------------------------------------------------------------------------------o---------------------------------------------------------------------------?-------------------------------------------------------------------------------------------------------------------------------------------------------------------------------------------------------------------------XXXX--------------------------------------------------------------------SSSS-SSSSS---------------------------------------------------------------------------------------------------------------------------------------------------------SSSSS---------SS----------------------------------------------------------------------------------------------------------------------------------------------------------------------------------------------------------------------------------------------------------------------------------------------------------------------------------------------------------------------------------------------------------------------------------------------------------------------------------------------------------------------------------------------------------o-o--
------------------E-------------------------------------------------------------------------------------------------------------------------X--------------------------------------------------------------------------------------------------------------------------------------------------------------------------------------------------------------------------------------------------------------------------------------------------------------------------------------------------------------------------------------------------------------------------------------------------------------------------------------------------------------------------------------------------------------------------------------------------------------------------------------------------------------------------S---SS--------------------------------------------------------------------------------------------------------------------------------------------------ooo--------SSSS--E--------S--------------------------------------------------------------------------oo-------------------------------------------------------------E------------X---------------E---------------------------------------------------------------------------------------------------------------------------------------------------------------------------------------------------------------------------------------------------oo--oo------------------------------------------------------------------------------------------------------------------------------
-------S---------SQ--SSS---S-----SSSSS------------------------------------------------------------------------------------------QQQ-----------SQQQ-----------S---?-S------------------------------------------------SSSS---------------------------------------------------XXX-----------------------------------------S-----------------------S-----------------------------------------------------------SS---SSS-------------XXXSS?SSS----------SSSSSSSSS-----------------------------------SQS---?SQS----E--------------SQS----SSS----------SS-----?-----------------------S-----------S--------------------------------SSS--------S----------SSS---------------------SSSS------------------X--------XXX-----o----------SSS------QQ-------------------Q------------------------------S---------------------------SSSSSSSSSS------QQ-Q------------------------------------------------------E-So--S------------------XX----------------------SS----------------------------------------SS----S--------S---?---------------SSSS--------------------------------SSS-------S-------XXXX-----XXX------------SSQ-----------------------------------SSQS---------------SS--------SSQSSS-----SSS--------XXX-------E---------SSSSS------SSS-------S---------?-----------------SSS-------------------------------------S-------Q-Q----------------SQS---------------------------------------------SSSS---------SSSS-----------------------------------------------------------XX--------------------------------------S?SSS----------------SSSSS---SS---S--------------SSS---S
-------------------------------------------------------------------------------------------------------E-------------------------------------------------------------------------------------------------------------------------------------------oo-------------------------------------------------------------------------------------------------------------------------------------------------------------------------------------------------------------------------------------------------------------------------------------------SS------------------------------------------------------------------------------------------------------------------------------------------------------------------------------------------------------------------------------------------------------------------------------------------------------oooo---------------E------------------<>---------------------------------------------------oo-------------------------------------SS----SS----------------------------------------------------oooo--oooo---------------------------XXXX--------------------------------------------------------------------------------------------------------------<>------------------------------------------------------------------------------------------------------------------------------------------S-----------------------------------------------------------------------------------SS---------------Qooo------XX------------------------------o---------------------------------------------------------------
------------------------------------------------------------------------------------------------------<>---------------------------------------------------------------------------------------------------------------------------------------------------------------------------------------------------------------------------------------Q-------------o----------------------------------------------------------------------------------------------------------------------------------------------------------------------------------[]-----------------------------S------------------------------------------------------------------------------------X-----------------X-X-----------------------------E-----------------------------------------------------------XX------------------------------------------------------------------------------------XXXXXXXXX-XXX--o------[]------------------------------------------------------------------------------------XXXX--SS----SS---------------------------E------------------------------------------------------------XXXXX--------------------------------------------------------------------S-----------------------------------------[]--------------------------------E------------------------------------------------------------------------------------------------------------------------------------------------------------------------------------------------------------------------XX-------------------------------------------------------------------------------------E--------
------------------------------------------E---------E-----------------------------oo---------------E--[]-----E-------------------------------?----------o-----------------------------------------------------------------------S------E--S------E<>-----------------------------------------------------------------------------------E----<>S--SSSSSSSS----------------E-E---E--------------------------SS----------E---------------------------------------------------------------X---oo----------------------------------------------------[]---SQ------------------------------------------------------------------o-------------X------------------------------------------------X------------XXX-------------XXX---------------------------E-----------------------------XXX------------------------------------------------------------------E------------E--------------------------[]-------------------E----------------------------------------------------------------------SSo??-SS--?-ooo-----------S------------------------E------E-----E------------------------------XXXXXX--------------------oooooo------------------------------------------------------------------------------------[]------------------------------------------------X-----------------SSSSSSS-----------------E-----------------------------------------------S--SQ--------------------E-------------Q-<>---------------------E--Q---oo--------------SQ----------E---------X-XX-------------------------E----SS------SSSSSS---------------SSSSSSS---------------E--<>--------
-------S--------SS----XX--XX------E------<>-------E<>----------------------------oE---------------<>--[]----<>-------E---------SSQS-----------ESSS----------QQ?--QQQ-----------------------------------------Q--Q------------------E--<>-----E--<][]----------------X---------------XXXX--------------SS------------QQQ------------E--<>----[]SS------------S-----------<>----<>-------QS----------------------------<>-----------------S-------Q--SSQS----Q-------------------------XX----E---Q?Q--QSQS--------------------SSS----------SS-----[]-S---------------E-----------X---------E-----E---------E------------E-----S---------XX-----E--------------------------XXX------S----XXX---------------XXXXXXX-------------------ooQSSQQ------E--<>-----QQQ--------------------XXX-------S-----SS--E-------Q-------------------------QQQQ--oS-------<>----------SSSSS---------------------E--<>---E-S------------<>---------------E------------SS------XXX----------------------S---------SSS--SS--?SSSSSS--S---------E-----SS------E------<>-----<>----<>-----------------------------XXXXXXX--------------E---------------QQ-Q---XX----S-----SSQS----------E-----SS--SS-----SQQ?--S?S--------Q-Q-----S----[]-----------QQQ-QQQQ--Q--------S?S----oo-------<>XX-X------------------------------E------<>-------SS----SSSQS-----------QQ-Q-SQS-----X--XXX-----------------------<>-----E----QQ?--[]-----QQQ------------<>-----o-----XXX----XX-------------<>--------XXXXX---------X--------------<>----------S-----------------------------------S-------<>--[]--------
---------E------E--E--X---XX-----<>------[]-----X<>[]----XX-??----XXXX?---------------------------[]--[]----[]-----------E--------------------------------------------------------XX--?---------XX--------------------------------<>--[]----<>--[][]--------X---------------------------------------E------------XS---------------<>--[]--XX[>SS---------------------XX-[]----[]----------------------XX-------------[]---E---------------------------------------------------------XXXX-----------------------------E----------------------XX--[]-S--------------<>---------XXX--------<>----<>--------<>---------------------------XXX---------E--------------------XX--------------XXX-----------------------------------------------------<>--[]----------------XXXX?------XXXX---------E------<>---------------------------------------------XX-[]----------E------------------------<>--[]------------------[]--E------X----<>-------------------XXXX----E-----------------------X------------------------------<>------------<>------[]-----[]----[]----------------------------XXXXXXXX---------------------------------------------E----------------<>----------------------------------------E-----[]--XX--------------------------------X---------[]XX-XX-----------X----------E-----<>------[]-----------------------------------------XX-XXXX-----------------------[]----<>---------[]--------------------[]----------------XXXX-SSS----o----[]-------XXXXXX--------XX--------------[]--E---E--------------------E--------------------------[]--[]--------
--------<>----------X-XX--XX-----[]------[]-----X[]-----X-----------------------------------------[]--[]----[]----------<>---------------------------------------------------------------------XXX--------------------------------[]-->-----[]--[][]--------X--------------------------------------<>-----------XXX---------------[]--[]-XXX[]SS--------------------XXX-[]----[]---------------------XXX-------------[]--<>--------------------------------------------------------XXXX-----------------------------<>----------------------X---[]-S--------------[]---------XXX--------[]----[]--------[]-----------X--------------XXXX--------<>--------------------XX--------------XXX----------o------------o-----------------------------[]--[]--------------------------XXXXX----------------[]--------------------------------------------XXX-[]--------------E--------------------[]--[]------------------[]-<>------X----[]------------------XXXXX---<>----------------------XX------------------------------[]------------[]------[]-----[]----[]--------<>-----------------XXXXXXXXX--------------------------------------------------------------[]---------------------------------------<>-----[]----XX-----------------------------XX--------X[]XX-XXX----------X----------------[]------[]-----------------------------------------EXX-XXX-----------------------[]----[]---------[]--------------------[]---------------XXXXX-SSS---S-----[]--------XXXXX-------XXX--------------[]-<>--<>-------------------<>--------------------------[]--[]--<>---E
--E-E---[]---------XXXX---XX--E--[]---EE-[]-EE--X[]----------------------------------EE--------E--[]--[]-E--[]----------[]-------------------EE----------------E-E----------------------------XXXX----------EE--E--EE-E-----------[]-----E--[]--[][]--------X-----------------E-------------E-E----[]-----------XXXXE-------------[]--[]--XX[]SS-----------------XE-XXX-[]-S--[]----EE-E--E----------XXX-------------[]--[]-------------------------------------------------------XXXXX----S------------E---------E-[]-----E-------E-E------X---[]----------EE-E--[]-E-------XXX-E--E---[]----[]--------[]-----E-EE--X-------------XXXXX-E-EE---[]-----------EE-E-----XX----------E---XXX---------XXXX----------------------------------------[]--[]-------------------------XXXXXX----------------[]-----------------------------S---------E-----XX-[]--------------------------------EE-[]--[]------------------[]-[]------X----[]----------E-E----XXXXXX---[]-----E--------------XXXX----------------E-E-EE--------[]------------[]------[]--E--[]----[]--------[]----------------XXXXXX-XXX---EE-----E-E-----------------EE---------------------------E--[]--------------------E------------------[]-----[]--X-XX----------------------------XXXE------XX[]X--XXXX-------XXX------------E---[]------[]---X-------------------------E----------XXXX-XXX-----------E-EE--------[]----[]---------[]-----------------E--[]--------------XXXXX--SSS-EE------[]---EE--XXXXXX------XXXX---EE-E-------[]-[]--[]-------------------[]-------------E---------E--[]--[]--[]---X
-XXXXXXXXXXXXXXXXXXXXXXX--XXXXXXXXXXXXXXXXXXXXXXXXXXXXXX-----XXXX-----XXXXX-XXXXXXXXXXXXXXXXXXXXXXXXXXXXXXXXXXXXXXXXXXXXXXXXXXXXXXXXXXXXX--XXXXXXXXXXXXXXXXXXXXQXXXXX---XXXXXXXXX-----XXXXXXXXXXX---X-X-XXXXXXXXXXXXXXXXXXXXX---X-[]XXXXXXX-XXXXXXXXXXXXXXXXXXXXXXXXXXXXXXXXXXXX--------XXXXXXXXXXXXXXXXXXXXXXXXXXXXXXXXXXXXXXXXXXXXXXXX--XXXXSXXXXXXXXXXXXXXXXXXXXXXXXXXXXXXXXXXXXXXXXXXXX-XXXXXXXXX-XXXXXXXXXXXXXXXXXX-XXXXXXXXXXXXXXXXXXXXXXXXXXXXXXXXXXXXXXX----XXXXXXXXX-XXXXXXXXX---XXXXXXXXXXXXXXXXXXXXXXXXXXXXX-XXXXXXXXXXXXXXXX-XXXXXXXXXXXXXXXXXXXXXXXXXXXXXXXXXXXXXXXXXXXXXXXXXXXXXXXXXXXXXXXXXXXXXXXXXXXXXXXXXXXXXXXXXXXXXXXXXXXXXXXXXXXXXXXXXXXXXXXXXXX-XX---XXXXXXXXXXXXXXXXXXXXXX----------------XXX----X----XXXXXXXXXXXXXXXXXXXXXXXXXXXXXXXXX--XXXX-----XXXXXXXXXXX-XXXXXXXXXXXXXXXXXXXXXXXXXXXXXXX-XXXXXXX---X-XXXXXXXXXXXXXXXXXXX--XX----XXXXXXXXXXXXXXX-XXXXX---XX-XXXXXXXXXXXXXXXXXXXXXXXXXXXXXXXXXXXXXXX---XXXXXXXXXXXXXXXXXXXXXXXXXXX-XXXXXXXXXXXXXXX---XXXXXXXXXX--XXXXXXXXXXXXXXXXXXXXXXXXXXXXXXXXXXXXXXXXXXXXXXXXXXXXXXXXXXXXXXXXXXXXXXXXXXXXXXXXXXXX---XXXXXXXXXX-XXXXXXXXXXXXXXXXXXXXXXXXXXXXXXXXXXXXXXXX--XXXXXXXXXXXXXXXXXXXXXXXXXXX-XXXXXXXXXXXXXXXXXXXXXXXXXXXXXXXXXXXXXXXXXX-XXXXXXXXXXXXXXXXXXXXXXXXXXXXXXXXXXXXXXXXXXXXXXXXXXXXXXXXXXXXXXXXXXXXXXXXXXXXXXXXXXXXXXXXXXXXXXXXXXXXXXXXXXXXXXXXXXXX--XXXXXXXXXXXXXXXXXXXXXXXXXXXXXXX--XXXXXXXXXXXXXXXXXXXXXXXXXXXXXXXXXXXXXXXXX---XXXXXXXXXXX------------XXXXXX--SSS-SXXS-XXXXXXXXXXXXXXXXXXXXXXXXXXXXXXXXXXXXXXXXXXXXXXXXXXXXXX-XXXXXXXXXXXXXXXXXXXX-XXXXXXXXXXXXXXXXXXXXXXXXXXXXX-XXXX-X