------------------------------------------------------------------------------------------------------------------------------------------------------------------------------------------------------------------------------------------------------------------------------------------------------------------------------------------------------------------------------------------------------------------------------------------------------------------------------------------------------------------------------------------------------------------------------------------------------------------------------------------------------------------------------------------------------------------------------------------------------------------------------------------------------------------------------------------------------------------------------------------------------------------------------------------------------------------------------------------------------------------------------------------------------------------------------------------------------------------------------------------------------------------------------------------------------------------------------------------------------------------------------------------------------------------------------------------------------------------------------------------------------------------------------------------------------------------------------------------------------------------------------------------------------------------------
---------------X-------------------XXX----------------------------------------------------------------------------------------------------------------------------------------------------------------------------------------------------------------------------------------------------------------------------------------------------------------------------------------------------------------------------------------------------------------------------------------------------------------------------------------------------------------------------------------------------------------------------------------------------------------------------------------------------------------------------------------------------------------------------------------------------------------------------------------------------------------------------------------------------------------------------------------------------------------------------------------------------------------------------------------------------------------------------------------------------------------------------------------------------------------------------------------------------------------------------------------------------------------------------------------------------------------------------------------------------------------------------------------------------------------------------------------------------------------------------------------------------------------------------------------------------------------------------------
----------------X-----------SSSSSS-----SSSSSSSS-----SSSS----------------------------------------------------------------------------------------------------------------------------------------------------------------------------------------------------------------------------------------------------------------------------------------------------------------------------------------------------------------------------SSSSSSSSS---------SSSSSSSSSS------------------------------------------------------------oo--------------------------------------------------------------------------------------------------------------------------------------------------------------------------------------------------------------------------------------------------------------------------------------oo----------------------------------------------------------------------------------------------------------------------------------------------------------------------------------------------------------------------------------------------------------------------------------------------------------------------------------------------------------------------------------------------------------------------------------------------------------SSSSSSSSSSSSSSSSSSSSSSSSSSSS------------------------------------------------------------------------------------------------------------------------------------------------------------------------------------------------------------------------------------------------------------
------------X-XX------------------------------------------------------------------------------------------------------------------------------------------------------------------------------------------------------------------------------------------------------------------------------------------------------------------------------------------------------------------------------------------------------------------------SS------------------------------------------------------o-----------------------------X------------------------------------------------------------------------------------------------------------------------------------------------------------------------------------------------------------------------o-------------------------------S---------------------ooS--------E--E-----------------------------------------------------------------------------------------------------------------------------------------------------------------XX-------------------------------------------------------------------------------------------------------------------------------------------------------------------------------------------------------------------------------------------------------------------------------------------------------------------------------------------------------------------------------------------------------------------------------------------------------------------------------------------------------------------------------------------------------------------------
------oo-----X------XX----------------------------------------------------------------------------------------------------------------------------------------------------------------------------------------------------------------------------------------------------------------oo----------------------------------------------------------------------------------------------------------------X---E-----------------------X---SS--------------------------------------------------------------------------------------oo--oo----------------------------------------------------------E-------------------------------------------------------------------X---E--------------------------------------------------------------------------------------------------------------------------------------S-------XXXXXXX------------------------------------------------------------oooo-------------------------E-------------------------------------------------------------------------------------------------------oooooo--ooo----------------------------------------------------E----------------------------------------------?--------------------------------------------------------------------------------------------------------------------------------------------------------------------------------------------------------------------------------------------------------------------------------------------------------------------------------------------------------------------------------------------------------------------------
----------------------------oE------------------------S-------------------------------------------------------------------------------------S?SSS---?---S--------------------------------------------SSS----------------SSSS--------------SSS----------------SSSS-------------oo-------o----------------SSSSSS---SSQSSSS--------SS-SSSSSSSSS------------------------S--------------------------SS--SSSSS--SSQS--?------------QQQQ------SS----SS------Q--------------------------SSS-----------SSS-----SSSS--------------o--S----------------XX---------------------------?-?--Q-----SS---------SQS---?------SSSSS---?SSSS--------------------------------SSSSSS-------SSQS----------------------------E--------------------S----SS------------------SSSS----------------SSSSS-------------SS----SSQ--S---S----XS----------------------------SSSSS-------SS--------------------------------XXXX------SSSSS------E--S----E--E---------------------SSSSSS------------S-S--------------------------------------------------------------------------------------------------XX------------------SSSSSSSSSS-----------------------------------SQS---?-----------------------------------SSSSS----------------------S---SS------S----S--------------SSS---------------------S-------SSS--------------------------------S---?SSSSS--------------SS-?------------SSSSSSSSSSSS----------------SSSSSSS-----SSSSS--SSQQ---------------------oo--XXXXX-------------------SSS----SSS--------------------------S--SSSSS?S-------------------------??--------?SSS-----------------------
--ooo---E-E------XXXX-------XX--o------------------------------------------------E---------------------------------------------------------------------------------------------------------------------------------------------------------------------------------------------------XXX--------------------------------------------------------------Q-oo----------S--------------------------SS------------------------------------------?-SS--------------------------------------------------------------------------------------------XXX-------------------------------XXX---------------------------------------------------------------------------------------------------------------------<>-----------------------------------------------------------------------------------S--------------S-----------------------oo--------------------------------------------------------------------------------------XXXXXX---------------------------------------------------------------------------------------------------------------------------------------XXX---------------------------------------------------------------------------------------------------------------------E-------------------------E-----------------------------------------------------------------------------------------------------------------------------------------------------------------------------------------------------XXX------------------------------------------------------------------------------------------------------XXXX-----------------------------
------XXXXXX-------------------XXX--X-------------------------------------------XXX-------------------------------------------------------------------------------------------------------------------------------------------------------------------------------------------------ooo-----------------------------------------------------------------------------S--------------------------SS----------S-------------------------SS------SS-------------------------------------------------------------X----------------------------------------------------------------------------------------------------------------------------------------------------------------------------------------[]--------------------------------------------------------------------------------------------------S--------------------------------XX-----------------------------------------------------------------------------------------------------------o--------------------------------------------------E----------------------------------------------------------XXXX----------------------------------XXXX--------------------------------------------------------------------------------------------------------------------------------------------------------------------------------------------------------------------------------------------------------------------------------------------------------------------------------------------------------------------------------------------o-------------E----------------------------------------------
---------------X--------XXXX-----------------------E-------------------------------------------------E-------------------o------------------SSSSSS------------------------------------------------------------------------S-----S----------------------------SSSSS-------------X------------------E-------------------------------------------------E--------ooo----S-------------------oooo-?-SS---E---------------------------------SQ-----SS---------------S-----------------------------SSSSSS----------X-----------XX--oo-------------------o----oo-----oooo---------------------------------------------S--------------------------------------------------------------------------------------[]-------------E----------------------------------------------------------oo----------S---------?-----------------------------------XXXSSSSS--------E-----------------------oo---------------------------------------------------------------------------------E-----------------------------------------------S----------------------XX-----------------------XXXXX------------------------------------------------------E-----------------------------------SSS-----------------------SQSQ--------------------------------------E-------------------------oo------------------------------------------------------------------E---------------oo------------X--------------------------------------------------------------------------------------------------------------------------------------------S-------<>---------------S-S----------------------------
---XXX-----ooo--------------SS-----------------E--<>---E----------EXX-X------------------E-------E--<>-----------------------------------------------------------------------------------------------ooo-------XX-X----------------E------QQ-----E------------------Q-------XX--SSS--------------<>----XXX--SSSS-----?SSS------------Q-------------<>-----E-------E-------SS----------E---------S--SSSS---ES?S-----SSSS------SQQQ----ESSS----SS----SSQQ-------SS----------------------------------------XX-XX----------X---o--o--------XXX--X----------------------XXXXX--SS---------S--------SQQQQ--------------Q--QQQS-----------------ooQ----------------------XX--ESSS---------Q--Q------------SS[]SS-----S----<>----E-S----------<>---S----------------------------------o------------S----SS---S--S-----XX------------------------XXXX----S---------XXXXX-----------------------XXXX--XXX-------SSS-------SS-XXXX--------X---------Q--Q--SS---SS?------------<>----X--X---------------------------S?S-----E------------XXXX---------------------------------XXXXXXX-----SSS------XX--X-----SS----------------QQ---------<>----Q---S?S-----S----X-----------Q----------X------SSSSS----------------------S---------Q-------------<>-----------------------E--------------SS-S-S------------------XX-------EQQ--QSQQ------------<>--oS--------E---------------XX-------E-------SSQS-SSQ---------SSQQQQQQ----------------------XX--------------------Q---SQQ--------X------------------Q------XX-X---SSS--------E----[]------XXX-------------SE------------Q---------
-------------E--------------------------------<>--[]-------------XXXX-XXX-----------------------<>--[]------------------------------------------------------X-------------------------------------------------XX--XX--------------<>-----------E<>-------E--------------XX--XX-------------------[]--------E---------------------------E-------X---[]----<>-----E<>---E---------E----<>-----------EE---------------SSSS-------------E-----------E-------------------------------------------------------XXXXX---------XX--------------XXXX--XX---S------------------------------------------------------------------------------------------------XX-------------XXX---------------------------------[]------------[]-----------------[]---------------------------E----------E------------------------E-----XXX---------------------EEXXXXX----------------------------------------------------------SSS----------------------X-----------------------------<>----[]---XX---X--E------X------------E----------XXXX----------------------S-----------------------XXXXXXXX-----E------XXXX--XX---------------------------------[]---------------------X--X------------------XX--X---E-----------------------------------X--------------[]-----------S----------<>--------------------------------------------------------------------[]------E----<>--------------XXX------<>-------------------------------------------------------------------------------------------X-------------------------X--XX------------<>----[]----------------------------------------------
------XXXXXXXXX------------------XXX----------[]--[]------------XXXXX-XXX-----------------------[]--[]--------------------------------------------------E---X----------X---------------------------E---------XXX--XXXX-----E------[]----------<>[]<>----<>--------------EX--XXX--------X---------[]------------E---X-----------X---X-------E---X---[]----[]----<>[]------------<>----[]----------------------------SSSS---------------------------------------------------------------------------------XXXXXX-------XXX-------------XXXXX--XXX--------------------------------------------------------------------------------------------------XXX------------XXXX-----------SSS-------------------[]------------[]-----------------[]--------------------------<>----------------------------------------XXXX--------------------XXXXXXXX---------------------------X------------------------XXXX--SSS----------------------X-----------------------------[]----[]--XXX--XXX<>------X-----------<>---------XXXXXX-------------------XXX----------------------XXXXXXXXX-----------XXXXX--XXX--------------------------------[]---------------------X--X-----------------XXX--X-------E---X------------------------------------------[]----------------------[]----------------------XXXX------------------------------------------[]-----<>----[]----X--------XXXX------[]-------------------X-----------------------------------------------------------------------X------------------------EX--XX------------[]----[]----------------------------------------------
----------------------------------------------[]--[]----E------XXXXXX-XXXX----EE-E--------------[]--[]------------------------------------------------------X-----EE-E-X------------E-E-X-------------------XXXX--XXXXX--------X--[]----------[][][]----[]-E----------X--X--XXX--E--E-XX---------[]---------------XX-----------E-E-X-----------XE--[]----[]----[][]------------[]----[]------------------E---------S--------------------------------------EE-------E-----E-EE--------EE-E--X-----------XXX-XX-------XXXX------------XXXXXX--XXXX-----------------------------------------------------EE---------------------------------E-------X--X-----------XXXXX------------------------------E--[]------------[]----------EE-E---[]---------EE-E-XX---E-EE-E-[]------------------E---------E----------XXXXX----------------E--XXXXXXXXX-----------------------E--XX----------XX----------------o--------------------------X---------E-----------------E-[]----[]--XXX--X-X[]--E---X------E-EE-[]-EE-----XXXXXXX---------------------S---------------------XXXXXXXXXX----------XXXXXX--XXXX--------X-----E-EE------EE-E---[]-----------------E---X---------X---------X-XX--XX-X-------XX---------E-E-EE------------S-----------E--[]---------X-X---E-EE---[]-----------------------------------------------------------------E--[]--E--[]----[]----X-------XXXXX------[]-------------------X-------------------------EE----------------------------------------XX--XXXX---E-E------------E---X--XX--------XX--[]---E[]-------------------E--------------------EE----
----------------------------XX--------XXXXXX--XXXXXXXXXXXXXXXXXXXXXX--XXXXXXXXXXXXXXXXXXXXXXXXXXXXXXXXXXXXXXXXXXXXXXXXXXX-XXXXXXXXXXXX---X-XXXXXXXXXXXXXXX--XXXXXXXXXXXXXXXXXXXXXXXXXXXXXXXXXXXXXXXXXXXXXXXXXXXXXXXXXXXXXXXXXXXXXXXXXXXXXXXXXXXXXXXXXXXXXXXXXXXXXXXXXXXX-X--XXXXXXXXXXXX--X-XXXXXXXXXXXXXXX-XXXXXXXXXXXXXXXXXXXXXXXXXXXXXXXXX--XX--XXXXXXXXXXXXXXXXXXXXXXXXXXXXXXXXXXXXXXXXXXXXXXXXXXXXXXXXXXXXXXXXXXXXXXXXXXXXXXXXXXXXXXXXXXXXXXXXXXXXXXXXXXXXXXXXXXXXXXXXXXXXXXXXXXXXXXXXXXXXXXXXXXXXXXX-XXXXXXXXXXXXXXXXXXXXXXXXXXXXXX---XXXXXXXXXXXXXXX------XX------XXXXXXXXXXXXXXXXXXXXXXXXXXXXXXXXXXXXXXXXXXXXXXXXX--XXXXXXXXX---XXXXXXXXXXXXX--XXXXXXXXXXXXXXXXXXXXXXXXXXXXXXXXXXXXXXXXXXXXXXXXXXXXXXXXXXXXXXXXXXXXXXXXXXXXXXXXXXXXXXXXXXXXXXXXXXXXXXXXXXXXXXXXXXXXXXXXXXXX---XXXXXXXXXXXXXXXXXXXXXXXXXX--XXXXXXXXXXXXXXXXXXXXXXXXX-XXXXXXXXXXXX-------XXXXXXXXXXXXXXX----------------------XXXXX--XXXXXXXX------XXXXXXXXXXXXXXXXXXXXXXXXXXXXXXXXXXXXXXXXXXXXXXXXXXXXXXXXXXXXXXXXXXXXXXXXXXXXXXXXXXXXXXXXX-XXXXXXXXXXXX-XXXXX-------EX-XXXXXXX--XXXXXXXXXXXXXXXXXXXXXXXXXXXXXXXXX-XXXXXXXXXXXXXX-XXXXXXXXXXXXXXXXXXXXXXXXXXXXXXXXXXXXXXXXXX--XXXXXXXXXXXXXXXXXXXXXXXX--XXXXXXXXXXXXXX-X-XXXXXXXXXXXXXXXXXXXX---XXXXXXXXXXXXXXXXXXXXXXXXXXX-XXXXXXXXXXXXXXXXXXXXXXXXXXXXXXXX---------XXX------XXXX--XXXXXXXXXXXXXX----XXXXXXXXXXXXXXXXXXXXXXXXXXXXXXXXXXXXXXXXXXXXXXXXXXXXXXXXXXXXXXX--XXXXXXXXXXXXXXX----XXXXXXXXXXX--------XXXXX-----------XXXXXXXXXXXXXXXXXXXXXXXXXXXXXXXXX---XXXXXXXXXX--XXXXXXXXXXXXXXXXXXXXXXXXXX--------XXXXXXXXXXXXXXXXXXXXXXXXXXXXXXXXXX