------------------------------------------------------------------------------------------------------------------------------------------------------------------------------------------------------------------------------------------------------------------------------------------------------------------------------------------------------------------------------------------------------------------------------------------------------------------------------------------------------------------------------------------------------------------------------------------------------------------------------------------------------------------------------------------------------------------------------------------------------------------------------------------------------------------------------------------------------------------------------------------------------------------------------------------------------------------------------------------------------------------------------------------------------------------------------------------------------------------------------------------------------------------------------------------------------------------------------------------------------------------------------------------------------------------------------------------------------------------------------------------------------------------------------------------------------------------------------------------------------------------------------------------------------------------------
---------------------------------------------------------------------------------------------------------------------------------------------------------------------------------------------------------------------------------------------------------------------------------------------------------------------------------------------------------------------------------------------------------------------------------------------------------------------------------------------------------------------------------------------------------------------------------------------------------------------------------------------------------------------?--------------------------------------------------------------------------------------------------------------------------------------------------------------------------------------------------------------------------------------------------------------------------------------------------------------------------------------------------------------------------------------------------------------------------------------------------------------------------------------------------------------------------------------------------------------------------------------------------------------------------------------------------------------------------------------------------------------------------------------------------------------------------------------------------------------------------------------------------------------------------------------------------
----------------------------SSSSSSSSSSSSSSS-S----SSSSSS-SSSSSSSSSSSSSSSSSSSSSSSSSSSSSSSSSSSSSSSSSSSSSSSSSSSSSSSS------------------------------------------------------------------------------------------------------------------------------------------------------------------------------------------------------------------------------------------------------------------------------------------------------------------------------------------------------------------------------------------------------------------------------------E-------------------------------------------------------o----------------------------------------------oo--------------o--------------------------------------------------------------------------------------------------------------------------------------------------------------------------------------------------------------oo----------------------------------------------------------------SSSSSSSSSSSSSSSSSSSSSSSSSSSS-------------------oo------------------------------------------------------------------------------------------------------------------------------------------------------------------------------------------------------------------------------------------------------------------------------------------------------------------------------------------------------------------------------------------------SS-SSSSSSSS-S----------------------------------------------------------------------------------------------------------------------------------------------
------------------------------------------------------------------------------------SSSSSSSSSSSSSSSSSSSSSSSSSSSS-------------------------------------------------------------------------------------------------------------------------------------------------------------------Q----------------------------------------------------------------------------------------------------------------------------------------------------------------------------------------------------------------------------------------------------------------------------------------------------------------------------------------------------------------------XXXX---------S---XX---------------------------------------------------------------------------------------------------------------------------------------------------------------------------------------------------------?-------------------------------------------------------------------------------------------------------------------XXXX-------------------------------------XX-----XXoX--?-------------------------------------------------------------------------------------------------------------------------------------------------------------------------------------------------------------------------------------------------------------------------------------------------------------------------------------------------------------------------------------------------------------------------------------------------------------------------------------------------------
------------oX-X--------------------------------------------------------------------SSSSSSSSSSSSSSSSSSSSSSSSSSS---------------------------------------------------------------------------------------------------------------------------------------------------------ooooooooo------------------------------------------------------------------------------------------------------------------------------------------------------------------------------------------------------------------------------------------------------------------------------------oo-----------------------------------------------------------------------------------------------S---E---------------------------------------------------------------------------------------------------------------------------------------XX---------oo--oo--oo----------------------------------------E-oo--------------------------------------------------------------------------------------------------------------------------------------------------------------------------E-------o---------------------------------------------------------------------------------------------------------oo------------------------------------------------------------------------------------------------------------------------------------------oo--oo---------------??----------------------------------------------------------------------------------------------------------------------------------------------------------------------------------------------------------E-----------
---------------------------------------------------------------o--oooooo------------SSSSSSSSSSSSSSSSSSSSSSSSSSS--XX--------------------------------E--------------------------------------------------------------------SSSS--------------------------------XXX------XX----------------------------------------------------------------------------SSSS----SS----S------SSSS-------E-------------------------------QQS--------------------------------------------------------------------------------------------XX--------S-----?SSS-----------------XXoo---------XX-----------------QQQS-----------------------------------------SQS------------------------------S----SS-------------------S--------------------------XX------------SS--SSSSS-----------------------SSSSSS---------------------------------------XXX------X-------------SSSSS---?--E-------??-----------o--XXXXX-----------------S-SS-------------SSSSSS---------------SSS-----------------SQ---------------------------SSSSS-----------------------------------------------XX-----------E--E-----------------------------------------------------------------XX--------S---E-----oo----X---------oo--XXXXX-----------------------------------------------------------------------SSQQS-----------------------------------------------------------------------------Q--SS-SSS?S------------SSSSS---------------------------X-------------------------------------------------------S--S---SS---------------S-------S-------SSSSSSSSS-----SSSQ?SSS----------------SSSSSS---------------SSSSSSS-----S-
-----XXX-----------XX-----------------------------------------------------------------------------------------------------------------------------<>--------------------------------o---o---------------------------------------------------------S---E---------------------------------------------------------------------------------------------------------------------------<>------------------------XXX---------------------------------------------------------------------------------------------------XX--------------------------------------------------------------------------------------------------------------------------------------o---------E-----SS-------------------X-------------------------XXX------------------------------------------------------------------------------------XX------------------------------------------------XXXX----XXXX-----------------------------------------X-----------------------------------------------------------------------------------------------------------------------------XXXX------XXXX-------------------------------------------oooo---------------XXX------------XXX----------XXXXXX-------------------XXX----------------------------------------------SSSSS-----------------------------------------------------------------------------------------E----------------------------------------------------------------------------------------------------------------------------------------------------------------------------------------------------------------------------------
-----------------------------------------------------------------SSSSSSS--------------------------------------------------------------------------[]-------------------------------XXX-XXX------XX-------------------------------------------------------------------------------------------------------------XS-----------------------------XX----------------------------------[]--------------------XXX-o-----------------XX---------------XX-----------------------------------------XX--------------------XXXX---------------------------o---------------------------------------------oo-------------------------------------------------E-------------------------SS------------------XX-----------------------XXXXX---------------------------------------------------------------------------------------------------------------------------------------------------------------------------------------XX-----------------------------------------------------------------------------------------------------------------------------------------------------------------------------------------------------------XXXX-------------------------------------------------------------------------------o-------------------XXX-----------------------------------------------------------------------------------------XXXXX----------------------------XXX----------------------------------------------------------------------------------------------------E--------------------------------------------------------------------------------------------
--------------XXX-----------------------------------------------SSSSSSSS--------------??------------EE-----------------------------------------E--XX--------------------------------------------XX-----------E-----E------------oo--------------XSSSSQ-----------------------------XX-------------------------XXS----------------------------XXX----------------------------------XXX-------------------SX------------------XXXX-------------------------------S-------------------------XXX-------oo-----------XXXX----------------------------------------------------------------------------------XX----XXX-------------------------X--------------E-------------S----SS-----------------XXX----------------------XXXXXX--------------------------X------------------------------S--------------------------Q-----------------------------------------------------------------------------------------------XE-XX--X---------S-------------------------X-------------------------------------------S-S----------S--------------E------------------------------------XX-----------------E----------------E------------------XXXXX----------------------------------------------------------------------------------------oo--------XXXSS-S----------------------E--SSSSSSSS---S-------------E-----------------------------------------------------------------------------------------------------------------E-----------S-----------------------------------------E--<>-----S-----------------------------------------E-EE---------------------o---E---------------
XXX---------------------------------------------------------------------------------SS??SSSSSSSSSSSSSSS--SQSQS-----XXXXX----------------------<>------QQQ-Q------------------------------SS----XXX-X--------<>----<>--------------------XXX----XXX------------------X-XXXXXX--------------Q------------------XXX----------------------------XXXX----SS----------Q----------------------------------------XX--------SSS----X-XXXX----XX-------------------------X------------------------XXXX--------------------XXXX---S---QQQ--Q---XX--XX-----------------XX---------------------Q---S?S---S---------XX----X-----------------------S---------S?S-----<>-------------SS---SS--S------------XXXXX---------------------XXX-XXX----------------S---------XX----------<>----------QQQ--------------------------------------XXXX----X------------------------Q--Q-QQ--------X------------------XX-X------oooo------XXX-XXX-XX--------------------S-------------XX--SSSS--------------------------SSS--------XX-------------------------<>------------XXX-----XXXX------------------------------<>---------------<>-----------------XXXXXX------XX------XXX----XX----------------XXXXXXX-------------------------XX---SS-----X---o--o-----XXXXXX---------X---?SSS-------<>--------------------------<>---------X------------------------------Q---S?S--------------------------------Q-Q---------------------------E--<>--------S-------------S----X--X---------Q---ESS-----<>--[]--------S---QQQ--Q--QS-S---SS----------SQSQ--------XX-XX--------------E----<>------S-S------
---XXXX------------------XXX----------XXX--XX----E--E--X----------------------------S---SSSSSSSSSSSSSSS----------------------------X---S------[]---------------------------E-------------------XXX----------[]----[]-----------X--------------XXXX------o----------------------------------------------E----XXXX-SXX------X--?-------------XXXXX------------------------------<>------------------------XXX---------------XXXXXX------XXXXXXXX-------------o---------------------------XXXXX------------------XXXXXX---------------XXX--XX---------X-----------------X------------------------------XXXX----X-------------E---------------------------[]----------------------------------XXXXXX--------------------XXXX-XXXS-----------------------EXXX----------[]---------------------------------------------------------------------o-----------------------------X-----------------XXXXXX--------------XXXX-XXX-XX-------------------------X-------XXX-----------------------------------------XXXX---------S---------------[]------------------------------------------------------[]--------XX-----[]----------------XXXXXXX----------------------------------------------------------------------------------XX-----------EXXXXXX--------EX--------------[]--------------------------[]--------XXX---------------------------------------------X-----------XXX--------------------------------E----<>--[]------------------------E--X--XX--------------------[]--[]---------------------------------------------------XX-XX-------------<>----[]---------------
-------------------------------------XXXX--XXXX-----------------------------------------SSSSSSSSSSSSSSS----------------------------X----------[]--------------------------<>-----------------X-XXX----------[]----[]-------------------------XXXXX--------o-------------------------------------------<>---XXXXX---X----------------------XXXXXX------------------------------[]------------------------XXX---------------XXXXXX------------------------------------------------------XXXXXX------------------XXXXXXX-------------XXXX--XXX-------XX-----------------XXX----------------------<>---XXXXX----E---<>-------<>---------------------------[]---------XXX---------------------XXXXXXX-------------------XXXXX-XXX------------------------XXXX----------[]---X---------------------------X------------------------------XXX---XXXX---------------------------X---------------XXXXX-X-X------------XXXXX-XXX-XXX------------------------X------XXXX-----------X---------------------------XXXXXX--X-----SS---------------[]------------------------------------------------------[]-------XXX-----[]---------------XXXXXXXX---------------------------------------------------------------------------------XXX----------XXXXXXXX-------oXX--------------[]--------------------------[]-------XXXX---------------E-------------------------E---X---------------------------------------------<>----[]--[]---------------------------X--XXX-------------------[]--[]---------------------------------------------------XX-XXX------------[]--<>[]------------<>-
--------------------------------E---XXXXX--XXXX--------X-------------------------E---oooSSSSSSSSSSSSSSS----------------------------X-X---S----[]----E-E--EE-EE-E----------[]------------EE-EXX-XXX---EE-E---[]----[]-----------X------------XXXXXX-SSSSSS----XXXXX----------------------------EE------[]--XXXXXX---S---------------------XXXXXX--E-E--------------------------[]------------------------XXX-------E-------X-XXXX-----------------------------------------------------XXXXXXX-------------EE---XXXXXXX-------------XXXX--XXX--EE---XX-----o----XXXXXXXX------------------------[]----XX-X--------[]-------[]---------------------------[]------------E--------------E---XXXXXXXXX----EE-E----------XXXXXX-XXX------------E----------XXXXX---EE-E-X-[]-E-X-----------------------E-E-X----------XX--XXXoo------------------------------------------------X--------------XXXXXX-X-XX---E------XXXXXX-XXX-XXX------X---------E-------X-----XXXXX-----------X-E--------E-EE-------------XXXXXX--XS---E-----------------[]--------------XXXX--------------------------------E---[]------XXXX-----[]----E---------XXXXXXXXX----------------------------------X-X----------------------------E---------------XXX---------XXXXXXXXX-SS?SS-XXX--------------[]--------------------------[]------XXXXX---------------------------------------------X-----E---------------------E-----------------[]-E--[]--[]-------E-----------E-E-E---X--XXXX---E-----------E--[]--[]--------------------E--E--E--------------------X---X--XXX--E---------[]--[][]------------[]-
----------------------------XXXXXXXXXXXXX--XXXXXXXXXXX-XXXXXXXXXXXX---XX-XXXXXXXXXXXXXXXXXXXXXXXXXXXXXXXXXXXXXXXXXXX---------------X-X---XXXXXXXXXXXXXXXXXXXXXXXXXXXXXXXXXXXXXX-----XXXXXXXXXXXXX--XXXXXXXXXXXXXXXXXXXXXXXXXX-XX-XXX------XXXXXXX------SXXXX----------------------------XXXXXXXXXXXXXXXXXXXXXXX----XXXXX-----XXXXX-XXXXXXXXXXXX-XXXXXXXXXXXXXXXXXXXXXXXXXXXX------------X--XXXXXXXXXX---XX---XXXXXXXXXXXXXXXXXXXXXXX------------------XXX-------XXXXXXXXXXXXXXXXXXXXXXXXXXXXX---XX-X----X-XXXXXXXXXXXXXXXXXXXXXXXXXXXX--XXXXXXXXXXXXX--XXX--------X-------------XXXXXXXXXXXXXXXXXXXXXXXXXXXXXXXXXXXXXXXXXXX---XXXXXXXXXXXXXXXXXXXXXXXXXXXXXXXXXXX---XXXXXXXXXXXXXXXXXXXXXXXXXXXXXXXXXXXXXXXX---XXXXXXXXX-XXX---XXXXXXXXXXXXXXXXXXXXXXXX-XXXXXXXXXXXXXXXXXXXXXXXXXX------XXXXXXXXXXXXXXXXXXXXXXXX-----XX---------------------XXXXXXXXXXXXXXXXXXXXXXXXXXXXXX-XXX--XXXXXXXXXXX-XXXXXXXXXXXXXXXXXXXXX-XXXXXXXXXXXXXXX-XXXXXXXXXXXXX-XXXXXXXXXXXXXXXXXXXXXXXXXXXXXXXXXXXXXXXXXXXXXXXXXXXXXXXXXXXX----XXXXXXXXXXXXXXXXXXXXXXXXXXXXX----------------XXX------------XXXXXXXXXXXXXXXXXXXXXXXXXX--XXXXXXXXXXXX---XXXXXXXXXXXXXXXX-XXX---XX----------------XXX-----X--------------XXXXXXXXXXXXXXXXXXX---XXXXXXXXXXXXXXXXXXXXXXXXXXXXS-SQ-ESXXSXXXXXXXXXXXXXXXXXXXXXXXXXXXXXXXXXXX--XXXXXXXXXXXXXXXXXXX-XXXXXX-XXXXXX----X--XXXXXXXXXXXXXXXXXXXXXX--XXXXXXXXXXXX----XXXXXXXXXXXXXXXXXXXXXXXXXXXXXXXXXXX-XX--XXX-XXXXXXXXXXXXXXXXXXXXXXXXXXXXXXXXXXXXXXXXXXXXXXXXXXXXXXXXXXXXXXXXXXXXXXXXXXXXXXXXXXXXXXXXXXX-XXXXXXXXXXXXo--XXXXXXXXXXXXXXXXXXXXXXXXXXXXXXXXXXXXXXXXX