------------------------------------------------------------------------------------------------------------------------------------------------------------------------------------------------------------------------------------------------------------------------------------------------------------------------------------------------------------------------------------------------------------------------------------------------------------------------------------------------------------------------------------------------------------------------------------------------------------------------------------------------------------------------------------------------------------------------------------------------------------------------------------------------------------------------------------------------------------------------------------------------------------------------------------------------------------------------------------------------------------------------------------------------------------------------------------------------------------------------------------------------------------------------------------------------------------------------------------------------------------------------------------------------------------------------------------------------------------------------------------------------------------------------------------------------------------------------------------------------------------------------------------------------------------------------
------------------------------------------------------------------------------------------------------------------------------------------------------------------------------------------------------------------------------------------------------------------------------------------------------------------------------------------------------------------------------------------------------------------------------------------------------------------------------------------------------------------------------------------------------------------------------------------------------------------------------------------------------------------------------------------------------------------------------------------------------------------------------------------------------------------------------------------------------------------------------------------------------------------------------------------------------------------------------------------------------------------------------------------------------------------------------------------------------------------------------------------------------------------------------------------------------------------------------------------------------------------------------------------------------------------------------------------------------------------------------------------------------------------------------------------------------------------------------------------------------------------------------------------------------------------------
------------------oo----------------------------------------------------------------------------------------------------------------------------------------------------SSSSSSSSSSSSSSSSSSSSSSSSSSSS----------------------------------------------------------------------------------------------------------------------------------------------------------------------------------------------------SSSSSSSSSSSSSSSSSSSSSSSSSSSS---------------------------------------------------------------------------------------------------------------------------------------------------------------------------------------------------------------------------------------------------------------------------------------------oo-----------------------------------------------------------------------------------------------------------------------------------------------------------------------------------------------------------------------------------------------------------------------------------------------------------------------------------------SSSSSSSSSSSSSSSSSSSSSSSSSSSS----------------------------------------------------------------------------------------------------------------o-----------------------------------------------------------------------------------------------------------------------------------------------------------------------------------------------------------------------------------------------------------------------------------------------------------------------------------------------
----Q---------?----X------------------------------------------------------------------------------------------------------------------------------------------------------------------------------------------------------------------------------------------------------------------------------------------------------------------------------------------------------------o-----------------------SSSSSSSSSSSSSSSSSSSSSSSSSSSS--------------------------oS----------------------------------------------------------------------------------------------------------------------------------------------oS----------------------o-------------------------------------------------------------------------------------o--------E--E-------------------------------------------------------------------------------------------------------------E--E---------------------------------------------------------------------------------------------------------------------------------------------------------------------------o--------------------------------------SSSSSSSSSSSSSSSSSSSS------------------------------------------------------------------------------------------------------------------------------Q-------------------------------------------------------------------------------------------------------------o-------------------------------------?-------------------------------------------------------------------------------------------------------------------------------------------------------------------------------------
---------o-----------------------------------------------------------------------------------------------XXX------------------------------------------------------------------------------------------------------------------------------------------------------------------------------------------------------------------------------------------------------Eoooooo-------------------------------SSSSSSSSSSSSSSSSSSSSSSSSSSSS---------------------------S---------------------------o-------------------------------------------------------------------E----------------------------------------------SS--E-----------------------------------------------------------------------------oo---------oooooo-------------------XXXXXXX------------------------------------------------------------------------------------------------------------XXXXX------------------E--------------------------------------------------------------------------------------E------------------------------------------------------------------------------------------------------SSSSSSSSSSSSSSSSSSSS--------------------------------------------------------------------------------------------------------------Eoo----------------------oo--oo------------------------------------------------------------------------------------------------------------------------------Eooo-----------------------------------------------------------------------------------------------------------------------------------------------------------------------------------------
---ooo--XXXX--------------------------------------------------------------------------------------------------------------------SSS----------------------------SS----S--Q---------------------------SSSS---QQQ------------------SSSS----SQQQ--------------------------SSSS--------------------S---?SSS-----------------------------SSS------SSSS------------------XXXXXXX----?SSS-------XX--------------SSSSSSSSSSSSSSSSSSSSSSSSSSSS--S--------------S---SSS----oo--------------------------------S----SS----------------SS?----------------SSSS--------------SQS--SQS-------SSSS-----------------------SS--------SS------------SS-----S-------------------------------?------------XX----------XXX-------X--------------------------------------------S--------------------------------------------------------SS---------------------SSSSS---------------------------------SQS-SSSS--------------------------------------S-----------------------------------------E--E---------------------------------------------------------------------------------------------------SSSSSSSSSSSSSSSSSSSS--QS-------S-QS-------------------------------------------------SSSSQS----SSSS--------------------------------XXXXX-----XX------------------------------SSS---?SSS---------------------------X------XSX---------------------------------SSSSS---??SSS----------------------XXXXX------E-------------------------------------SS----------------------SS-SSSSS?S-S---SSSSSSSSSSS-----------------------SS----------S---------------SS--------------------------------EQ---
---X-----------------------------------------------------------------ooo---------------------------------------------------------------------------------------SS-----------------------------------------------------------------------------------------------------------------------------------------------------------------------------------------------------------------------------------------------------------------------------------------S-------------------------------------------------------------------------------------------------------------------------------------------------------SS------------S---------E---------------------------------------XXXXXX---------------------------XX-------------------------o------------------------------------------------------------------------------------------------------------------oooo------------------------------------------------oo------------------------------------------------XXXXXX-----------------------------------------------------------------------------------------------------------------------------------------------------------------------------------------------------------------------------------------------------------------XXX--o------------------------------oo-------------------------------------------------------------------------------------------------<>---------------------------------------------------------------------------------------------------------------------------------------------------------------------------------
-------------o--------------------------------------X-------------------------------------------------o--------------------------------------------------------SS-------S---------------------------------------------------------------------------------------------------------------------------------------------------------E-----------------------------------------------------------------------------------------------------------------------S-------------------------------------------------------------------------------------------------------------------------------------------------------SS------------SS------------------------------------------------XXXXX----------------------------------------o---------------E---------------------------------XX----------------------------------------------------------------------------E----------------------------------------------------------------------------------------------------------------------------------------------------------------------------------------------------------------------------------------------------------------------------------------------------------------------------------------------------------------------------------XX---------------------------------------------------------------------------------------------------------------------------------[]---------------------------------------------------------------------------------------------------------------------------------------------------------------------------------
---------------------------------------------------XXS-S----E--S--------------ooo---------S----------------oo--------------------------------------------oo--?-SS-------------------------------------------------------------------------------------------S----------------------------------------------------E---------------<>-----------------------------------------S--------------S-------------------------------oooo-----------------------SS--------SS-S-----------------X----------------------------E---------------------------------------------------------------------------E---------------ooo-SS-----oo---?--S------XS---------------------------------------XXXXX---------------XXXX-------------------------------------<>--------------------------------XXX------E--------E-------------E---E--S----ooo-------------------------S-----<>--------------------------E------------SSS-----------------------------------XXXXX------------------------------------------------------o---------oo-S-----------------------E--------------------------------?-----------------------------------------------------------------------------------------------------------------------------------------------------------------------------------------------------oo-----------S--------------------------------------S-S----------------------E----SSSSS----------[]-------------------------------------E---------E--o-------------------------------------------S-------------------------X----------E------------------------<>--XX---------------
-----XXXX-SSS-----X--X---------E------------------XXX--E---<>-----E---------------XXo--------------------------------------E----Q---------EX-----------E------ESS----SS-SS--------o-E---------------?SQQQ--SSS-----Q------------------QQ?SQQQ------------------QQQ---QQQ-------------E--Q-----S------------E----<>------------E--[]-----------SS-------------------------------------------XXXX-----------SSSSSSSSSSSSSSSSSSSSSSSSS---S-------XXX-X----S----SS-----------XX-----------------------S--------S-----<>------QQQ-----------E-----------X---------E-----QQQQ---------QS--------E--<>---------------SSSSSS--S---------------SS-----------------X--X-------ooooo-------XXXXXX----------------------XXX--------------SS------------E--[]-------------------------------XXXX--E--<>-------<>-----<>----S-SSS<>-----E-------------S?-----E-----------E--[]-----E-----QQQ---S?S-----<>------E-X-----------------------------------EE-E--------XXXXX----QQ--S?S----------------------------------E-----------o-----------------E--------<>-----E------------S-----------SS??SSSSSSSSSSSSSSS--QQ-----Q---SSSQQ--------------------Q--------------------------E?QQQ--QQQ--Q--Q------------QQQQ------------------QQQ------E------XXXX--XXX-------------?QQ-----XX-XXX---------------------------------------------------------------------Q-Q--QQQQ-----E-E----<>-------------SS----XX----------Q----------XX-X------------XS--SSS--<>---E----------------S?S-------------SSSS--------------------S----------XXQ--------<>---------------XX--E----[]-------------------
--XXXXX---------XXX-XX---S----<>---E-------------XXXX------[]----<>--------------XXXX---E----------X----------------------<>-------------<>X----------<>-----<>---E-----------oXX--------E--E-------------------------------------------------------------E-------------------------<>--------------------------[]-----------<>--[]-----E------------------------------------------------XX--X------------SSS?SSSSSSS--SSSS------------------XXXX-XX---E-EE------------------------------------------------------[]--------------E----<>-----------X--------<>---------------------------<>--[]---E--------------------------------EE-E---------------E--X--XX----XX----------XXXXXXXX--------EX-------------------------------------E---E<>--[]------------------------------XXXXX-<>--[]-------[]-----[]---------[]----<>-------------------<>----------<>--[]----<>-------------------[]-----<>---------E-------------------------XXXXXXXXX-----------XXX-----------------------------------E----<>----------------------------<>--------[]-S--<>------------------------SSoSSSSSSSSSSSS--SS---------------------------------------------------------------------------------------------------------------------------<>-----------------------------------XXX-XXX-----------------------XX--------------------------------------------------------E<><>----[]-------------------XX--XXX---------------XXX-XX--------------------[]--<>-----------S------------XX---X------------------------------------XXX---------[]--------------XXX-<>----[]-------E-------E---
--XX--------E--XXXXX-X--------[]--<>------------XXXXX------[]----[]-------------XXXXX--<>----------X----------------------[]-------------[]X----------[]-----[]--------------XXXX--XX-----------E--------------------------------------------------------<>-------------------------[]--------------------------[]-----------[]--[]----<>-----------------------------------------------XXX----X------o-ooSSS-SSSSSSS--SSSS-----------------XXXXX-XXX------------------------------------------------------------[]-------------<>----[]-----------X--------[]---------------------------[]--[]--<>--------------------------------------------------XXX-X--XX----XX---------XXXXXXXXX-------XXXXXXXX-------------------------------<>--<>[]--[]-----------------------------XXXXXX-[]--[]-------[]-----[]---------[]----[]-------------------[]----------[]--[]----[]-------------------[]-----[]--------<>----------------------------------------------------------------------------------<>----[]----------------------<>----[]--------[]----[]------------------------SSSSSSSSSSSSSSS--SS---------------------------------------------------------------------------------------------------------------------------[]----------------------------------XXXX-XXX----------------------XXX-----------E---------------------------X---------------<>[][]----[]---------------E---XX--XXXX-------------XXXX-XX--------------------[]--[]------------------------XX--XX----------X---------------------<>-XXXX---------[]-------------XXXX-[]----[]------<>------<>---
SSSSo---------XXXXX?XX-X?SS---[]--[]-----------XXXXXX------[]----[]--------------XXXX--[]----------XX--------------EE-E---[]-------EE--XX[]X--------E-[]-----[]-------------XXXXX----------------------------------------------------------------------E-[]----E------------------E-[]-----E-------E------X--E--[]-----EE-E--[]--[]----[]---------------------------------------------XXXXX-------------SSSSSSSSSSSSSooSSSS----EE-EE--EE---XXXXXE-XXXX-----------------------------------------------------E-----[]-----EE------[]-E--[]-E---------X-E-EE---[]-----------EE----X---EE-E--[]--[]--[]--EE-E-------E--------E----------------------E---XXX--X--XXXX--XX--------XXXXXXXXXX------XXXX-------------------------oo--EE-----[]--[][]--[]-------------E-EE-------E---XXXXXXX-[]--[]-------[]-----[]---------[]----[]-------------------[]-----E--E-[]--[]----[]-E-------E---------[]-----[]---E----[]----------------------------------------------------------------------------------[]----[]-----------------E----[]-E--[]-----E--[]-S--[]------------------------ooSSSSSSSSSSSSSooSS-----------------------------E-EE-E--E-------------------------------------------------E-EE-E------------------------------[]----oo---------------------------XXXX---XX---------------------XXXX------S----------EE-E----------E-EEX-X-X---------------[][][]----[]-------------------XX?-XXXX------------XXXXX-XXS----------E--E-----[]--[]------------------------XX--XX----EE-E-XX--------EE-E--EE-----[]XXXXXE--------[]-------E----XXXXX-[]-E--[]------[]------[]---
X-XXX------XXXXXXXX-XXXXXXXXXXXXXXXXXXXXXXXXXXXXXXXX----X--XXXXXXXXXXXXXXXXXXXXXXXXXXXXXXXXXXXXXXXX-XXXXXXXXXXXXXXXXXXXXXXXXXXXXXXXXXXXXXXXXXXXXXXXXXXXXXXXXXXXXXXXXXXX-XXXXXXXX---XXXX------XX-X-XXXXXXXXXXXXXXXXXXXXXXXXXXXXXX-XXXXXXXXXXX------XXXXXXXXXXXXXXXXXXXXXXX----XXXXXXXXXXXXXXXXXXXXXXXXXXXXXXXXXXXXXXXXXXXXXXXXXXXXXXXXXXXXXXXXXXXXXXXXXXXXXXXXX-XXXXXXXX-X---XXXXXXXXXXXXX-----------X-XXXXXXXXXXXXXXXXXXXXXXXXXXXXXXXXXXXXXXXXXXXXXXXXXXXXXXXXXX-XXX--XXX----XXXXXXXXX--XXXXXXXXXXXXXXXXXXXXXXXXXXXXXXXXXXXXXXXXXXXXXXXXXXXXXXXXX--XXXXXXXXXXXXXXXXXXXXXXXXXXXXXXXXXXXXXXXXXXXXXXXXXXXXXXXXXXXXXXXXXXXXXXXXXXXXXXXXXXXXXX-X-XX--XXXXXXXXXXXXXXXXXXXXXXXXXXXXXXXXXXXXXXXXXXXXXXXX------------------------XXX-XXXXXXXXXXX-XXXX--XXXXXXXXXXXXXXXXXXXXXX-XXXXXXXXXXXXX--XXX-XXXXXXXXXXXXXXXXXXXXXXXXXXXXXXXXXXXXXXXXXXXXXXXXXXXXXXXXXXXXXXXXXXXXXXXXXXXXXXXXXXXXXXXXXXXXXXXXXXXXXXXXXXX-XXXXXXXXXXXXXXXXX--XXXX-XXS-XXX---------------X---------XXXXXXXXXXXXXXXXXX---XX---------XXXXXXXXXXXX-XXXXXX-----XXXXXXXXXXXXXXXXXXXXXXXXXXXXXXXXXXXXXXXXXXXXXXXXXXXXXXXXXXXXXXXXXXXXXXXXXXXXXXXXXXXXXXXXXXXXXXXXXX--XXXXXXXXXXXXXXXXXXXXXXXXXXX----XXXXXXXXXXXXXXXXXXXXXX--XXXXXXXXXXXXXXXXX---XXXXXXX-XXXXXXXXXX---XXXXXXXXXX------------------XXXXXXXXXXXXX--XXXXXXXXXXXXXXXXX--XXXXXXXX-------XXXXXXXXXXXXXXXXXXX---XXXXXXXXXXXXXXXXXXXXXXXXXXXXXXXXXXXXXXXXXX---XX--XXXXXXX-XXXXXXXXXXXXXXXXXXXXXXXXX--XXXXX-XXXXXXXXXXXXXXXXXXX-XXXXXXXXXXXXXXXXXXXXXXXXXXXX-EXXXXXXXXXXXXXX-X-XXXXXXXXXXXXXXXXXXXXXXXXXXXXXXXXXXXXXXXXXXXXXXXXXXXXXXXXXXXXXXX--XXXXXXXXXXXXXXX