-----------------------------------------------------------------------------------------------------------------------------------------------------------------------------------------------------------------------------------------------------------------------------------------------------------------------------------------------------------------------------------------------------------------------------------------------------------------------------------------------------------------------------------------------------------------------------------------------------------------------------------------------------------------------------------------------------------------------------------------------------------------------------------------------------------------------------------------------------------------------------------------------------------------------------------------------------------------------------------------------------------------------------------------------------------------------------------------------------------------------------------------------------------------------------oX--S--?-----------------------------------------------------------------------------------------------------------------------------------------------------------------------------------------------------------------------------------------------------------------------------------------------------------------------------------------------------------------------------------
-----------------------------------------------------------------------------------------------------------------------------------------------------------------------------------------------------------------------------------------------------------------------------------------------------------------------------------------------------------------------------------------------------------------------------------------------------------------------------------------------------------------------------------------------------------------------------------------------------------------------------------------------------------------------------------------------------------------------------------------------------------------------------------------------------------------------------------------------------------------------------------------------------------------------------------------------------------------------------------------------------------------------------------------------------------------------------------------------------------------------------------------------------------------QS------oX--XSXX---XEX---------------------------------------------------------------------------------------------------------------------------------------------------------------------------------------------------------------------------------------------------------------------------------------------------------------------------------------------------------------------------------
--------------------------------------------------------------------------------------------------------------------------------------------------------------------------------------------------------------------------------------------------------oo-----------------------------------------------------------------------------------------------------------------------------------------------------------------------------------------------------------------------------------------------------oo-------------------------------------------------------------------------------------------SSSSSSSSSSSSSSSSSSSSSSSSSSSS------------------------------------------------------------------------------oo------------------------------------------------------------o------------------------------------------------------------------------------------------------------------------------------------------------S---------------------------ooo----------------------------------------------------------------------------------------------------------------------------------------------------------------------------------------------SSSS----X--XX-ES---------o------------------------------------------------------------------------------------------------------------------------------------------------------------------------------------------------------------------------SSSSSS----------------------------------------------------------------------------------------------------------------------------------------------
----------------------------------------------------------------------------------------------------------------------------------------------------------------------------------------------------------------------------------------------X-----------X-----------------------------------------------------------------o---------------------------------------------------------------------------------------------------------------------------------------------------------------------------------XXXX--------------------------------------------------------------------------------------------------------SSSSSSSSSSSSSS----------------------------------------------------------------------------------E--------------------------------------------------------------------------------------------------------------------------------------------------------------------------------------------------------------------------------------XXXX------------------------------------------------------------------------o---------------------------------------------------------------------------------------------------------------------Q-----X-X-XX---------XXXX-------------------------------------------------------------------------------------------------------------------------------------------------------------------------------------------------------------------------------------------------------o----------------------------------------------------------------------------------------------------------------ooo-
---------------------oooo-----------------------------------Eoooo------------------------------------------------------------------------------------------------------------------E-----------------------------------------------------------------------------------------------------------------------------------------------------------------------------------------------------------------------------------------------------------------------------------------------------------------E----------------------------------------------------------------E---------------------------------------------------SSSSSSSSSSSSSS---------------------------------------------------------------------------------XXX---------------------oo------------------------------------XX---o----oooooooooo---------------------------------------------------------------------------------------------------------------------------------------------------------------------------------------------------------------------------------------oo--------------------------------------------------------------------------------------------------------------------XXXX--------XXX---------------------------ooo---------------------------------------------------------------E-----------------------------------------------------------------------------------------------------------------------------------------------------------------------------------------------------------------------------------------------------------------------------------
---------------------XXXX---------S-------------------------XXXXX---------X---------SS----------------------SS------E------QQQQ-------------------------------------------SSS-----SQS---SS-------------XXXX-----------------------o-----------------------------oo--XXX--------------------------------SSSS------------------------------------------------------S---------SSSSSS---------------??---------?------------------------------------XXX----------------?-------------------------?SSS---SQS--------XXX------------------S---SSSSSSSS---------------------S?S-SSS---S---------------------------------------SSSSSSSSSSSSSSSSSSS-------SSS--------?----------------------------------------oo---X-------o---XXX-----XX-oo------------------------------------------QQQQ---o------------XX-------------------------------------SSSS-------------Q---------------------------------------------------------------------------------------------------------S-------------------S------?---------------------SS---SS--------------SSSSS---------------------E-----o-------------------------------S?S--------SSS--S?SSSSS------------------------------ES----XX-------------------SSX----------------------XXXX-------------------------------------------------------------S?SSS---SSSSS-----QQQQQ--SS-----E--S---------?-------------E-------QQ-S---?---------------?QQS----------------------------------------------------------SSSS--SSS---SSS---------------------------------------------XX------------------SS-------------SS-------------------SS---SS--
---------------------------------------------------------------------------------------------------------------------XX-------------------------------------------------------------------------------------------------XSSS------------------------XX---------------------X--------------------------------------XX-------------------------------------------------------S-----------------------XXX---------------------------------------------------------------------------oooo--------------------------XXX-----------------------------------------------------------------------------------------------------S--------------------------------------------------------------------------------E-----------------------------------X------------------------------------------------------XXX------------------------------------------XXS------------------------------------------------------------------------------------------------------------------------------------------------------------ooo--E----------------------------------o----------XXXXXX-------------------------------------------------------------------------------------<>S-------------------------------------------------------X---------------------------------------------------------------------------------------------------------------o-----<>---------------------------------------------------------------------------------------------------------------------oooo-------------------------------XX------------------------------------------------------SS---S---
---------------------------------------------------E-------------------------------------------------------------XX--o-------------------------------------------------------------------------------------------------XXX---------------XX--------XXX----------------------------------------------------------XXXXXX-XXX-XX----------------------------------------------------------------------------------------------------------------------------------------------------------------------------------XXX---------------------------------X-------------------------------------------------------------------S-------------------------------------------------------------------------------------------------------------------------------------------o------------------------------------------XX--------------------------------oo---------------------------------------------------------------------XX----------------------------------------------------------E------------------------------------------------------------------XXXXXX--------------XX--------------------------------E------------------------------------------------[]S----------------XXX------S----------------------------XX------------------------------------------------------------------------------------------------------------------S--[]-----------------------------------------------E------X-------------------------------------------------------------------------------------------------XX---------------------------------------------------------------
oo----o-------------------------------------------<>-------------------------------------------------------------XX-------------------------SS------------------------------------------------------oo----------------XXXS----------------------EXEXXX----------------------------------------------------------XXXX-------------------------------------------------------------------------------------SQSQ------------------------------------------------------------------E-----S--------------------E-E--XXX---------------------------------X---------------------------X----------------------------------------?ooooooooo---------E----------------------------------------------E-------------------------------------------------------------------------EE--------------------------------------------------------E------------X-X-------------------------------------E------------------------------------X-----------------ooo----------------------------------E--<>-------------------------------------------------------------------------------------------------------E---------E-------------------------------------------------------[]S----------------S------XSS-----------------E---------XXX------------E-------------E-------------------E---XX-----------------------------------E--X-----------------E-----S--[]-------------------------------------------E--<>-----XX--SQ--------------------------------------------------------E----------------------S---E----E-EX-XXX-----------------E--------E--------------------------S----E---
-------------------------------Q---QQQ-----E------[]----Q--------------------SSSSS-------------------------------XX--------S?S-----------------------------------------X-------QQQQQQ--QQQ-----S---------------------XXXXX----------XXXX-----------XXX------------XXXX----------------------------------S?S---XXXXXX----------ooo------------EE------------------SS------SSS--------QQQ-Q--Q--Q----------o-o--------X--X-----------X-----------------------------Q-Q----------<>-----------------XXX----S------XXX----------------------SS----X---XXQQ---------------S-------XXX----------------------QQ---------X------??SSSSSSSSSSS-----<>------QQ---------------------------E--------E<>------------XXXXXX------------XXXXXX----XXXX-------XXX--XXX-----SSSSSSSSSSSSS-----QQQQ-----------XXXX-----------------------------<>-----------XX-XX--------S?S--------------o---------<>X--X----------XX----Q-------------X-X-------------------------------E----------SSS-----E--<>--[]------XXX-------------------X---Q---S?SS-------E--S---------XX------oo--oo----------------------------<>---E----<>---ooQ-------XX--X---SSS--------------------------E----[]S----------------------XXX---QQQQ----------<>--------XXXX-----------<>-------E----<>------------------<>---XXXX-----SQS-----S----------QQQQ----<>------?S-----------<>----S-S-[]SS--E?QQQ--QQQQ---------------SQQQ--------<>--[]----XXX--S---ES----XX-----------------------E-----------XSS-------<>---------------XX-------------------XXX----------------<>-------<>----------S-------XX--X--------SSS-
------------------------o--X--------------<>------[]------------------------------------------------------------XXX---------------------------------------------------XX--------------------------------------------XXXXXX-SSS--------------o------XXX-------------------------------------------------------EXXXXXX-------X----EE--------XXXXXX--------------------------SS---------------------------------------XX--XX---------XX------XX----------------------------------[]---------X---------------------XXX-------------------------E--XX--XX----------X-------------EXXX---E----------------------------XX------------------------[]----------------------------------<>-------<>[]----------------------------------------------------------------SSSSSSSSSSSSS-----------------------------------------------------[]-------E--XXXXXX-----------------------------------[]X--XX--------XXX------------------XXX-----------------------------------X-----------------[]--[]----------------------------------------------<>-----------S-------------E----------------------------[]--<>----[]------------XXX--XX--E-------X-------------------<>----[]S----XXXXXX-----------XXXX-----------------[]-------XXXXX-----------[]------<>----[]------------------[]-XXXXXX--------------------------------[]-------------------[]------E-[]------------------------------------------[]--[]---XXXX------E--E--XX----------------------<>-----------X---------[]--------------XXX--------------X----XXX----------------[]-------[]----------------XXXX--XX-----E--EE-
-----------------XXX---XXXXX--------------[]------[]------------------------------------------------------------XXX--------------------------------------------------XXX-------------------------------------------XXXXXXX--------------XX-XXXXX---XXX------------------------------------------------------XXXXXXXX-----XXXXXXXXXX---------------------------------------SS---------------------------Q-----------XX--XXX-------XXX------------------------------------------[]---------X---------------------XXX--------------------------X-XX--XX---------XXX----------EXXXXX--<>---------------------------XXXX-----------------------[]----------------------------------[]-------[][]-----X-------------------------------o--------------------------SSSSSSSSSSSSS------------------------------XXXX-------------------[]------<>-XXXXXXX----------------------------------X[]X--XXX------XXXX------------------XXX-----------------------------------X-----------------[]--[]----------XXX---------------------------------[]----------SS----XXXXXXXXXXX---------------------------[]--[]----[]----------EXXXX--XXX-----E---X-------------------[]----[]S--------------------XXXXX-----------------[]------XXXXXX-----------[]------[]----[]------------------[]-XXXXXX--------------------------------[]------------<>-----[]--X-----[]------------------------------------------[]--[]-EXXXXX------------XXX---------------------[]-----------X---------[]------------EXXXX--------------X----XXX----------------[]-------[]---------------XXXXX--XXX----------
----------------------XXX-----------------[]--E---[]------------------------------------------------E-EE--------XXX---------------E-------E-------------------------XXXX----------------------E----------o--------XXXXXXXX--SX?-XXooo--------------XXX--E-------------------------------------E-E------EE--XXXXXXXXX-----XXX----------------------E--EE-E------E----------SS----------------------E--------E-----XXXX--XXXX-----XXXX--------------------EE----------------EE--[]---------X---------------------XXX---------------E--EE-----XX-X---XXE-------XX-E-----E----XXXXXX--[]--------------------------XXXX--------------EE-----E--[]-----------------------------EE-E-[]-------[][]------XX---o-o--------E------------XXXX-----------------------------SSSSSSSSS------------XXXXXXXX-----------------------E--E------[]------[]XXXXXXXX-------E-E------------------EE-E-XX[]X--XXXX--E-XXXXX----EE-E-----EE---XXX-----------------------------------X-E---E--------E--[]--[]--------------------------------EE---------E--[]-E---------S--------------------------------E-E-------[]--[]-E--[]-EE-------XXXXX--XXXX-------XX---E-EE------------[]----[]S-------------------XXXXXX-----------------[]-----XXXXXXX---------E-[]------[]----[]-E-----E-E-----E--[]--XXXXX--------------------------------[]------------[]-E---[]--X--E--[]---------E-E--------------E-EE------------[]--[]XXXXXXX------------XXX--E-E----E-----------[]-----------XE--------[]------------XXXXX--------------X----XXX----------E-----[]-------[]---------EE---XXXXXX--XXXX---------
XXXXXX--XXXXXXX---XXXXX-----XXXXXXXXXXXXXXXXXXXXXXXXXXXXXXXXX-X-XXX-----XXXXXXXXXXXXXXXXXXXXXXXXXXXXXXXXXXXXXXXXXXX--XXXXXXXXXXXXXXXXXXXXXXXXXXXXXXXXXXXXXXXX---XXXXXXXXXXXXXXXXXXXXXX--XXXXXXXXXXX-XX-XXX--XXXXXXXXXXXXXXXXXXXX-XXX--------------XXXXXXXXXX-XXXX---------XXXXXXX-------XXXXXXXXXXXXXXXXXXXXXXXXXXXXXXXXXXX------------XXX------XXXXXXXXXXXXXXXXXXXXXXXX-SXXX-XXXXXXXXXXX----XXXXXXXXXXXXXXXXXXXXXXXXXXXXXXXXXXXXXXXXX-------XXXXX--XXXXXXXXXXXXXXXXXXXXXXXXXXXXXXXXXXXXXXXX-XXXX---XXXXXX---XXXXXXXXXXX--XXXXXXXXXXXXXXXXXXXXXX--XXXXXXXXXXXXXXXXXXXXXXXXXXXXXXXXXXXXXXXXXXXXXXXXXXXXXX----XXXXX---XXXXXXXXXXXXXXXXXXXXXXXXXXXXXXXXXXXXXXXXXXXXXXXXXXXXXXXXXXXXXXXXXXXXXXXXXXXX--------------XXXXXX-X----------------------------------XXXXXXXXXXXXXXXXXXX-XXXXXXXX----------------------------XXXXXXXXXXXXXXXXXXXXXXXXXXXXXXXXXXXXXXXXXXXXXXXXXXXXXXXXXXXXXXXXXXXXX--XXXXXXXXXXXXXXXXXXXXXXXXX---XXXXXXXXXXXXXXXXXXXXXX-----XXXXXXXXXXXXXXXXXXXXXXXXXXXXXXX-XXX-XXXXXX----------------------------XXXXXXXXXXXXXXXXXXXXXXXXX--X----------------------------XXXXXXXXXXXXXXXXXXXXXXXXXXXXXXXXXXXXXXXXX--XXXXXXXXXXXXXXXXXXXXXXXXXXXXXXXXXXXXXXXXX-XXX-------XX--X-XXXXXXX---XXXXX---XXXXXXXXXXXXXXXXXXXX-X---XX-XXXXXXXXXXXXXXXXXXXXXXXXXXXXXXXXXXXXXXXXXXXXXXX-XXXXXXXXXXXXX----XXXXXXXXXX--XXXXXXXXXXXXXXXXXXXXXXXXXXXXXXXXXXXXXXXXXXXXXXXXXXXXXXXXXXXXXXXXXXXXXXXXXXXXXXXX-XXXXXXXX----XXXXXXXXXXXXXXXXXXXXXXXXXXXXXXXXXXXXXXXXXXXXXXXXXXXXXXXXXXXXXXXXXXXXXXXXXXXXXXXXXXXXXXX--XXXXXXXXXXXXXXXXXXXXXXXXXXXXXXXXXXXXXXXXXXXXXXXXXXXXXXo--XXXXXXXXXXXXX