------------------------------------------------------------------------------------------------------------------------------------------------------------------------------------------------------------------------------------------------------------------------------------------------------------------------------------------------------------------------------------------------------------------------------------------------------------------------------------------------------------------------------------------------------------------------------------------------------------------------------------------------------------------------------------------------------------------------------------------------------------------------------------------------------------------------------------------------------------------------------------------------------------------------------------------------------------------------------------------------------------------------------------------------------------------------------------------------------------------------------------------------------------------------------------------------------------------------------------------------------------------------------------------------------------------------------------------------------------------------------------------------------------------------------------------------------------------------------------------------------------------------------------------------------------------------
------------------------------------------------------------------------------------------------------------------------------------------------------------------------------------------------------------------------------------------------------------------------------------------------------------------------------------------------------------------------------------------------------------------------------------------------------------------------------------------------------------------------------------------------------------------------------------------------------------------------------------------------------------------------------------------------------------------------------------------------------------------------------------------------------------------------------------------------------------------------------------------------------------------------------------------------------------------------------------------------------------------------------------------------------------------------------------------------------------------------------------------------------------------------------------------------------------------------------------------------------------------------------------------------------------------------------------------------------------------------------------------------------------------------------------------------------------------------------------------------------------------------------------------------------------------------
SSSSSSSSSSSSSSSSSSSS----SSSSSSSSSSSSSSS--S-SSSSSSSSSSSSSSSSSSSSSSSSSSSSSSSSSSSSSSSSS----------------------------------SSS---------------------------------------------------------------------------SS------------------------------------------------------------------------------------------------------------------------------------------SSSSSSSSSSSSSSSSSSSSSSSSSSSS-----------------------------------------------------------------------------------------------------------SSSSS--------------------------------------------------------------------------------------------------------------------------------------------------------------------------------------------------------oo----------------------------------------------------------------------------------------------------------------------------------------------------------------------------------------------------------------------------------------------------------------------------------------------------------------------------------------------------------------------------------------------------------------------------------------------------------------------------oo----------------------------------------------------------------SSSSSSSSSSSSSSSSSSSSSSSSSSSS----------------------------------------------------------------------------------------------------------------------------------------------------------------------------------------------------------------------------------------------------------------------------------------
-----------------------------------------SSSSSSSSSSSSSSS---------------------------------------------------------------------S------------------------------------------------------------------------------------------------------Q-----------------------------------------------------------------------------------------------------------------------------------------------------------------------------------------------------------------------------------------------------------------------------------------------------------------------------------------------------------------------------------------------------------E-E--E--------------------------------------------------E-------------------------------------------------------------------------------S-----------------------------------------------------------------------------------------------------------------------------------------------------------------------------------------o-----------Q-----------------------------------------------------------------------------------------------------------------------------------------------------------------------o--------------------------------------------o--o---------------------------------------------SSSSSSSS--SS--------------------------------------------------oo-SS---------------------------------------------------------------------------------------------------------------------------------------------------------------------------------------------------------------------------------
-----------------------------------------SSSSSSSSSSSSSSS--------------------------------------------E-----------X---E?-----S--------------------------------------------------------oooooooo-oo---------------------------------------------------------------------------------------------E-------------------------oo-----------------------------------------------------------------------------------------------------------------------------------------------------------------------------------------------------------------------------------------------------------------------------------------------------ooooo-------------XXXXXXXXX-----------------------------------------------XXX-XXX------------------------------------------XX--------------------------X-SSS---E------------------------------------------------------------------------------------------------------------------------------------------------------------------------------------XXX----E---------------------------------------------------------------------------------------------------------------E-----------oo-------------------------------------------------------------------------------------------------------------------------------------------?--SSSSSSSS--SS--------------------------------------------------XX-SS-------------------------------------------------------------E-------------------------------------------------------------------------------------------------------------------------------------------------------------------
--------------------------XX-oo-------------SSSSSSSSSSSS--------------------------------------------E--E-----------SSS??-S-S----<>------------------------E-----ooo----------------------------------QQQ-------------SSSSSSS-------Xoo--XXXX--------XXX--------?----------------SSS---------ES-----SQSSQ--SSSS----------------------------------Q-Q------------------------------------------------------------------------------------------QQQQQ------------------S-------SSSQSSSSS?SSS-----------------------SSS------------------------------------------------SSSSS-----SSS----------SSS---------------------------------XXXX----------------------------------X-------------------------------------------------------SSSSQ----------------------------SSSSSS-------------------SS---SS-------SSSS-------S---?-----------------------------------------------------------------------------------------------------------------------------SSS-----SS-----------------------------S---S-----?-----------------------------------SSSSS-----Q?SSS-------SS------------------------------------------SS--SQS----------------S----SSSSQS--------SQSS---?SSS-------oo--XXXX-----------------SSS-----------------SSS--------QQS--------------SSSS--SSSQQ-----------------SSS---S-----------Q-----------------------------------------------------------------------------SQSSSSSS-----------------SSQ---?--SSSSS-----SSSS---QSSSS---------SSSSSS----S--------------------------------SSS------------------------------------------------------------S--------S----------
------------------------------------------------------------------------------------------------------XXXXXX--------------------[]------------------------------------------------------------------------------------------------XX----------------XXX--------------------------------------------------------------------------------o---------------------------------------------------------------------------------oo---------------------------------------------------------------------------------------------------------------------------------------------------------------------------------oo-------------------------------------------oo------------------------------------------------------oo-------------------------------------------------<>----------------SS---SS----------------------------------------------------------------------------------------------------------------------------------------------------------------------------------------------------------------------------------------------------------------------------XXX----------------------------SS--------------------------------------------------------XXX----------X---------------------------------------------------------------------S-------------------SSS--------------------------------------------oooo---------------------------------------------------------------------------------------------------------------------------------------------------------------------------------------------------------------------<>---------------------
----oo----------------------------------------------------------------------------------------------------------SSS-------------[]-------------------XXX-------------------------------------------------------------------------------------------XXXX---------------------------------XX------------------------------------------------------S---------------------------------------------------------------------------------------------------------------------------------------------------------------------XX-----------------------------------------------------------------------------------------------------------------------------------E----------------------ooo--------------------------------------------------------------------XX---------[]--o--------------S---SS------------------------------------------------------------------------------------------------------S---------------------------------------------------o---------------------X--------------------------------------------------------------------------------------------o----------------------------------------------------------------------------------------------------------------------------------------------------------------E--------SS-------------------SS---------------------------------------------------XX-----------------------------------------------------------------------------------------------------------------------------------------------------------------------------------------------------------------[]-S-------------------
--------------------------------XXX-SS------------------------------------------------------------------------------------E-EE--------------------------------------------------------------------------------------------------------------------XXXXX--------------------------------XSX--------------------------------------XXXX----------------------S-----o------------S----------S---------------SSSSSS---------E--S-SS------------E---------------E--------------SS--------------------------------E---------XXX---------------------------------------E------------------------------------------------------------------------S-----------------<>-----------------------------------------------------------E---------------oo----------------XX---------[]--------------X--So?-SS----------------------------------E----------XX---E-------------E---o-----------------------------------S--Q--------------------------------------------------------------------X----------ESQSSS--------------S----------Soo----------------------SSSSSSS------E-----------------------------------E------SS---o---------E--SSSSSSSS-----------------------------------------------------------------------------------S--------S--------E--<>--------S----------------o??-SSS-?-----E---------------------E------------E-------XX----------------------------------E------------------------------?-So-------------------------------------------------------oo----------------------------------------------------------ooo--------------------SS[]-------o-------------
-------------------------------XXXX--S---SSSSSSSSSSSS-----------------------------------------o-----------------SSSSSSSSSSSSSSSS--Q---------XX--------------XXXXXXXXX-----------------XXX------------SQS---------------SSSSSS--------XXX---SS-----XXXXX------ooo-------XXX-XX---------XXS--QQ--QQ?-SQSQQ--------------XXXX--------------XXX-----SSS----------------------------------------E---------X----------------<>-----------------<>-QESSQSQ------<>-------SSS--------ESSSSSSSSS-------------------<>--------XXXX-----E-------E---E--------------------<>--------------S-----------QQS------------E--------------------------------------XXXX---E--[]--------------XXXXXXXX-----------------------------E---E--<>------Q?SS-QQ------------QQQ----XXX-SS----S-XXX-------------X--SSS-SS------SQQQ--QQQ-----QQQ----------<>----------XX--<>------S-----<>-----------------------------------XXS------------------S-----<>------------E----XXX--SSSS-----------------X-XXXX----------S---SS------XX----------------o--o-----XX-XXX---------X------------X--XXX---SS----------------------E--<>-----QSS--S?S-------<>--------------S?S-----------QQQ--Q------------XXX---------------------S----E--S--------------SSS----SSS--E----<>--[]-----E--SSSS--------E----SS--SSSS-----<>---QQQQQQ---Q-------<>-----------<>-------XX-----S----------------------E----<>-----QQ---SQS------------------ESSS------QSQQ-----SSSS--------------E--S-------------------o--------------------X----S------------------------------------------------------SSSSSS------QQQ----------
------------------------------XXXXX--XX------------------------E-----------------------XX-----------------------SSSSSSSSSSSSSSSS-SS--------------o-----------------------------------------------------------------------------X-----E-----------XXXXXX---------------XXXX-XX--------XXXX------------------E-------------------X----------------------------------------------------------<>------X--XXX--------------[]------------X----[]--------------[]--------------------------------X-------E------[]-------XXXXX------------<>--<>--<>----------------[]----------------------------------------<>--------X-----------------------------------<>--[]--------------------------------------------------<>--<>--[]--------------------------------XXX--------------E----------------------------------------------------[]--------XXXX--[]------------[]-----------------------------------XXX---------------E--------[]-----------<>-----------------------------XXXXXXX---------------------XX---X---------------------XXXXXXX---------X------------X--------------X------E---------<>--[]--------------------[]---------------------------------------------------------XX----oo-o-------<>------------------SS--------<>----[]--[]----<>----------EXXX------------------[]--------------------[]-----------[]------XXX---------------------------<>----[]-----------------------E-------------------------------------------<>-------------------------------E---------XXX--------------------------E---XXXX--------------------------------------------------
------------------X---X---X--XXXXXX--XXX----------------------<>----------------------XXX-----------------------SSSSSSSSSSSSSSSS--o-------------XXXXX-----------------o-------------------XXXX--XXXX-----------X---------------X------------E---XXXXXXX--------------XXXXX-XXX------XXXXS-------------------------------------------------------------------------------------------------[]----X-XX-XXX--------------[]------------X----[]--------------[]----------------------------E---X------<>------[]------XXXXXX------------[]--[]--[]----------------[]----------------------------------<>----[]--------------------------------------------[]--[]--------------------------------------------------[]--[]--[]--------------------------------XXX--SSS--------<>----------------------------------------------------[]-------XXXXX--[]------------[]-----------------------------------XXX--------------<>--------[]-----------[]----------------X-----------XXXXXXXXX---------------------X---X---------X----------XXXXXXXX---------X------------X---X-X-------XX-----<>---------[]--[]--------------------[]-----------------------X---------------------------------X--------X-------[]------------------SS--------[]----[]--[]----[]---------XXXXX------------------[]--------------------[]-----------[]------XXX---------------------------[]----[]----------------------<>-------------------------------------------[]------------------------------<>--------XXXX-------------------------<>--XXXXX--------------------------------------------------
-------E----------E-E-X---X-XXXXXXX--XXX---------------EE-----[]-------EE-E-----X---XXXXX--------------------E--SSSSSSSSSSSSSSSS--S------E---------------------------XXX---ooo----------------------------------------------------ooo----------XXXXXXXX-------------XXXXXX-XXXX----XXXXXS-----------------E----------------XX-----------------------------------------------------E--E----[]-E--X-X--XXX--------------[]------------X-E--[]-E-------E-E--[]--------------------------------X-E--E-[]------[]-----XXXXXXX-EE-E-------[]--[]--[]---------EE-E---[]---------EE------------E----------[]----[]-E------------------------------------------[]--[]--------XXXXX-------------------------------------[]--[]--[]-----E--------------------------XXX-------------[]-----------------------------E-EE----------------E--[]-------XXXXX--[]----E-EE-E--[]--------EE----E-E--E-E---E---------XXX---E----------[]----X--X[]-S---------[]---------------XX---------XXXXXXXXXX----------------------X---X--------XX---------XXXXXXXXX--------XX---------XX-X---X----E---XXX-----[]---EE----[]--[]----E-E-------------[]-------------E---------X-E------------XX---oo------X-X-X-----SSSS---EE----[]-----------------E---EEEE---[]-E--[]--[]----[]--E------XXXXXE-----------------[]-E-EE-----E-E-------[]----EE-E---[]-E----XXX---------------------------[]----[]----------------------[]--------------------------------------EE---[]-E----------------------------[]--------XXXXE-EE---------E-----------[]-XXXXXX---------------------------E----------------------
XXXXXXXXXXXXXXXXXXXXXXXXXXXXXXXXXX---XXXXXXXXXXXXXXXXXXXXXXXXXXXXXXXXXXXXXXXXXXXX-XXXXXX----XXXXXXX-XX-XXXXXXXXXXXXXXXXXXXXXXXXXXXXXXXXXXXXX-------------------------------XXX----------------------XXXXXXXXXXXX---XXXXXXXXX-------XXX--XX-XXXXXXXXXXXXXXXXXXXXXXXXXXXXXX--XXXXXXXXXXXXXX---XXXXXXXXXXXXXXXXXXXXXXXX-------------------------XXXXXXXXXXXXXXXXXXX-XXXXXXXXXXX--XXXXXXXXXXXXXXXXXXXXX--SXXXXXXXXXXXXXXXXXXXXXXXXXXXX-XXXXXXXXXXXXXXXXXXXXXXXXXXXXXXXXXX--XXXXXXXXXXXXXXXXXXXXXXXXXXXXXXXXXXXXXXXXXXXXXXXX-XXXXXXXXXXXXXXXXXXXXXXXXXXXXXXXXXXXXXXXXXXXXXXXXXXXXXXXX---XXXXXXXXXX--XXXXXXXXXXXXXXXXX------XXXXXXX-----------XXXXXXXXXXXXXXXXX-XXXXX-XXXX------------------------------XXXXXXXXXXXXXXX-XXXXXXXXXXXXXXXXXXXXXXXXXXXXXXXXXX---XXX------XXXXXXXXXXXXXXXXXXXX-XXXXXXXXXXXXXXXXXXXXXXXXXXXXXXXXXXXXXXXXXXXXXXXXXXXXXXXXXXXXXXXXXXXXXXXXXXXXXXXXXXXXXXXXXXXXXXXXXXXXXXXXXX--XXXXXXXXXXXXXXXXXXXXXXXXXXXXXXXXXXXXXXXXXXXXX---XXXXXXXXXXXXXXXXXXXXXXXXXXXXXXXXXXXXXXXXXXXXXXXXXXXXXXXXXXXX-XXXXXXXXXXXXXXXXXXXXXXXXX-XXXXXXXXXXXXXXXXXXXXXX--XXXXXXXXXXXXXXXXXXXXXXXXXXX-XX--XXXXXXXXXXXXXXXXXXXXXXXXXXXXXXXXXXXXXXXXXXXXXXXXXXXXXXXXXXXXXXXX---XXX------XXXXX------SSSS-XXXXXXXXXXXXXXXXXXXXXXXXXXXXXXXXXXXXXXXXXXXXX-XXXXXXXXXXXXXXXXXXXXXXXXXXXXXXXXXXXXXXXXXXXXXXXXXXXXXXXXXXXXXXXXXXXXXXXXXXXXXXXXXXXXXXXXXXXXXX---XXXX--XXXXXXXXXXXXXXXXXXXXX-XXXXXXXXXXXXXXXXXXXXXXXXXXXXXXXXXXXXXXXXXXXXXXXXXXXXXXXXXXXXXXXXXXXXXXXXXXXXXXXX-XXXXXX--XXXXXXXXX--XXXXXXXX-XXXXXXXXXXXXXXXXXXXXXXXXXXXXXXXXX-------XXXXXXXXXXX--XXXXXXXXXXXXXXXXXXXXXXXXXXXXXXX