------------------------------------------------------------------------------------------------------------------------------------------------------------------------------------------------------------------------------------------------------------------------------------------------------------------------------------------------------------------------------------------------------------------------------------------------------------------------------------------------------------------------------------------------------------------------------------------------------------------------------------------------------------------------------------------------------------------------------------------------------------------------------------------------------------------------------------------------------------------------------------------------------------------------------------------------------------------------------------------------------------------------------------------------------------------------------------------------------------------------------------------------------------------------------------------------------------------------------------------------------------------------------------------------------------------------------------------------------------------------------------------------------------------------------------------------------------------------------------------------------------------------------------------------------------------------
-------------------------------------------------------------------------X-X--------------------------------------------------------------------------------------------------------------------------------------------------------------------------------------------------------------------------------------------------------------------------------------------------------------------------------------------------------------------------------------------------------------------------------------------------------------------------------------------------------------------------------------------------------------------------------------------------------------------------------------------------------------------------------------------------------------------------------------------------------------------------------------------------------------------------------------------------------------------------------------------------------------------------------------------------------------------------------------------------------------------------------------------------------------------------------------------------------------------------------------------------------------------------------------------------------------------------------------------------------------------------------------------------------------------------------------------------------------------------------------------------------------------------------------------------------------------------------------------
SSSSSSSSSSSSSSSSSSSSS-----------------------------------SSSSSSSSSSSSSSSS-S-------Soo----------------------------SSSSSSSSSSSSSSSSSSSSSX-XS--S----------------------------SSSSSSSSSSSSSSSSSSSSSSSSSSSS---------------------------------oo-------------------------------------------------------------------------------------------------------------oo------------------------------------------------------------------------------SSSSSSSSSSSSSSSSSSSSSSSSSSSS-----------------------------------------------------------ooo------------------------------------------------------------------------------o-----------------------------------------------------------------------oo------------------------------------------------------------------------------------------------------------------------------------------------------------------------------------------------------------------------------------------------------------------------------------------------------------------------------SSSSSSSSSSSSSSSSSSSSSSSSSSSS------------------------------------------------------------------------------------------------------------------------------------------------------------------------------------------------------------------------------------------------------------------------------ooo-----------------------------------------------------------------------------------------------------------------------------------------------------------------------------------oo--------------------------------------------------
------------------------------------------------------------------------------------------------------------------SSSS---Q-?oS--SS?-SS?---oS---------------------------------------------------------------------------------------------E--E---------------------------------------------------------------------------------Xo-E--?-------------------E--E---------------------------------------------------------------------------------------------------------------------------------------------------------------XXXX------------------------------------------------------------------------------------------------------------------------------------------------------------------------------------------------------------------------------------------------------------------------------------------------------------------------------------------------------------------------------------------------------------------------------------------------XXX--------------------------------------------------------------------------------------------------------------------------------------------------------------------------------------------------------------------------------------------------------------------------------------------------------------------------------------------XXXX--------------------------------------------------------------------------------------------------------------------------------------------------------------------------------------E--E--------------------------------------------
-----------------------XX-----------------------------------------------------------------------------------------SSSS-EE--?SS--SS--SS----SS--------------------------------------------------------------------------------------------XXXXXXX--------------------------------------------------------oo-----------------------XXXX-------------------XXXXXXX---------------------------------------------------------------------------------------------------------------------------------------------------------------------------------------------------------E---------------------------------------------------------------------------------------------------oooo------------------------------------------------------------------------------------------------------------------------------------------------------------------------------------------------------------------------------------------------------------------------------------------o------------------------------------------------------------------------------------------------------------------------------------------------------------------------------------------------------------------------------------------------------------------------------------------------------------------------------------------oo--oo-------------------------------------------------------------------------------------------------------------------------------------------------------------------------------------E-------XXXXXXX------------------------------------------
----------------------------------------------XX----------------------------------XX------------------------------S----SS-----------SS--S-S------------SSS-----------------------------------------o-------------------------------------------------------------SS----SSS-------------SS?SSS------------------------------------XX--------------------------------------------------------------------------------SSS--SSSSSS----------------------------------------------------SSSSS-------SSS---------------------------------------------------SSSS-------E-------E--------SSSSQ---?------------?-QQ----------------------------------------SQQS----------------------XXXXX-----XXX----------------------------------------------------SSS-----------------------------------------------SS----------------------S--------------------S---------------------------------------------------------XX--------------------------------------E-----------oo---------------------------------------------------------Q---------------------------------------------SSSSSS------QS---------------------------?------------------SSS------------------SSSS-------------------------------------SSSSS----------o-----o-----------------------------------------Q-------------------S----------------------------oo--------------------------------------------SSS--?SSQQSSSS-------SSSS--SSSSSSSS----------------------------------------------------------S--------------------------------------SSS---SS-------SSS--------------------------------------------------------
----------------------------------------------XX----------------------oo-----------------------------------------------SS-----------SS----S----------------------------------------------------------------------------------------E--------------ooo-----------------------------------------------------ooooo-----------XXX--------------------------------------E------------------------------------------------------------------------------------------------------------------------------------------------------------------------------------------<>---------XXXX---------------------------------------------------------o----------------------------------------------XXX---------------------------------------------------------------------------------------------------------------------------------------------------------------<>---------------oo-------------------------------------------------------ooo-----------XXXXXX---------------------XX---------------------------------------------------------------------------------------------------------------------------------------------------------------------------------------------------------------------------------------------------------------XX---ES--------------------------------------------------------------------------------------------------------------------------------------------------------------------------------------------------------E----------------------------------------------------------------------oooo-----------------------------------
----------------------------------------------XX-----------------------X-----------------------------------------------SS-----------SS----SS-------------------------------------------------------S----------------------------XXXXXXXXX--------------------------------------------E--------------------------------XXX--o--------------------------------------<>------------------------------------------------------------------------------------------------------------------------------------------------------------------------------------------[]-----------------------------------------------------------------E--------------------------------------------------XXXX----------------------------------X-------------------E------X-------------------------------------------------------------------------------------------------[]----------------------------------------------------------------------------XXXXXXX---------------------------------------------------------------------------------------------------------------------------------------------------E-------------------------------------------------------E--------XXXXXXXXX----------------------------------------------------------------XXXX------Q---------S-------------------------------------------------------------------------------------------------------------------------------------------------------------------------------------------<>-------------------------------------------------------------------------------------------------------------
---------------------E---XX--oo---------------XX-----------------------XS------------------------------------------ooooSS----oo---?-SS----SS-----------------------------------------------------XX---------------E-------E---------------------------------------------------------<>--SSS-----------------------------------------------------------------------[]----------E--------E-------------------------------------E------------------------------------------oo------------------SSSSSSS-----------------------------------------------------------[]--------------------------------------------XXXX----------------<>----------------------------E--------------------XXXXX----------------------------------XX-----------------------XXX---------------------------E---------------------------------------------------------------------[]-----------E----------------------------------------------------------------------------------------------------------------------------------------------------------S-----------------------------------------------------------E--<>------oo-S-SQS-------------------------------E--------------------------------------------o-----------------------------------------E----XXXX--------------------------------------------------o------------X-------------------------------E------------------------------------------------------------E-------E-E------------E---------o--------------[]-------------------------------------------------------------------------------o--------------oo-------------
--------------------<>--XXX-------------------XX------------------------------------------S------------------<>-X--SSSSSSS----------SS--SSSS----Q----------------------XQQQ---------------------XXX----E---------<>------<>-------------------------------------SSS----------SS-----[]-------oQQQQQQ---------------------------------------------------------E<>--[]---------<>-------<>------E------------------------XXX-SSSSS------------------------------------------------SS----------------------------------------------------------------------------XXX--Q-Q-------------SSS------Q--Q-QQ---QQQ--------------------E--[]-----------Q--QQQQQ--------<>-------------------XXXXXX---------------------------------<>X----------------S?S---XXXX--------------S-----------<>---------------------------E-------SS--------E----------SS--E-------SXXX--E------<>------------EE-------------------------------XXX-------------XXX------ooo-----------------------XXX--------------------------------------------SS-----XX-------------------Q------E--------S?-----------QQQ----------<>--[]-----------o---------------------------E----<>---E--SSS----Q--------------------------<>---E----------------XXXX--SS---------------------XX-X--------------SSS---------------X---------------------------------------XXX-------------------<>--------X--XX---SSSSSS--SSSS-------E-----------------------<>---E--<>-------------<>-----<>---S----E--S-----[]----------S-------------------------E----------------S------------E--S-------------------------------------SS
--------------------[]-XXXX------------------XXX------------------XXXX----------------------E----------------[]-------------------------------------------------------XX-----------------------XXXX---<>---------[]------[]------------------E--------------------------------------[]-------------------------------------XXX-?----------------------------<>[]--[]-----E---[]-------[]-----------------------------------E----------E-----S----------------X---------------------------------------------------S-------------------------------E--------------------------------------------------------------------------<>--[]---------------------------[]------------------XXXXXXX---------------------------------[]X---------------------XXXXX--------------------------[]--------------------------<>----------------<>------E---S--<>------------<>------[]--------XXXXXXXXXXX---------XXX-----------------S----------------------EE-----o-----------------------------------------E---------E-------XXX--------XXX-------------------------<>----------------------------------[]--[]--------------------------------------<>----[]--<>------------------------------------[]-----------------E-------------------------------XX-X-------X--------------E---------XX-------------E------------E---------------------------------[]------XXX--XX----------------------EE-E--------------------[]--<>--[]-------------[]-----[]------E<>--------[]-----------------------------------<>-----------------------E----<>----------XXX---------------------E-------
--------------------XXXXXXX------------------XXX-------------------------------------------------------------[]-------------------------------------------------------XX----------------------XXXXX---[]---------[]------[]---------------------------------------------------------[]----------------------------------------------------------------------[][]--[]----<>---[]-------[]-------X-------------------X---X-------E----X<>----------------------X---------------------------------------------------S------------------------------<>--------------------------------------------------------------------------[]--[]---------------------------[]-----------------XXXXXXXX--------------------------------X[]X--------------------XXXXXX--------------------------[]---------------<>---------[]----------------[]-----<>------[]------------[]------[]-------------------------------------XXXX------------------------XXXXXXXXX---XXXXX-------------------------------------<>--------<>------XXXX-------XXXX-------------------------[]----------------------------------[]--[]--------------------------------------[]----[]--[]----<>------------------------------[]------<>--------<>------------------------<>-----XX-X-------X-------------<>------<>-XSX-----------<>-----------<>--------------------XXXX---------[]-----XXXX--XX----------------------------------------------[]--[]--[]-------------[]-----[]-----<>[]--------[]---------------------X-------------[]----------------------<>----[]---------------------------------<>-------
--------------------XX--XXX----------E----E--XXX-------X-----------------------------------E-----------------[]----E-E----------------E-------------------------------XX---------------------XXXXXX---[]----EE---[]------[]------------------------------------E-------E-EE---------[]-S----------------------E-EE-------------------------------EE---------[][]--[]----[]---[]----E--[]-------X-------E-----------X-E-X----------XXX[]----------------------X--------------------------------------------------SS------------E-EE----EE--------[]--EE--X-----------E-E-----------------------------------------------EE-E--[]--[]----E------E-E-------------[]-----E----------XXXXXXXXX-------X---------E--E-EE-------XX[]X-----EE-E------EE--XXXXXXX--------E-EE-E--E------E--[]-S-------------[]-------E-[]---E-E----------[]-E---[]------[]------------[]--E---[]----------------------------------------------------------------------------------------ooXXXXX------------------------[]--------[]------XXXX------XXXXX-------------------EE----[]------------------------------EE--[]--[]--------E----------E-----------------EXXE---[]--[]----[]-----------------------EE-E---[]------[]--------[]----------------------E-[]-----X--X------XX-----EE------[]-E----[]XXSX----EE-E---[]-----------[]------XXXX-----------------------[]-----XXXXE-XXX--------------------------------------EE-E---[]--[]--[]-------------[]-----[]-----[][]-E------[]-------E-E------EE------E---E-E----[]---------EE-E----E--E-[]----[]-E----------------EE-E-----------[]-------
XXXXXXXXXXXXXXXXXXXXXXX-XX------XXXXXXXXXXXXXXXXXXXXXXXXXXXXXXX---------XXXXX-------XXXXXXXXXXX---XXXXXXXXXXXXXXXXXXXXXXXXXXXXXXXXXXXXXXXXXXX-X-XX--XXXXXX------XXXXXXXXXXXXXXXXXXXXXXXXXXXXXXXXXXXXXXXXXXXXXXXXXXXXXXXXXXXXXXXX---XXXXXXXXXXXXXXXX-XXXX----XXXXXXXXXXXXXXXXXXXXXXXXXXXXXXXXXXXXXXXXXX--XXXXXXXXXXXX-----------XXXXX-XXXXXXXX---XXXXXXXXXXXXXXXXXXXXXXXXXXXXXXXXXXXXXXXXXXXXXXXXXXXXXXXXX--XXXXXXXXXXXXXXXXXXXXXXXXXXXXXXXXXX---XXXXXXXXXXXXXXXXXXXXXX-X---XXX-XXXXXXXXXXX-XXXXXXXXXXXXXXXXXXX--XX--XXXXXXXXXXXXXXXXXXXXXXXXXXXXXXXXXXXXXXXXXX-XXXXXXXXXX--XXXXXXXXXXXXXXXXXXXXXXXX--XXXXXXXXXX--XXXXXXXXXXXXX--XXXXXXXXXXXXXXXXXXXXXXXXXXXXXXXXXXXXXXXXXXXXXXXXXXXXXXXXXXXXXXXXXXXXXXXXXXXXXXXXXXXXXXXXXXXXXXXXXXXXXXXXXXXXXXXXXXXXX--XXXXXXXXXXXXXXXXXXXXXXXXXXXXXXXXXXXXXXXXXXXXXXXXXXXXXXXXXXXXXXXXXXXXXXXXXXXXXXXXXXXXXXXXXXXXXXXXXXXXXXXXXXXXXXX-XXXXX------X-X----XXXXX-----XXXX---------------------XXXXXX--------------------------XXX-------------------------XXXXXXXXXXXXXXXXXXXXXXXXXX--XXXXXXX?----XXXXXX---XX-XXXXXXXXXXXXXXXXXXXXXXXXXXXXXXXXXXXXXXXXXXXXXXXXX-XXXXXXXXXXXXXXXXXXXXXXXXXXX---XXXXXXXXXXXXXXXXXXXXXXXXXXXXXXXXXXXXXX--X-XX---XXXXXXXXXXXXXX-XXXXXXXXXXXXXXXXXXX-----XXX-XX---XXXXXXXXXXXXXXXXXXXXXXXXXXXXXXXXXXXXXXXXXXXXXXXXXXXXXXXXXXXXXXXXXXXXXXXXXXXXXXXXXXX-----------XXXX-----------XXXXXXXXXXXXXXXXXXXXXXXXXXXXXXXXXXXXXXXXXXXXXXXXXXXXX--XXXXXXXXXXXXXXXXXXXXXXXXXXXXXXXXXXXXXXXXXXXXXXXXXXXXXXXXX-XXXXXXXXXXXXXXXXXXXXXXXXXXXXXXXXXXXXXXXXXXXXXXXXXXXXXXXXXXXXXXXXXXXXXXXXXXXXXX-----XXXXXXXXXXXXXXXXXXXXXXXXXXXX