------------------------------------------------------------------------------------------------------------------------------------------------------------------------------------------------------------------------------------------------------------------------------------------------------------------------------------------------------------------------------------------------------------------------------------------------------------------------------------------------------------------------------------------------------------------------------------------------------------------------------------------------------------------------------------------------------------------------------------------------------------------------------------------------------------------------------------------------------------------------------------------------------------------------------------------------------------------------------------------------------------------------------------------------------------------------------------------------------------------------------------------------------------------------------------------------------------------------------------------------------------------------------------------------------------------------------------------------------------------------------------------------------------------------------------------------------------------------------------------------------------------------------------------------------------------------
------------------------------------------------------------------------------------------------------------------------------------------------------------------------------------------------------------------------------------------------------------------------------------------------------------------------------------------------------------------------------------------------------------------------------------------------------------------------------------------------------------------------------------------------------------------------------------------------------------------------------------------------------------------------------------------------------------------------------------------------------------------------------------------------------------------------------------------------------------------------------------------------------------------------------------------------------------------------------------------------------------------------------------------------------------------------------------------------------------------------------------------------------------------------------------------------------------------------------------------------------------------------------------------------------------------------------------------------------------------------------------------------------------------------------------------------------------------------------------------------------------------------------------------------------------------------
----------------------------------------------------------------------------------------------------------------------------------------------------------------------------------------------------------------------------------------------------------------------------------------------------------------------------------------------------------------------------------------------------------------------------------------------------------------oo----------------------------------------------------------------------------------------------------------------------------------------------------------------------------------------------------------------------------------------------------------------------------------------------------------------------------------------------------------------------------------------------------------------------------------------------------------------------------------------------oo----------------------------------------------------------------------------------------------------------SSSSSSSSSSSSSSSSSSSSSSSSSSSS----------------------------------------------------------------------------------------oo---------------------------------------------------------------------------------ooo--------------------------------------------------SSSSSS------SSSSSSSSSSSSSSS-----------------------------------------------------------------------------------------------------------------------------------------------------------------------------------------------------
--------------------------------------------------------------------------------------------------------------------------------------------------------------------------------------------------------------------------------------------------------------------------------------------------------------------------------------------------------------------------------------------------------------------------------------------------------------------------E--E-----------------------------------------------------------------------------------------------------------------------------------------------S?---------------------------------------------------------------------------------------------------------------------------------------------------------------------------------------------------------------------------------------------------------------------------------------------------------------------------------XXXX---------------o----------------------------------------------------------------------------------------SSSSSSSSSSSSSSSSSSSS----------------------------------------------------------------------------------------------------E--E---------------------------------------------------------------------------XXXX-----------------------------------------------------------------------------------------------------------------------------------------------o---------------------------------------------------------------------------------------------------------------------------------
-------------oo--oo--oo----------------------------------------------------------------------------------oo---------------------------oooo------------------------------------------------------------------------------------------------------------------X----------------------------------------------------------------------------------------------------------------------------------------------------------------------------------------------------------XXXXXXXXX----------------------------------------E-----------------------------------------------------------------------------------------E--------------------S----------------------------------------------------------------------------------------------------------------------------E----------------------------------------------------------------------------------ooXXX---------------------------------------------------ooooooo-------------------------------------------------XXX--------------------------------------------------------------------------------------------------SSSSSSSSSSSSSSSSSSS----------------------------------------------------------------------------------------------------XXXXXXX-------------------------------------------------------------------------------------------------------------------------------------------------------------------------------------------------------------------------------------------------------------------------------------------------------------------------------oo-----------------------------
-------------------------------S------?Q---------------------------------------------------------------------------XXXXX-------Xoo----XXXX---------------------------------------------------o------------------------XXX--------------------------------------SS---S---------------------------------------------------------------------------Q---------------SSSSSS------SS--SSS-----------------SSS-----------------------------SSSSSSSS?--SSSS--------------o------------------------------------------------------SS--SQS----------------------------SSSQ--------------------------------------------------SSS------------SS-----SS?SSS-------XX-----------------------------------QQQQQ------------QQQQQ------------------------------------E--SS---S-------SSS----S-------------------------QS---?-----------------------------------------------------------------S---SS-------------------------------------------------SSS-------------------------S--------------S---SSS---S-----------Q----------------------------------------SSSSSSQS------------SSSSSS------SSSSSSSSSSSSSSSSSSSS---------------------------------------------------------XX-----------------------E------------------------------------S------------------------------------------------------------------------------------------------------------------Q---------ooo-oo----------SSSSS--S----SSSSSSSS-------------------SSS---S----------------------XX--------------------------------------------------------------------------------------------XX--------------------------------
-------------------------------------------------------------------------------------------------------------------------------XX--------------------------------o--------------oo-------------------------------oo---XXX------------------------------------------ES------------------------------------------------------------------------------------------------------------------------------------------------------------------------------------------------XXX------------------------------------------------SS----------------------------------------------------------------------------------------SS------------SS--------XXX-----------------------------------------------------------------------------------------------------<>--------------------------------------------------------------------------------------------------------XX---oo----------------------------------------------------------------------------------------------------------oo------------------------------------------------------------------------------------------------------------------------------------------------------------------ooo-----XX--------------------------------------------------oo---------------oooo---------------------------------------------------------------------------------------------XX----E------------------------------------------------------------------------------------------------------SSS-------XX---------------------oooo-----------------------------------------------------------XXX-------------------------
--------------------------------------------------------------------------------------------------------------------------------------------------------------E------------------------------------------------------XXXX--------------------------------------S----S---------------------------------------------------------------------------------------------E---------------------------------------------------------------------------------------------------------------------------------------------------------------------------------XX-----------o------------------------------------------------SS------------SS----------------------------------------------------------------------------------------------------------------[]-----------------------------------------------------------------------------------------------------------------------------------------------------------------------------------------------E--------------------------------------------------o---------------------------E-------------S------------------------------------------------------------------------------E------------------------XXX---------------------------------------------------------------------------------------XX--------------------------XX-----------------------------------------------XX--XXXX-------------SSSSS----------------------------------------------------------------------------------XXX-------o------------------------------------------------------------------------------------------------------------------
------------------------------------------------------------------------------------oo---oo-------------------------------------XXX---------S--------E----------------------------------------------------------E-E-XXXXX------------------------------E-------So?---------oo---------------E-------E--------------------------------------SSSSS-----------------------------------------o------S-------SS------------------------------------------------------------------------------XX----E-------------------------SS-------------E--SSSSSSSS--S---------------------------------------------------------ooooSS------------SS---E--SSSSSS------------------------------------------E------------------------------------------------------E--[]---------------------------------------------------------------------------E-------------------------------E-----------S-?------------------------------XX---------------XXX------------------<>----------Q-----------------------------------------------X---o--------------<>-------E--?--S-------SS-S---------E-E------------S-------?---------------------------------<>--------------------S---XXXX----------------------E------------E----------------------------E----------o---------XXX-------------------------XXX---------------E----------XX--------------E-EX-XX-------------------SSSSS------------------------------------------------------------------X-------------XXSXX-----------------------------E--------------------------------------------------------------oo----------------------------
----------------------------Q-----QQQSSQQ---------------------------------QQQQ----------------------XX---------X-----XXXXXXX-------XXXX--XXX---E----<>------SSS--------------E----------XXXX--SSS--------------------XXXX----------E---------------E--<>-------SSS--S----E-------Q-Q-------<>------<>-------E---------------------<>-------------Q--------------S?S---------SS--SSS-----S--S---------------------------------------------------------------------XX-----XXXX-----------------<>---E----E--?S----E--S----SS--S?SQS-----<>----------------XXXX-SSSSS---------------------------------------------SSSSS--S-------------?SSS--------------XXXX--------------------------E--<>-QQQQ--X-------Q-SSQSQ--------------QQQ-----------E--<>--[]----E-QQ--QQQQ--Q--Q----------------------------QQQ--QQQQ-----------------<>----------S--------o--XXXX---E<>-----------SS---S-------------------------------------------------S?SE-------E--S-[]-------------SS--------E----------SS---------S-QS---------XX-------------S---[]------<>-----SSS-----X---E----X--SSSSS------------------S??SS-------------------Q----------[]----------------------X-XXX-------------------E--<>---E-------<>------S-----------XX-XXX---<>-------------------X-XX------------------------XXXX--------------<>----------XX------------------XX--------SSS----------------------------SQS---------Q-Q--------------SSS--------S----------XX------------XXXXX---SSS----X-------QQ--------E<>-----E-------------XX--X-----------S--------------------------------------------------------
------XX-?-------------------------------------------------------------------------X--------------XXXX--------XX------------------------------<>----[]---E------------------<>---------------------------------------XXXX---------<>---------E----<>--[]----------------<>-----------------[]------[]------<>---------------------[]---------------------------------------X----------E----XX-----E-------------------------------------------------X----------------------------------------[]--<>---<>-------<>---------------------[]------------XXX--------------E---------------E--------E---E-E---------------------------------SS------------------------------------------E<>--[]-------X-----------------------------------------<>--[]--[]--------------------------------------------------------------------------[]--------XX------------------<>[]----------------------------------------------------------------------------<>----[]----------------<>----<>----------SS--------------------X-XX-----------------[]------[]-------------X--------E-EE------------o------------SS------------------------------[]----------------------XXXXX------------------<>--[]--<>-------[]------------------XX-XXX---[]------------------XXXXX-----------E-----------XXXXX--------------[]--E-----XXXX------------------XX-----------------------------------------------------------------------------------------XXX-----------XXXX-----------XX---------------E<>[]----<>------------XXX--XX-----E--EE------------------------------------------------------E--
-----------------------------------------------------------------------------------X-------------XXXXX-------XXX---------------------------X--[]----[]--<>------------------[]------------------------------------X-XXXXX---------[]--------<>----[]--[]----------------[]-----------------[]------[]------[]---------------------[]-------------------------------------------------<>----XXX--------------------------------------------------E---X----------------------------------------[]--[]---[]-------[]---------------------[]------------XXX--S----------<>--------------<>-------<>--<><>----------------------X-----------S---------------------------X-------------<>[]--[]-------X-----------------------------------------[]--[]--[]--------------------------------------------------------------------------[]-------XXX------------------[][]----------------------------------------------------------------------------[]-E--[]----------------[]----[]----------SS--------------------X--X-----------------[]------[]-------------X-----------------------XXXXX---------SS------------------------------[]----------------------XXXXX---------<>-------[]--[]--[]-------[]-----------------XXX-XXX---[]------<>------<>-XXXXXX----------<>-----<>---XXXXXX--------------[]-<>-----XXXX------------------XXX------------------------------------------------------------------------------X--------XXXX----------XXXXXX----------XX--------------<>[][]----[]-----------XXXX--XXX--------------------------------------------------------------<>--
-------------------------------------------------------------------------------E-E-X-----o------XXXXXX---SSSXXXXXXX---------------------------[]---E[]--[]------------------[]---------------------------------------XXXX------X--[]--------[]----[]--[]-----E----------[]-------EE--------[]------[]------[]--------E-EE----E----[]------E-E------------------------------XE--E-----[]E---XXX-------------E-------E-S-------EE-E-------------------X------E---X-----------------------------[]--[]---[]-------[]-----E---------------[]---------X--XXX-------------[]-----E-EE-----[]-------[]--[][]--------E-E----X--E-E-X-E----------------------------------E-XX-------------[][]--[]-------X----E-EE-------E-----------------EE------[]--[]--[]--E-------E----------------------E-EE-E--------------EE-E-------------E---[]------XXXX------------------[][]-------E-----EE---------------E------------------ooo-------------E----------[][]--[]---------E-EE---[]----[]-E-------SSS------EE------------X--X-------------E---[]------[]-------------X------------------X---------------oo-SS-------------E-EE------EE-E---[]------EE-E--------EE--XXXXX---------[]-EE----[]--[]--[]-E-E---[]--E-E------EE--XXXXX-XXX---[]----E-[]------[]XXXXXXXE---------[]-----[]--XXXXXXX----E-E--E----[]-[]----XXXXX------------------XXX-------E-----X----------------------------------------------------E-----E-EE--X-------XXXXX---------XXXXXXX-SS-----XXXX-EE---------E-[][][]----[]-E----E---XXXXX--XXXX-------X-----------------------------------------------------[]--
XXXX-----XXXXXXXXXX--X-X----XXXXXXXXXXXXX---------XXXX-XXXXXX-XXXXXXXXXXXXXXXXXXXXXX---XXX--XXXXXXXXX------XXXX-----------------------------XX[]XXXXXXXXXXXXXXXXXXXXXX-X-XXXXXXXXXX--XX--------XX---XX-X--XXXXXXXXXXXXXXXXXXXXXXXXXXXXXXXXXXXXXXXXXXX-XXXXXXXXXXXXXXXXXXXXXXXXXXXXXXXXXXXXXXXXXXXXXXXXXXXXXXXXXXXXXXXXXXXXXXXXXXXXXXXXXXXXXXXXXXX-X-XX-XXXXXXX-XXXXXXXXXX---XXXXXXXXXXXXXXXXXXXXXXXXXXXXXXXXXXXXXXXXXXX--XXXXXXXXXXX---XXXXXXXXXXX--XXXXXXXXXXXX------------XXXXX------------XXXXXXXXXXXXXXXXXXXXXXXXXXXXXXXXXXXXXXXXXXXXXXXXXXXXXXXXX------XXXXXX--XXXXXXXXXXXXXXXXXXXXXXXXXXXXXXXXXXXXXXXXXXXXXXXXXXXXXXXXXXXXXXXXXXXXXXXXXXXXXXXXX------XXXXXXXXXXXXXXXXXXXXXXXXXXX-XXXXXXX--XXXXXXXXXXXXXXXXXXXXXXXXXXXX-XXXXXXXXXXXXXXXX-XXX-XXXXXXXXXXXXXXXXXXX--XXXXXXXXXXXXXXXXXXXXXXXXXXXXXXXXXXXXXXXXXXXXXXXXXXXXXXXXXXXXXXXXXXXXX---XXXXXXXXXXXXXXXXXXXXXXXXXXXXXXXXXXXXXXXXXXXXXXXXXXXXX-------------XX-------------XXXXXXXXXXXXXXXXX-XXXXXXXXXXXXXXXXXXXXXXXXXXXXXXXXXXX-SXXXXXXXXXXXXXXX-XXXXXXXXXXXXXXXXXXXXXXXXXXXXXXXXXXXXXXXXXXXXXXXXXXXXXXXXXXXXXXXXX----XXXX-------XXXXX--X---XXXXXXXXXXXXXXXXXXXXXXXXXXXXXXXXXX-XXXXXXXXXXXXXXXXXXXXXXXXXXXXXXXXXXXXXXXXXXXXXXXXXXXXXXXXXXXXXXXXXXXXXXXXXXXXXXXXXXXXXXXXXXXXXXXXXXXXXXXXXXXXXXXXXXX----XXXXXX-XXXXXXXXXXXX-XXXXXXXXXXXXXXXXXXXXXXXXXXXXXXXX--XXXX-XX--X--XXXXXXXXXXXXXXXXXXXXXX---XXXXXXXXX---XXXXXXXXXXXXXXXXXXXXXXXXXXXXXXXXXXXXXXXXXXXXXXXXXXXXXXXXXXXXXXXXXXXXXXXX--S---XXXXXXXXXXXXXXXXXXXXXXXXXXXXXXXXXXXXXXXXXXXXXXXX--XXXXXXXXXXXXXXXXXXXXXXX--XXXXXXXXXXX-----X---XX-X-XXXXX---XXXXXXXXXX-