------------------------------------------------------------------------------------------------------------------------------------------------------------------------------------------------------------------------------------------------------------------------------------------------------------------------------------------------------------------------------------------------------------------------------------------------------------------------------------------------------------------------------------------------------------------------------------------------------------------------------------------------------------------------------------------------------------------------------------------------------------------------------------------------------------------------------------------------------------------------------------------------------------------------------------------------------------------------------------------------------------------------------------------------------------------------------------------------------------------------------------------------------------------------------------------------------------------------------------------------------------------------------------------------------------------------------------------------------------------------------------------------------------------------------------------------------------------------------------------------------------------------------------------------------------------------
------------------------------------------------------------------------------------------------------------------------------------------------------------------------------------------------------------------------------------------------------------------------------------------------------------------------------------------------------------------------------------------------------------------------------------------------------------------------------------------------------------------------------------------------------------------------------------------------------------------------------------------------------------------------------------------------------------------------------------------------------------------------------------------------------------------------------------------------------------------------------------------------------------------------------------------------------------------------------------------------------------------------------------------------------------------------------------------------------------------------------------------------------------------------------------------------------------------------------------------------------------------------------------------------------------------------------------------------------------------------------------------------------------------------------------------------------------------------------------------------------------------------------------------------------------------------
--------------------------------------------------------------------------------------------------------------------------------------------------------------------------------------------------------------------------------SSSSSSSSSSSSSSSSSSSSSSSSSSSS----------------------------SSSSSSSSSSSSSSSSSS-----SSSSS-------------------------------------------------------------S---------------------------------------------------------------------------------------------------------------------------------------------------------------------------------------------------------------------------------------------------------------------------------------------------------------------------------------------------------------------------------------------------------------------------------ooo-------------------------ooo-----------------------------------------------------------------------------------------------------------------------------------------------------------------------------------------------------------------------------------------------------------------------------------------------------------------------------------------------------------------------------------------oo-----------------------------------------------------------------------------------------------------------------------------------------------------------------------------------------------------------------------------------------------------------------------------------------------SSSSSSSSSSSSSSSSSSSSSSSSSSSS
-----------------------------------------------------------------------------------------------------------------------------------------------------------------------------------------------------------------------------------S----------------SS----oS----ooo----------------------SSSS----Q-?-S--SS---S----oS----------------------------------------------------------------------------------------------------------------------------------------------------o------------------------------------------------------------------------------------------------------------------------------------------------------------------------------------------------------------------------------------------------------------------------------------------------------------------------------------------XXXX------------------------XXXX---------------------------------------------------------------------------------------------------------------------------------------------------------------------------------------------------------------------------------------------------------------------------------------------------------------------------------------------------------------------------------------XXXX--------------------------------------------------------------------------------------------------------------------------o-----------------------------------------------------------------------------------------------------------------------------------------------------------------------------------------------
----------------------------------------------------------------------------------------------------------------------------------------------------------------------------------------------------------------------------------S----------?-------S-----------------------------------SSSS-EE-----S--SS---S-----S--------------------------------------------------------------?---------------------------------------------------------------------------------------------------------------------------E-------------------------------------------------------------------------------------------------------------------------------------------------------------------------------------------------------------E----------------------------------------------------------------------------------------------------------------------------------------------------------oo------------------------------------------------E-----------------------------------------------------------------------ooo----------------------------------------------------------------------------------------------------------------------------------------------------------------------------------------------------------------------------------------------------------------------------------------------------------------------------------------------------------------------------------------------------------------------------------------------------------------------------------------------------------------------------------------------------
----SSQS----------------------------------------SS--------XXXo-------------------------------?SSSS-------------------------SS---SSSSSS--------------------------------------------------------------------SS-------------------S-S-------------------SS-------SSS------------XX----------S----SS-------------SS----S------S------------------------------------------------------S??--------------Q-Q---------SSSS--------------------------------------------------------XXX-------------------------------SSSSSSSS-------------------------------------------S---------------------------SS---SSSSSS---SSS----SSS----SS---------------------------------------------SSS------SSS----SSSSS---------QSS---?SSS--------------S---SQS-------------------------------?SSS----------------------------------SSS---------------------SQS-SSSS------------------------------------------SQS-----------------------?SSS-------------------------E--E-------XXX-----------------------------------------XXX-------E-----XXXX------SS-------------------S------S------------------------------SSS---o----?--------------------------?SSS--------------QQQQQ----------------------------------------------------------------------SSSSS---SQS----------------------------------------------------S--------SSS--------S------------QQQQ--------------------------------------------SS-----SSS--SSSSSSSS--------------SSSS------------------------------------Q-Q-------------------------------SSSSQ---?---SS--------------S?SSS---------------------------------------------------
------------------------------------------------------------------------o----------------------------------------------------------------------XX-----------------------------Qooo----------------E-------S-----------------------------------------ESS-------XXX-----------XXX----------S----SS----S--------SSS----------------------------------------------------------------------------------------------------------------------------------XXX-------------XXXX------------------------------------------------------------------------------------------------------------------------------------------------------------------------------------------------------------------------------------------------------------------------------------------------------------------------------------------------------------------------E-----------------------------------------------------------------------------------------------XXSS-------------------------------------------------------<>------------------------------------S-----------------SS--------------------------E-----XXXX--------------------------------------------------------------------------------XXX-----------------------------------------------------XX----------------------------------------------------------------<>----------------------------------------------------------------XXS-----------------------------------------------------------------------------------ooooo------------------------------------------------------------------------------------------
------------------------E-----------------------------------------------X------------------------------------------------------------------X------------o----------------------------------------<>-------SS-----------------------------------------SS--------------------E-XX----------SS---SS----S--------SS----S---------------------------------------------------XX-------------------------------XXX-oo--------------------------------------------------------------------------------------------------------------------------------------------------------------------------------------------------------------------------------------------------------------------------------------------------------------------------------------------------------------------------------------------------------------------------------------------------------------------------------------------------------------------------------------------------------------------XX---------------------[]------------------------------------S-----------------X--------------------------<>---------------------------------------------------------------------------E---------------------------------------------------------------------------------------------------------------------------------------[]--------------------------------------------------------------EXXX-------------------------------------------------------------------S---------------------------------------------------------------------------------------------------------------
----------------E------<>------------------E----S-----------------------------oo-----------------------------------------------------------X--------------------------------E--------------------[]-------SS--------------------------------oooooo??-SS-----SSSSSS---E-EE-XX-XX---------SoSoo-SS--?-So??-S??-SS--EEX-----------------------oo----S--------------------XXX-------------ooo---------------S-------------------------------------------------------Q---------------XSS-S---------------------------------------------------XX--------------Q----------------------------------E-----------------------------------------E------------------oo------------------------------------------------------------------E---------------------E---------------------------E----XS--------------------SSS-S-----------E-------------------S-------------E------------S------------------------E----------------E--o--------------oS--------------X----------------------------XXX--o-----E------------]-----------------S---------------E--------------------XSS--Q---------E------------[]--------------------E---------------------------------------------S-------<>-------------------S-------------E------------S--------------------XX---------------------------------------------------------------S--[]-----------------------------------------SS------------------X------------------------------------------o------------------------------------SSS------------------------------------------------------------------------------------o----oo----------
------E--------<>---E--[]-----------------<>------------X----XXXX----------------------QQQ--QQQQ-------------E-Q--------------------------XX----------SS-------------------<>--------------------XXX------SS-------E--S-------E--S--------E----------SS----X-------------XX--XX---------SSSSS-SSS---SSS--SS--SS----X-----SS--------S---------------------------------XXXX-X------------------------QQQ---X----------------E----------------XXX---------------------------------XXXX-------------------------------oo---S---------------XXX---------X---------------------------X----------<>---S----S-----S-----QQQ-----S--S--------<>------------------------------o?--QQQ-------------------------SSSQQ----------------E--Q---S?S-------E------<>---E----Q--Q--Q-QS--S-----<>---XX----------------S--------------E----<>-----ESSS-----------------------<>----------X--------Q?-QQQ-----------<>-----Q-----S---<>-----E--S-----------------------------------------------------XXX---E---<>-----------------------X------SS-------------<>-XX----------------XXX------------<>-----SQS----XXX------------------<>----XX----------XS---Q--QQ?SSQS-----------------E----[]-----E?QS-----------------------<>------------------SQQ-XXXX-------------------E---------------QQQQ--------SSS--------SSS----o--SS--SSS[]SS--E?QQQ--Q-------------------------------------oooo-------XXX-XXX---------X----------S-S---------------Q---------------S-----?QQQ--SSS---------------------------ES?S-QQQ--Q--Q------------Q-QQ-----------------QQQQ---QQQ-------------------------
-----<>--------[]--<>--[------------------[]--E------------XXXX---------------------------------------------<>---------------------------XXX---X---------------------------[]-----E--------------XXX--------------<>---------<>----------<>----------------X-------------XX--XX---------------------------------E--X-----------E------E-----------------------------XXXXX-XX-----------------------------X---------E-----<>---------------------------------XXXX-------------XXXXXX-------EX----------XX------------------------------XXXX-------EXX--------------------------XX----------[]----------E---E-------------------------[]---------E------------------------------------------------------------------------<>---------------<>------[]-----------------------E--[]--XXX-------E----------------------<>----[]-----------------X--------------[]---------XS-------------------------[]---------------[]----<>--------------------------------------E----------------XXXX-------[]------E----------------X---------------------[]-XXX--------------XXXX------------[]---------------------------------[]----XX---------XXS-----------------------------<>----[]--------------------------------[]-----------X------------------------------------------------------------------------E----------------[]-----------------------------------------------------------XXX--XXX--------XX-------------------------------------------------------------------------XXXXX------------------------------------------------------------------------------------------
-----[]--------[]--[]---------------------[]-<>---------XXXXX----------------E------------------------------[]-----------------X--------XXXX---X----------E-------------X--[]----<>--------<><>-XXXX--------------[]---------[]----------[]------------------------------XX--XX--------X---------------------------X----------<>-----<>----------------------------XXXXXX-XX-----------------------------X---------------[]---------------------XX--------------------------XXXXXXX-------XX----------[]---X-------------------------XXXXX-------XXX-------------------------XXX----------[]----------------------------------------[]--------<>-------------------------------X---X------------------------------------[]---------------[]------[]----------------------<>--[]-XXXX---------<>-------------------[]----[]--------------------------------[]--------XXX-------------------------[]---------------[]----[]----------------------XX------------------------------XXXXX-------[]-----<>-<>-------------X---------------------[]-XXX-------------XXXXX------------[]---------------------------<>----[]----XX--------XXXS-----------------------------[]----[]--------------------------------[]---------X-X------------------XXXXX------------------------------------------------------------------[]---------------------------------------------<>----------EXXXXX-XXX-------XXX------------------------------------------------------------------------------------------------------------------------------------------------------------------------
--E--[]--------[]--[]---------------E-----[]-[]---------XXS----------------------XXo---E------------------E-[]----------EE-E-E-X-------XXXXXE--X------------------------E--[]----[]----E---[][]XXXXX----E-E------E[]---------[]-E--------[]--------E---------------------XX--XX----EE--XE-E---------E--------------X---EE-----[]-----[]------------------E--------XXXXXXX-XX-----------------------------X-----E------E--[]-------E----------------------------------o-----XXXXXXXX----SSXXX---EE-E-X-[]-E-X------------------------XXXXXX------XXXX---------E--------------XXXX---EE-E---[]-------------------E-----E-E---E-EE-----[]-E-E----[]-------------------------------X-E-X--------E------E------------------E-[]------E--------[]------[]--X-----EE-E--------E-[]--[]-XXXXE--------[]-------------------[]----[]-----------------S----E-E-EE-E--[]-------XXXX-----------------------E-[]-E-------------[]----[]-E---------------------------------------------------XXXXXX----E--[]-----[]-[]-------------XX----EE-------EE-----[]-XXX------------XXXXXX------------[]-----------------EE--------[]----[]--XXXX-------XXXXS----E-EE-------EE-----------X[]----[]-----------EE----------------E--[]---------X-X-----------------------------------------------E-EE------E-E-------E---E-E------------E--[]---------E-E--------------------E------------[]----------XXXXX--XXX------XXXX-----------------------------------E---------------------------------------------EE-----------------------EE-E----------------------------------E-E---------------------
XXXXXXXXXXXXXXXXX--XXXXXXXXXXXXXXXXXXXXXXXXXXXXXXXXXXX-X------------------XX-X---XXXXXXXXXXXXXXXXXXXXXXXXXXXXXXXX-X-XXXXXXXXXXXXXXXXXXXXXXXXXXXXXXXXXXXXX---XX-XXXXXXXXXX--XXXXXXXXXXXXXXXXXXXXXXXXXXXXXXXXXXXXXXXXXXXXXXXXXXXXXXXXXXXXXXXXXXXXXXXXXXXXXXXXXXXXXXXXXXXX--XX-XXXXXXXXXXXXXXXXXXXXXXXXXXXXXXXXXXXXXXXXXXXXXXXXXXXXXXXXXXXXXXXXXXXXXXXXXXXXXXXXXXXXXXXXXXXX--XX-X---XXXX---XXX-------XXXXXXXXXXXXXXXXXXXXXXXXXXXXXXXXXX--XXXX---------X---XXX------XX-XXX--XXXXXXXXXXX-----XXXXXXXXXXXXXXXXXXXXXXXXXXXXXXXX-XXXXXXXXXXXXXXXX-XXXXXXXXXXXXXXXXXXXXXXXX------XXXXXXXXXXXXXXXXXXXXXXXXXXXXXXXXXXXXXXXXXXXXXXXXXXXXXXXXXXXXXXXXXXXXXXXXXXXXXXXX---XXXX-EXXXXXXXXXXXXXXXXXXXXXXXXXXXXXXXXXXXXXXXXXXXXXXXXXXXXXXXXXXXXXXXXXXXXXXXXXXXXXXXXXXXXXXXXXXXXXXXXXXXXXXXXXXXXXXXXXXXXXXXXXXXXXXXXXXXX-XXXXXXXXXXXXXXXXXXXXXXXXXXXXXXXXXXX--XXXXXXXXXXXXXXXXXXXXXXXXXXXXXXXXXXXXXXXXXXX--XXXXXXXXXXXXXXXXXXXXXXXXXXXXXXXXXXXXXXXXXXXX----X-X-XXXX------------X-X-XX-X-X-XX-XXXXXXXXX-----XXXXXXXXXXXXXXXXXXXXXXXXXXXXXXXXXXXXXXXXXXXXXXXXXXXXXXXXXXXXXXXXXXXXXXXXXX-X----XXXXXXXXXXXXXXX-----SXXXXXXXXXX-XXXXXXXXXXXXXXXX--X-XXXXXXXXXXXXXXXXXXXXXXXXXXXXXXXXXXXXXX[]XXXXXXXXXXXXXXXXXXXXXXXXX-XXXX--XXXXXXXXXXXXXXXXX---XXXXXXXXXXXX---------------XXXXXXXXXXXXXXXXXXXXXXXXXXXXXXXXXXXXXXXXXXXXXXXXXXXXXXXXXXXXXXXXXXXXXXXXXXXXXXXXXXXXXXXXXXXXXXXXXXXXXXXXXXXXXXXXXXXXXXXXXXXXXX--XXXXXXXXXXXXXX-XXXXXXXXXXX--XXXXXXXXXXXXXXXXXXXXXXXXXXXXXXXXXXXXXXXXXXXXXXXXXXXXXXXXX------XXXXXXXXXXXXXXXXXXXXX-XXXXXXXXXXXXXXXXXXXXXXXXXXXXXXXXXXXXX---XXXXXXXXXXXXXXXXXXXXXXX---XX