------------------------------------------------------------------------------------------------------------------------------------------------------------------------------------------------------------------------------------------------------------------------------------------------------------------------------------------------------------------------------------------------------------------------------------------------------------------------------------------------------------------------------------------------------------------------------------------------------------------------------------------------------------------------------------------------------------------------------------------------------------------------------------------------------------------------------------------------------------------------------------------------------------------------------------------------------------------------------------------------------------------------------------------------------------------------------------------------------------------------------------------------------------------------------------------------------------------------------------------------------------------------------------------------------------------------------------------------------------------------------------------------------------------------------------------------------------------------------------------------------------------------------------------------------------------------
------------------------------------------------------------------------------------------------------------------------------------------------------------------------------------------------------------------------------------------------------------------------------------------------------------------------------------------------------------------------------------------------------------------------------------------------------------------------------------------------------------------------------------------------------------------------------------------------------------------------------------------------------------------------------------------------------------------------------------------------------------------------------------------------------------------------------------------------------------------------------------------------------------------------------------------------------------------------------------------------------------------------------------------------------------------------------------------------------------------------------------------------------------------------------------------------------------------------------------------------------------------------------------------------------------------------------------------------------------------------------------------------------------------------------------------------------------------------------------------------------------------------------------------------------------------------
------------------------------------------------------------------------------------o-----------------------------------------------------------------------------------------------------------------------------------------------------------------------------------------------------------------------------------------------------------------------------------------------------------------------------------------------------------------ooo---------------------------------------------------------------------------------------------------------------------------------------------------------------------------------------------------------------------------------------------------------------------------------------------------------------------------------------------------------------------------------------------------------------------------------------------------------------------------------------------------------------------------------------------------------------------------------------------------------------------------------------------------------------------------SS-SSS------------------------------------------------------------------------------SSSSSSSSSSSSESSSSSSSSSSSSSSS--------------------------------------------------------------------------------------------------------------------------------------------------------------------------------------------------------------------------------------------------------------------------------------------------------------------
--------------------------------------------------------------------------------------------------------------------------------------------------------------------------------------------------------------------------------------------------------------------o--------------------------oo-----------------------------------------------------------------------------------------------------------------------------------------ooo---------XXXX---------------------------------------------------------------------------------------------S-----------------------------------------------------------------------------------------------------------------------------------------------------------------------------------------------------------------------------------------------------------------------------------------------------------------------------------------------------------------------------------------------------------------------------------------------------------------------------------------------------------------------------------------------------------------------------------------------------------------------------------------------------------------SSSS------?-S--SS--SS----oS--------------------------------------------------------------------------------------------------------------------------------------------------------------------------------------------------------------------------------------------------------------------------------------------------------------------
------------------------------------------------------------E--------------------------XXX------------------------------------------------------------------------------------------------------------------------------------------E--------------------------------Eo-------------------------------------XXX----------------------------------------------------------------------------------------------------------------------------------------------ooo------------------------------------------------------------------------------------------E-----------E---------------------------------------------------------o---------------------------------------------------------------------------------------------------------------------------------------------------------------------------------S---------------------------------------------------------------------------------------------------E-----------------------------------------------------------------E----E---------------------------------------------------------------------------------------------------------------------------------------------------------------------------------------------------------------------------SSSS--E-----S--SS--SSS---ES----E---------------------------------------------------------------------------------------------------------------------------------------------------------------------------------------------------------------------------------------------------------------------------------------------------------------
---SSQS-?SSS-----E----------------------QQQQ---------------SQS------SSSS--S--QQQQQ-----------------XXX----------SSS-----------o-----oo-----------------QQQQ-------------Q---------------------QQQQQ--S---SS--------------SSSSS-----SQS----SSSS----------------------XXXX------------------------------------------S-----------------------------------------------------XX-------------------------------------------------------------SS---XXX--------------XXX-----------SSSSSSSSSSS-SS---Q?SS--S-Q---------SSSSSSSSSS------------------Q--?------SS----SS---------S?S-------S-----------------S----------------------XXX---XXXXX---------------?SSS---------------------------------SS---SS-S-----------S-------------------------SSQS-----------------------------------------E-----------------XX----------------SS-------------------S----------------------------------------SS--SSSSSSSS----SSSQ-------------S?--SSS-----SS---S----SSSS-SSSS-S--------------------------------------SQS---?SSS--XX-------------?---------------SSSSS-------------------SSS--------SS---------------SQS---------------------SSS----------------SQQS---------------------------------SS----------------SS---------------------------S---SSS-------Q----SS----S------SS-?--SS-----------------------------------SSSSSSS----------------------------------SS-------------------S---------------------XXX--------------------------QQQ------------------------------S------------XX-----------------------------------------------------------SSSSS-SSSSS----------------SS-----SSSSS
----------------<>-------------------------------------------------------------------------------------------oo-------------------------------------------------------------------------------------E---------------------------------------------------------XXXX-------------SX----------E----------------------------------------------------------------------------XX------------------------------------oooo----------------------------------------------------------------------------------------------------------------------------------------SS--------------------------------------------------------------------------------------------------------------------oooo---SS---------------------------------------------------------------------oooo---------------<>----------------XXX----------------SS----------------------------------------------------------------------------ES--------------------S-----------------------------------X----------------------------------------XXX------------------------------------------------------------------------------------------------------------------------E---S-------S---------------------------------------------E-----------------------------S---SSS------------SS----S-------S----------------------------------------------------------------------------------S-----------------------XXX----------------XXX-----------------------------------------------------------------------------------XXX--------------------------------------------------------------------------------------
----------------[]-----------------------------------------------------------------------------------------------------------------------------------------------------------------------------------------------------------------------------------------------------------XSSX-------XXXXXXXXX-------XXX-------------------------------------------------E-----------XX--------------------------------------------------------------------------------------------------------------------------------------------------------------------------------SS---------------------------------------------------------------------------------------------------------------------------SS--------------------------------------------------------------E-------------------------[]---------------XXXX----------------SS-----------------E-----------------------------------------------------------S-------------------SS---------------------------------XXXX--------------------------------------XXXXX-----------------------------------------------------------------------------------------------------------------------E---S-E----------------------------------------------------S----------------------------S-S--SS------------SS----S-------S----------------------------------------------------------------------------------S------------------E---------------------XXXXX-------------------------------------------------------E--------------------------------------------------------------------------------------------------------------------
----------------[]--------------------------------------------------------------------------------------------------------------------------------------------------------------------------------------------------------------------------------o------E--QSSSSS----------XXX--------------------------------XSS-SQ-----S-------------------------E--o---<>---------ooXX----------------oo---------E------E-----------------ooo---Q------------------------------------------------------------------------------------------E--------------------------SS---------------------------------o--------------------------------------------------------------------------------E--------SS--------SSSS----------------SSSSSSS---E---------------------E----------------------------ES----oo-------XXXXX----------------SS----------------<>------------------E--oo--------------------------------------------------------SS----------------------------------XXX------------------------------------XXXXXX--------------------------------------------E-------E-------E---------------------------------S------------------------<>---S-------S------------------------------------------E---S----------ooo-----------E-?-SoS--S---------o??-SS---EX-------S-----------------------------------------SS---------------------------------------S------------E----<>---------------------XXXXX------------------------------------------------------<>----SQ---S---------------------------------------------------------------------------------------E-----------------X
---E?Q--Q-?S----S---------------X----E-SQQQQ--------------ES?S--------------SSQQQS---------------------------XXXXXX----------XXXXXXXX--XXX-------------QSQS-------------Q---------<>---------E?QQQ------SSS--------------oo-----S--QQQ--QQQQQ-----------<>-----------------XXXX-X-----------------------------XXX--E---E--------S------------------<>------[]------S----XX--Q----------E------------<>-----<>---------------------------------------------------------Q--Q-Q---------------XQ-----QQQQ--Q--QQQ-------------E--<>-----E-ESQS--QQQ------S---SS---------SS--------S----------E-----------o---------------------XXXXXSQQQ-------SS-----XX--X----------------E----<>---------S-o-----------------------------------<>---QQ?SSS-----------<>--------------------E------<>-------------XXXXXX---------X------SSS---------------[]-S---------S-----<>----------------------XXX-X----------XX--SS-------XX-XX-----------X--QS--S-------------------XX-XXX------SSXXX-----------------SQS-----XXXXXX-----------ooo-----------------------------<>------<>-----E<>----S------------------QQQ-------S--QQ-Q--Q-Q-------------[]---S?S-----------QQ?--Q-Q-------------------S--------<>--QS---S----E--------------XSS--SSS--SS-S--S--SSS--SS----S--SS--SSS-------------------Q---SS--------------------SS-----------------S----E---S-----S?SSS------E--<>----[]-S------------------XXXXXX---------E---------------E-QQ--------------------SS---[]-------------------XXXX-----------------XX----------------------------EXX---------SSSSS----E----<>-----S----------XX
--------------------------------X---------------------------------------------------------------------------------------------------------------X---------------------------------[]--------------------------------------------------------------------[]----------------XXXXX-XX---------------------------XXXX-----<>---------------------E-----[]------[]-----------XX------------<>------E-----[]-----[]------E------E---------------------------------------------------------------XX------------------------------<>--[]----<>---------------------------------------------------<>-----------E----------XXXX?----------------------------XXX--XX---------X----<>----[]-----------E---E-------------------------------[]--------------------[]-------------E-----<>------[]------------XXXXXXX--------XX------------------------[]-S---------------[]---------------------XXX--XX--------XXX---------XXX--XX-----------X-----------XX--X---E-----XXXXXXX-------------E--------E------------XXXXXXX-------------------------------------------[]------[]----<>[]-------------------------------------------------------E--[]-----------------------------------------------------[]-----------<>-------------XXX-------------------------E----------------------------------------E---------------------------------------<>-------------------<>--[]----[]-S---E-------------XXXXXXX--------<>--------------<>----------------------------[]-XX---S---------------------------------------------------------------XXX---------E-------<>----[]--------E---E--XXX
---------------------------X----X-----------------------------------------------------------------------------------XXXX------------------------X---------------------------------[]--------------------------------------------------------------------[]--------------EXXXXXX-XXX-------------------------XXXXX-----[]--------------------<>-----[]------[]-----------XXX-----------[]-----<>-----[]-----[]-----<>-----<>--------------------------------------------------------------XXX------------------------------[]--[]----[]---------------------------------------------------[]------------------------------------------------------XXXX--XXX--------XX---[]----[]-----------------------------------------------[]--------------------[]------------<>-----[]------[]-----------XXXXXXXX-------XXX------------------------[]-S---------------[]-------------------XXXXX--XXX------XXXX--------XXXXX-XXXX-----E---X-----------XX--X--------XXXXXXXX------------<>-------<>-----------XXXXXXXXX--------X---------------------------X-----[]------[]----[][]---------------------------------S--------------------<>--[]-----------------------------------------------------[]-----------[]------------XXX------------------------------------------------------------------<>---------------------------------------[]--Q----------------[]--[]----[]------------------XXXXXXXX--------[]--------------[]----------------------------[]-XXX---------------------------X-------------------------------------XXXX---X-X-----------[]----[]-------<>--<>-XXXX
----------------------EE-E-X----X-----------E-EE------EE---------------------------------------E-----E------------------------------------------X------------EE-----E-E-----EE-E--[]----------------EE---------E-E---E-------------------------------E--[]-E-------------XX-XXX?XXXX?----------------------XXXXXX-----[]--------------------[]-----[]------[]----E--EE--XXX----E-EE-E-[]---E-[]--E--[]-----[]---E-[]-----[]----------------------------------------------E-E------------XXXX------------------------------[]--[]----[]-------EE----------------E-E-E---------------E-E---[]---------------X--------------------------------EE---XXXXX--XXXX--EE---XXE--[]-E--[]-----------------------------------------------[]----E--------E----X-[]------------[]-----[]------[]----------XXXXXXXXX----E-XXXX--E------------------E--[]?S------------E--[]---------------E--XXXXXX--XXXX----XXXXX-EE----XXXXX--XXXX--------XX-----------XX--X-XX----XXXXXXXXX------------[]-----E-[]----------XXXXXXXXX----E-E--X------------------------------E--[]------[]----[][]--------E-E----------------E-E-E-S---E--E-------------[]--[]--E-----------------E-----------------------E--------[]--E--------[]-----------XXXX---------------------E---------------------E----------EE-E-E-EE---[]-E------------------------E-------EE---[]-------E-----------[]--[]----[]-----------------XXXXXXXXX--------[]--------------[]---------------E-E---E-E----[]--SX---------------------EE---XX------------------------------------XXXXX-----X-----------[]--E-[]-------[]--[]XXXXX
XXXXXXXXXXXX-----XXXXXXXXXXXXXXXXXXXXXXXXXXXXXXXXXXXXXXXXXXXXXXXXXXX--XXXXXXXXXXXX----XXXXX---XXXXXXXXXXXX-XX-X-----------------------------XXXXXXXXXXXXXXXXXXXXXXXXXXXXXXXXXXXXXXXXXXXXXXXXXXXXXX--XXXXXXXXXXXXXXXXXXXXXXXXXXXXXXXXXXXXXXXXXX--XXXXXXXXXXXXX---XXXXXXXXXXXXXX--XXXXXXXX----XXXX----XXXX-XXXXXXX----XXXXXXXXXXXXXXXXXXXXXXXXXXXXXXXXXXX--XXXXXXXXXXXXXXXXXXXXXXXXXXXXXXXXXXXXXXXXXXXXXXXXXXXXXXXXXXXXXXXXXXXXXXXXXXXXXXXXXXXXXXXXX------X---XX--X-XXXXXXXXXXXX-XXXXXXXXXXXXXXXXXXXXXXXXXXXXXXXXXXXXXXXXXX-XXXXXXXXXXXXXXXXXXXXXXXXXXXXXXXXXXXXXXXXXXXXXXXXXXXXXXXXXXXXXXXXXXXXXXXXXXXXXXXXX-XXXX-----XXXXX--XXXXXXXXX---XXXXXXXXXXXXX--XXXXXXXXXXXXXXXXXXXXXXXXX-XXXXXXXXXXXXXXXXXXXXXXXXXXXXXXXXXXXXXXXXXXXXXXXXXXXXXXXXXXXXXXXXXXXXXXXXXXXXXXXXXXXXXXXXXXXXXXXXXXXXXXXXXXXXXXXXXXXXXXX-XXXXXXXXXXXXXXXXXXXXXXXXXXXXXXXXXSX--XXXXXXXXXXXXXXXXXXXXXXXXXX-XXXXXXXXXXXX--XXXXXXXXXXXXXXXXXXXXXXXXXXXXXXXXXXXXXXXXXXXXXXXXXXXXXX--XXXXXXXXXXXXXXXX-----XXXXXX--XXXXXXXXXXXXXXXXXXXXXXXXXXXXXXXXXXXXXXXXXXXXXXXXXXXXX------XXXXXX-S-XXXXXXXXXXXXXXXXXXXXXXXXXXXXXXXXXXXXXXXXXXXXXXXXXXXXXXXXXXXXXXXXXXXXX-XXXXXXXXXXXXXXXXXXXXXXXXXXXXXXXXXXXXXX--XXXXXXXXXXXXXXXXXXXXXXXXXXXXXXXXXXXXXXXXXXXXXXXXXXXXXXXXXXXXXXXXXXXXXXXXXXXXXXXXXXXXXXXXXXXXXXXXXXXXXXXXXXXXXXXXXXXXXXXXXXXXXXXXXXXXXXXXXXXXXX----XXXXXXXXXXXXXXXXXXXXXXXXXXXXXXXXXXXXXXXXX-XXXXXXXXXXXXX-XX-X-X-XXXXXXXXXXXXXXXXXXXXXXXXXXXXXXXXXXXXXXXXXXXX-XXXXXXXXXXXXXXXXXXXXXXXXXXXXXXXXXXXXXX-XXXXX--XXXXXXXXXXXXXXXXX----XXXXXXXXXXXXXXXXXXXXXXXXXXXXXXXXXXXXXXXXXXXXXXXXXXXXXXXXXXXXXXXXXXXXXXXXX