------------------------------------------------------------------------------------------------------------------------------------------------------------------------------------------------------------------------------------------------------------------------------------------------------------------------------------------------------------------------------------------------------------------------------------------------------------------------------------------------------------------------------------------------------------------------------------------------------------------------------------------------------------------------------------------------------------------------------------------------------------------------------------------------------------------------------------------------------------------------------------------------------------------------------------------------------------------------------------------------------------------------------------------------------------------------------------------------------------------------------------------------------------------------------------------------------------------------------------------------------------------------------------------------------------------------------------------------------------------------------------------------------------------------------------------------------------------------------------------------------------------------------------------------------------------------
-----------------------------------------------------------------------------------------------------------------------------------------------------------------------------------------------------------------------------------------------------------------------------------------------------------------------------------------------------------------------------------------------------------------------------------------------------------------------------------------------------------------------------------------------------------------------------------------------------------------------------------------------------------------------------------------------------------------------------------------------------------------------------------------------------------------------------------------------------------------------------------------------------------------------------------------------------------------------------------------------------------------------------------------------------------------------------------------------------------------------------------------------------------------------------------SXX----------------------------------------------------------------------------------------------------------------------------------------------------------------------------------------------------------------------------------------------------------------------------------------------------------------------------------------------------------------------------------
--------------------------------------------------------------------------------------------------------------------------------oo--------------------------------------------------------------------------------------------------------------------------------------------ooo---------------------------------------------------------------SSSSSSSSSSSSSSSSSSSSSSSSSSSSSSSSSSSSSSSS?SSSSSSSSSSSSSSS--------------------------------------------------------------------------------------------------------------------------------------------------------------------------------------------------------------------------------------------------------------------------------------------------------------------------------------------------------------------------------------------------------------------------------------------------------------------------------------------------------------------------------------------------------------------------------------------------------------------------------------------------------------------------------------------------------------------------------------------------------SSSSSSSSSSSSSSSSSSSSSSSSSSS-----------------------------------------------------------------------------------------------------------------------------------------------------------------------------------------------------------------------------------------------------------------------------------------------------------------------------------------------------------------------------
-------------------------------------------------------------------------------------------------------------------------------XXXXX-----------------------------------------------------------------------------------------------------------------------------ooo----------XXX---------------------------------------------------------------------------SS-SS----------------------------SSSSS----SS------------------------------------o------------------------------------------------------------------------------------------------------------------------------------------------------------o-----o----------------------------------------------------------------------------------------------------------------------------------------------------------------------------------------------------------------------------------------------------------------------------------------------------------------------------------------------------ooo---------------------------------------------------------------------------------------------------------------------------------------------------------------------------------------------------------SSSSS?-SSSSS--------------------------------------------------------------------------------------------------------------------------------------------------------------------------------------------------------o-------------------------------------------------------------------------------------------------------------------------------------------------------------------
------------------------------------------------------------------------------------------------------------------------oo--------------------------------------------------------------------------------------------------------------------------------------------------------------E----------------------------------------------------------------E--SSSSS----------------------------SS--S----SS-----------------------------------------------------------------------------------------------------------------------------------------------------------------------------------------------------------------------------------------------------------------------------------------------------------------Eoo-----------------------------o-----E-----------------oo----------------------------------------------------------------------------------------------------------------------------------------------------------------------------------------------------o--------------------------------------------------------------------------------------------------------------------------------E-------------------------------------------------------SSSSS--SSSS-------------------------------------------------------------E-------------------------------------------------------------------------------------------------------------------------------------------------------------------------------------------------------oo--oo-------oooo----------------------------------------------------------------------XX---------------
----------------SSSSSS---SQ-----------------------------SS----S--------------------SS---------------SS------SSSS---o---XXXX----------------E----------------------------------------------SSSSS----------------SS---------------S--------SS-------o------------S----XXXX--------------XX---SQQS---?SS----------SSSSS--------------------------------S----SS-----Q--------------------------------S--------------------SSSSSS------------------------XX---------------------Q-----------------------------------------------------------SQQSSS?SS-------------------SSSS---------SSS--------------------SSS--SSSS---------------------------------------------------------------------XX----------------------------------XXXSS---------------------SSSSQ--o----E--E----oooo---XX----------S-------------------------SQS-----------------S---------------------------SSSS-----------------------SSS-----------------------------------------------------SS---S---------XXX------o--------SS-----------------------------------------------------S-------------------------------------SSSS---------------------E--------SQS---------S-SS---SQQ--------------------------------------SS------------SSSSSS------------------SS-----------------------------QS----SSSS----------------------------SSSS---?-------------------------------------?--------------------------------?SSS------------------SSS------SSSSSSSSSSS-------------------------------S-----------------------XXXXX----SSS------------------SSSSS---S----?-----------------------------------------------
-----------------------------------------------------------------------------------X--------------------------------------------------------------------------------------------------------------------------------------------------------------------------XXX----------------------------------------------------------------------------------------SS--------------------------------------SS-----------E-------------------------------------XXSS------------------------------------------------------------------------------------------------------------------------------------------------------------------------o----------------------------------------------------XX--------------------------------------------------------------------------XXX--------------o------------------oo--------------------------------------------------------------------------------------------E--------------------------------------------------------XXXXXX----------------XXXXXX---------------------------------------------------------------------------------------------------------------------<>--------------------------------------------------------------------SSS-------------------------------------------------------------------------------------------------------------------------------------------------------------------oo-----------------------------------------------------------------------------------------E----------------------------------------------------------E---------------------------------------------oo---------
-----------------------------------------------oo----------------------------------S--------------E-------------------------------------------------------o-------------------------------------------------------------------------------------o--------------------------------------------------------------------------------------------------------SS--------------------------------------SS----------<>-----------------------------------XXXX--------------------------------------------------------------------------------------------------------------------------------------------------------------E--------------------------------------------------------------E-XX---------------------------------------------------E------------------------------------------------------------------------------------------------------------------------------------------------------------------------------------------------------------------------------------------------------------------------------------------------------------------------------------------------------------------[]--------------------------------------------X-----------------------SS--------------------o------------------------------------------X----------------------------------------------------------------------------X---------------------------------------------------------------------------------------------------------------------Q----------------------------------------------------------------------------------------------------------------
-----------------------------o----o---------------------E---------------------E----X-------------<>------------------------------------------------------------------------------------------------X-------------------------------------------------XXX---------------------------------------------------------S--o---------------X----Q---o----EE-----SS----o??--------------------------oooooSS--EEX-----[]---------------------X---oo-------XXXXX-------------E--S----------------------S-------------E---------------------E--------------------------------------------------------E--o------------------------------------------------------------------------------------XXXXX---------X--SSS--------------S----SSS----E--S-----oo-----------------------------XXX------------------------E--S-SSSSSSS------------------------------------------oo-------------S--------------E-----SSSSSSS-----SS---------------E-------------------E---------S-----------------------XXXX-----------------------------------------------E---------E-----------------E----S----------E--S------------------E-------[]-------------------------------------------XX--oo-------------oo--??SS---Qo??-------------------------------------------E------------S--------------------------------------------------------oo---oo-----------------------------------E--S-SS--------------------E--S--------E-----------S------------------S----------------------SS-E------------------S-SQ------------------------------SSSS--S------------E---SSSSSSS--SS---------------------SSSSS
------------X---X----SSSSSS-----------------------------SS---SS--------S-----<>--XXXQ---------E--[]-----------SSQ----XXXX------------X---------------SSQS-------X-------------------X--X----------XX-----Q--Q-----------------------------XXXXX-------------------XX--SXS------------------ESSS------------------------------------XXX-----------SSSSS---SS--E--S---------------------------SSSSSS----SS-----[]------SQS--SSQS------------o-----XXXXXX---------X--<>------SQQQ----------------------------<>--------------------<>----ESSQS-----------------------------------XXSS-------<>-----------o----S------S?S---------------------------------------------------QQQ------XXXXXX----------------------------------------<>-----E-------------S?S--XXXXX-------------------XX-----S?SQS-----<>----------------S?S---------------------SS--------E-------------S?SQ---E----------<>-----------X---------------------<>------------------<>-----------------------XXXXXXXXX-------------------------Q-Q--Q--Q--QQQ------------<>--------<>----------------<>----------SS--<>-----------S--------<>-----SS[]-S-----S-------------Q-----SSS------------XXX---------------E-------SS--ESSSS----SQQ--SSSSS--------------QQQ-----------<>---------X--S--QQQQ--Q--------------<>---------------S-S---QQS------------------------XXX--------Q-Q----------<>---------------------S---<>-----E--SS<>----QQQQ--------X---S-------------SS-----S--S----X---SSSS--------XXXX-----------------------------E-E?-Q--Q---------Q-Q--Q-----<>---------------E------------------------
-----------XX---X--------------------------XXX-X-----------------------------[]--XXX---------<>--[]------------------------------X---XX--------------------------X----------------XXX--XX--------XXX-----------------------------------------------------------------------------X------------------------------------------------XXXX--XS----------SS------<>-----------------------XX-----E------EE--------[]--------------------------------XXXXXXX--------XX--[]--------------------------------------[]-------XXXX---------[]-------------------------------------------XXX---------[]--------E--E--------------------------------------------------------E----------------XXXXXXX-------------------------------------X--[]----<>-----------------------------------------------------------[]------------------------------E---E--E------E----<>-------------------<>----------[]----------XX-----E---------E-----[]------------------[]----------E------------------------------------------------------------------------[]--E-----[]----------------[]--E---E-------[]--------------------[]-------[]-------------E---------------------------XXXX--XX----------<>----------EE------------------------SS--------------------[]--------XX--S-----------------------[]-----------------------------------------------XXXXX--------------------[]-----------X-------------[]----<>----[]----------------X--------------------------------XX-----S-----------------------o-----------E----<>----------------------------[]--------------<>------------------------
----------XXX---XX------------------------XXXX-X-----------------------------[]--XXX---------[]--[]-----------------------------XXX--XXXX-----------------------XX----------------XXX--XXXX-----XXXX---------------------------X-------------------------------------------------X-----------------------------------------------XXXXX-XXX---------SSS------[]-----------------------XX----------------------[]-------------------------------XXXXXXXX-------XXX--[]--------------------------------------[]-----<>XXXX---------[]------------------------------------------XXXX---------[]-------------------------------------------------------------------<>---------------XXXXXXXX-------------------------------------X--[]----[]-----------------------------------------------------------[]-----------------------------<>--<>-<>-----<>----[]-------------------[]----------[]---------XXX----<>--------<>-----[]------------------[]---------<>------------------------------------------------------------------------[]-<>-----[]----------------[]-<>--<>-------[]--------------------[]-------[]------------<>--------------------------XXXXX---X----------[]-------------------------------------S------------------<>[]-------XXX--S--------------X--------[]----------------------------------------------XXXXXX--------------------[]---------X---------------[]----[]----[]------------X---XX----------X--------------------XXX---S---------------<>----------o-------<>----[]----------------------------[]--------------[]------------------------
---------XXXX--XX-------------------------XXXX-X-----S--E--E----EE-E--EE-E-X-[]--XXX-E-EE-E--[]--[]---------------ooo----------XXXX--XXXX---------E-E-----------XX------------E-E-XXX--XXXX----XXXXX-E-EE----------------EE-E--X-------------------------------------------------X-------E-E-----------------EE-E---------------XXXXXX-XSX-E-------------E--[]-----------EE------EE--XXX------------------E--[]-----E-----EE-----------------XXXXXXXXX---XX-XXXX--[]----E-E-----EE--------E---------------[]-----[]XXXX---------[]--------------------E--EE-E-------E------XXXXXE--------[]--------------------------------------------------E-EEE------------[]--------------XXXXXXXXX--------X-------------S---X----------X--[]----[]-----------------------------------------------------------[]-------------E-E-----------E-[]--[]-[]-----[]----[]-------------------[]----------[]----------XX----[]--------[]-----[]--------EE-E------[]-------E-[]-------------------------------------------------------------EE-E-------[]-[]--E--[]---E-EE---------[]-[]--[]-------[]----E--------EE-----[]----E--[]------------[]-E-----E-----------------XXXXXX---S----E-----[]-------------------------------------S------E-----------[][]------XXXX--S--E-------E---X--------[]-E-----------------------E-E-----------------XXXXXX------------------E--[]---------X-X-------E-----[]----[]-E--[]------------X-E-X----------XXE--E----EE-E--E--X--XXXX--SS------X-------[]-------------E--E-[]----[]--------EE-E---E-E----------[]------E-------[]-------E----------------
X--XXXXXXXXXXXXXXXXXXXXXXXXXXXXXXX---XXXXXXXXXXX-XXXXXXXXXXXXXXXXXXXXXXXXXXXXXX--XXXXXXXXXXXXXXXXXXXXXXXXXXXXXXX--XXX-----XXXXXXXXXXXXXXXXXXXXXXXXXXXXXXXXXXXXXXXXXXXXXXX-XXXXXXXXXXX--XXXXXXXXXXXXXXXXXXXXXXXXXXXXXXXXXXXXXXXXX--------XXX-------X----XXXXX--XX----------XXXXXXXXXXXXXXXXXXXXXXXXXXXXXXXXXXXXXXXXXX-XXX------XXXXXXX--XXX-XXXXXXXXXXXXXXXXXXXXXXXXXXXXXXXXXXXXXXXXXXXXXXXXXXXXXXXXXXXXXXXXXXXXXXXXXXXXXXXXXXXXXXXXXXXXXXXXXXXXXXXXXXXX--XXXXXXXXXXXXXXXXXXXXXXXXXXXXXXXXXXXXXXXXXXXXXXXXXXXXXXXXXXXXX--XXXXXXXXXXXXXXXXXXXXXXXXX-XXXXXXXXXXXXXXXXXXXXXXXXXXXXXXXXXXXXXXXXXXXXXXXXXXXXXXXXXXXXXXXXXXXXXXXXXXX--XXXX------XXXXXXXXXXXXXXXXXXXXXXXXXXXXXXXXXXXXXXXXXXXXXXXXXXXXXXXXXXXXXXXXXX-XXXXXXXXXXXXXXXXXX-XXXXXXXXXXXXX-XXXXXXXXXXX----------------------------XXXXXXXXXXXXXXXXXXXXXXXXXXXXXXXXXXXXXXXXXXXXXXXXXXXXXXXXXXXXXXXXXXXXXXXXXXXXXXXXXXXXXXXXXXXXXXXXXXXXXXXXXXXXXXXXXXXXXXXXXXXXXXXXXXXXXXXXXXXXXXXXXXXXXXXXXXXXXXXXXXXXXXXXXX-XXX--XX------------------XXXXXXXXXXXXXXXXXXXXX-XXXXXXXXXXXXXXXXXXXXXXXXXXXXXXXXXXXXXXXXXXXXXXXXXXXXXX-XXXXXXXXXXXXXXXXXXXXXXXXXXXXXXXXXXXXXXXXXXXXXXXXXXXXXXXXXXXXXXXXXXXXXXXXXXXXXXXXXXXXXX---XXXXXXXXXXXXXXXXXXXXXXXXXXXXXXXXXXXXXXXXXXX----X--XX--XXXXXXXXXXXXXXXXXXXXXXXXXXXXX--XX---XXXXXXXXX-XXXXXXXXXXXXXXXXXXXXXXXXXXXXXXXXXXXXXXXXXXX---XX---XXXXXXXXXX-XXXXXXXXXXXXXXXXXXXXXXXXXXXXXXXXXX-XXXXXXXXXXXXXXXXXXXXXXXXXXXXX--XXXXXXXXXXXXXXXXXXXXXXXXXXXXXXXXXXXXXXXXXXXXXXXXXXXXXXXXXX-------EXXXXX----X------XXXXXXXXXXXXXXXXXXXXXXXXXXXXXXXXXXXXXXXXXXXXXXXXXXXXXXXXXXXXXXXXXXXXXXXXXXXXXXXXXXXX