-----------------------------------------------------------------------------------------------------------------------------------------------------------------------------------------------------------------------------------------------------------------------------------------------------------------------------------------------------------------------------------------------------------------------------------------------------------------X------------------------------------------------------------------------------------------------------------------------------------------------------------------------------------------------------------------------------------------------------------------------------------------------------------------------------------------------------------------------------------------------------------------------------------------------------------------------------------------------------------------------------------------------------------------------------------------------------------------------------------------------------------------------------------------------------------------------------------------------------------------------------------------------------------------------------------------------------------------------------------------------------------------------------------------------------------------------------------------------------------------------------------------------------------------------------------------------------
------------------------------------------------------------------------------------------------------------------------------------------------------------------------------------------------------------------------------------------------------------------------------------------------------------------------------------------------------------------------------------------------------------------------------------------------------------------------------------------------------------------------------------------------------------------------------------------------------------------------------------------------------------------------------------------------------------------------------------------------------------------------------------------------------------------------------------------------------------------------------------------------------------------------------------------------------------------------------------------------------------------------------------------------------------------------------------------------------------------------------------------------------------------------------------------------------------------------------------------------------------------------------------------------------------------------------------------------------------------------------------------------------------------------------------------------------------------------------------------------------------------------------------------------------------------------
------------------------------------------------------------------------------------------------------------------------------------------------------------------------------------------------------------------------------------------------------------------------------------------------------------------------------------------------SSSSSSSSSSSSSSSSSSS?SSSSSSSS------------------------------------------------------------------------------------SSSS-------------------------------------------------------------------------------------------------------------------------------------------------------------------------------------------------------------------oo---------------------------------------------------------------------------------------------------------------------------------------------------------------------------------------------------------------------------------------------------------------------------------------------------------------------------SSSSSSSSSSSSSSSSSSSS----SSSS---------------------------------------------------------------------------------------------------------------------------------------------------------------------------------------------------------------------------------------------------------------------------------------------------------------------------------------------------------------------------------------------oo-----------------------ooo-------------------------------------------------------------------SSSSSSSSSSSSSSSSSSSXSSSSSSSS
----------------------------------------------------------------------------------------------------------------------------------------------------o----------------------------------------------------------------------------------------------o------------------------------------------------------------------------------------------------------------------------------------------------------------------------------------------------------------ooSS-----o------------------------------------------------------------------------------------------------------------------------------------------------------------------------------------------------------------XXXX------------------------------------------------------------------------------------------------------------------------------------------------------------------------------------------------------------------------------------------------------------------------------------------------------------------------------------------------------------------------------------------o-----------------------------------------------------------------------------------------------------------------------------------------------------------------------------------------------------------------------------------------------------------------------------------o---------------------------------------------------------------------------------------------XXXX-E--E-------------------------------------------------------------------------------SSSSSSSSSS
---------------------oooo--------------------------------------------------------------------------E----------------------------------------------------------------------------oo--ooo--oo--oo------------------------------------------------------------------------------------------------------------------------------------------------------------------------------------------------------------------------------------------------------------------SSS----XXX--------------------Eooo-------------------------------------------------------------------------------------oo--------------------------------------------------------------------------------------------------------------------------------------------------------------E----------------------------------------------------------------------------------------------------------------------------------------------------------------------------------------------------------------------------------------------------------------------------------------------------------------------------------------------------------------------------------------------------------------------------------------------------------------------------------------------------------------------------------------------------------------E----------------------------------------------------------------------------------------------------------oo----------------------oooo----------XXXXXXX---------------------oooo-----------------------------------------------------SSSSSSSSS
--------------------XXXXXX-------------------------------------------------XXX-------------------SSQSSSSSS--------------------------------------------------------------oo------------------------------SSSSSS-----------------------------SSS-SSSS--------------------------------SSSSS---------S-S---------------------------------------------------------oooooo-----ooooS?SSS------------------------------------------------------------------SSS-------------S-------o-------------------XXXXX-----------------------------------------------------------------------------------XXXX-----------------S---oo--XXXXX-----oo--------SSSS----Q-----------------------------------------------SSSSS---?-----------?-Q-------------------------------------SQS-S??SSS----------------------------------------------S-SSSSS-------E---------SS--SQS---------------------?SSSS-------XXX---o--------o---------------------X--------------------------------------------------------------------------------------------------------------------SS-?SSS---------------SSSS----E---------XX--------?-------------SSSS---------------------?-------SSSS--S?SSSSS----------------------E---------SSSSQS--S--SQSS------------------------SSS-------------------------------------------SSSQQ-----------------SSSSS-----S-----SSSSSSSSS-S-----S-----------------------------?SSS------------SSSSSS--SS---------------------------------S-S-XXX---------------------XXXXX-------------------------------------XXXX------SS----------XXo--------------------------------SSSSSSSSS
---------------------------------------------------------------------------XX---------------------------------------------------------------------------------------------------------X--------------------------------------------------------------------X-----------------------------------------------------X-----------------------------------------------XX--------------------------------------------------------XX--------------------------------------S-------------------------------------------------------o----------------------------------------------------------------------SS-----------XX--------------------XXX-------------------------------------------------------------------------------------------------------ooo-------------------------------------------------------------------------------<>---------------------------------------------------------------XX-------------------XXXX------------------------------------------------------------------------------o---------------------------------------------------------------------XXXX----------------XXX---------------------------------------------------------------------------<>-------------------------------------------------------------------------------------------------------------------------------------------------------------------------------------------------------------------------------------------------------------------------------------------------------------------------------------------------------------------------------------
-------------------------------------------------------------------------X-XX----------------------------------------------------------------------------------------------------------------------------------------------------------------------------XXX------------------------------------------------------------------------------------------------SSSSSSS---S-SSSS-------------------E--------------------------XXX--------------------------------<>--------S-S-----------------------------------------------------------------------------------------------------------------------XS--------------------------------------------------------------------------------------------------------------------------------E---------------------------------------------------------------------------------------------[]---------------------------------------------------------------oX-------------------XXXX--------------------------------------------------------------------------------E---------------------------------------------------------------------------------------------------------------------------------------------------------------------[]-------------------------------------------------------------------------------------------------------------------------------------------------------------------------------E------------------------o--------------------------------------------------------------------XXS-----------------------------------------------------------------------------------------------------
-------------------------------------------E--S---------oo---o-----------X-XX---------------oo------------------------------E-------------E-------SS---------------oo---XXX----------------------------?---------E-------------------------------------X--XX-XXX--------------------------SSS------------------------ooo------oo----------------------S-S-SSSSSSSSS--------S---------E--------<>-----S-S-oo---------------XXX-------------E------------------[]--------So--------------E--------------------------oo-------------------E----------------------------oo--------------oS----------XSS--Q--------------------------------------------------------------SS-SSS-----------------------------------------------------E--<>---------E----------S----------E----------------------------------------ooo------------------[]------E--E---------------------E-------S------------S-------------S-SQ--------------XXXX------------------------------o---oo---o---------------------SSSSSS---------E--<>--------------------E--------------------------------------------------------------XXX--------------------------------------------------------------------------E----XX----------------------------------------------------------------X------oo--------------ooo---------------------------------------------------------------------------------E--<>--SSSSS---------------------------E--------------------------------------X---------------------------------Q-----XXXX-----ooo----------------SQ---------------------SSSSS------------oooo------------
-----XXXXX------------------QQQQ----------<>---------------------------XXX-XX----------XXX-------S-Q-----------------------<>-------E----<>-------------------X-o----------------XXX-------------------S?S-----SSSSS--------Q-QQ---------Q-Q----SS----XX-XXX------------------------------------------------------------------------------------SS---------------------S---S---E----<>---E--SS[]--------------------------XX-------------<>---Q--------------[]-SSS----SSS---E-----E--<>-----------XXXX---XX--------------------------<>-------------------------------------------------------XXXX-X-------------XXX-XXXXXXXX--XXX-----QQQ---QQQ----------------------------------------------------Q--Q--S------XX--Q-------<>--[]--------<>------XX-XS--ESQS--------S---------------------------------------E----QQQ----------[]-----<>--XS--S?S--------------<>---SS--------------XXXXX-SSS----------------------X-XXXX--------E------------S?---------------------------XX-----------------------<>--[]------------E------<>-----------XX---ooo-------XXXXX----------------------XXX-------------------XXX----------------------Q------------<>-----------X-----------------XX-------------Q--QQQ-SQSQ-------------Q-----S--------X----------XX--------------------------------SS---------------S---------SSS------X--X-----------X-----------<>-------E<>--[]-------------XX-XX---SSS---------<>--------------E-----------S?SS-------XXXX-X---------------------------------------------------------------SS-E-------XX---------------SS--------E------------SSSSS
------------------------o--E--------------[]-------------------------XXXXXXXX-----o---EXXX---------------------------------[]------<>----[]------------------XX---------------------------------------------ES-SSSSS----------------------------------XX-XXX-------------------------------------------------------X--------------------------------X-------------------------<>----[]--<>----[]------------------E-------XX-------------[]------------------[]-------------E-----<>--[]----------------------------------------------[]-------------------E-----------------XXX--------------XXXX--XX---------XXXX-----------------------------------------------------------------------------------------------------------[]--[]--------[]-----XXX-----------------------------------XXX-------------------------------E-----[]-----[]--------------------E--[]------------------XX---X--------X--------------X--X-XXXX-------<>------E---------------------------------XXX--XX-------------------[]--[]-----------<>------[]----------XXX------------XXXXXXX---------------------------------------------------------------------------------[]----------XX-----------E-----XX----------------------------------------------------X---------XXX------------------X-----------------------------------------------XXX--XX---------XX-----------[]------<>[]-->-------------XXX-XX---------------[]--E-----E----<>---E-----------------XXXX--XX------X----------------XX---------------------------------------<>----------------------------E----<>-----------------
-----------------------XXXXX--------------[]-----------------------XXXXXXX-XXX---XXXo-XXXX---------------------------------[]------[]----[]------------------XX-E-------------------------XXXX--------------SS-SSSSS---------------------------------XXX-XXX-------------E----------------------------------------XX---------------------------X----X-------------------------[]----[]--[]----[]-----------X----------E-X-XXX------X-----[]-----------------X[]-------------------[]--[]----------------------------------------------[]---------X--------<>------------------------------<>-XXXXXX-XXX-----XXXXX--------------------<>-------------------------------------------<>------------------------------------------[]------------[]----XXXX-------------------X------------------------------------------------<>-----[]-----[]-------------------<>--[]-----------------XXX---XXX-----XX---------XE---X----XXXX-------[]--------------------------------------XXXXX--X--------------------[]--[]----<>-----[]------[]---------XXXX-----------XXXXXXXX----------X----------------o-----------------------------------------------------[]---------XXX----------<>-E---XX-------------------------------X----------------E---XXX------XXXX------------------X------------------------------------X---------XXXX--XXX-------XXX-----------[]------[][]---------------XXXX-XXX---------X----[]-<>----<>----[]--<>----------------XXXXX--XXXXX---X----------------XX---------------------------------------[]---------------------------<>----[]-----------------
------------------------------------------[]---------X-------o----XXXXXXXXXXXX-EE---XXXXXX---E--E-----E-----E--E----EE-----[]------[]----[]------------------XXE------------XXXXXXXX--------------------------SSSSSS--------------------EE-E--E----X-XX--XXX-------------X--------EE-E---------------------------XXX-----------------------E-E-X------------------E------E-E--[]---E[]--[]-E--[]--------E--X--------------XXX-----XX-----[]-------E-E------XX[]-------------------[]--[]----------------------------------------------[]---------X--------[]------------------------------[]XXXXXXX?XXXX?---XXS----------------------[]-E----------------E---------E--------------[]------------------------------------------[]--------E---[]-----XXX-----E-------------X----E-E-----------------------------------------[]--E--[]-----[]--E----------------[]--[]--------------XXXXXX----------XXX--------XXX---X----XXXX-------[]--------------------------------------XXXXX--XX-------------------[]--[]----[]--E--[]------[]--------X-XXXX---------XXXXXXXXXS--------XX------ooo------------------------------------------E-E-------------E--[]--------XXXX----------[]-X---XX---------------------------E---X----------------EX--XXXX----XXXXX------------E-EE--X----------------------E-----E------XX-E-E----XXXXXE-XXXXE-EE---XX-------EE--[]-E----[][]--------------XXXXX-XXX---EE---XXEE--[]-[]--E-[]----[]--[]-E-------------XXXXXX-?XXXX----X----------------XX--SSSSSS-------------------------------[]---------------------------[]----[]-----------------
-XXXXX----------------------XXXX--XXXXXXXXXXXXXXXXXXXXXX---XXX--XXXXXX?-XXXXX-----S-XXXXXXXXXXXXXXXXXXXXXXXXXXXXXXXXXXXXXXXXXXXXXXXXXXXXXXXXX---XX----XXXXXXXX-XXXXXXXXXXX--------------------------XXXXXXXXXXXXXXXXXXXXXXXXXXXXXXXXXXXXXXXXXXXXXXXXXXXX-XXXXXXX-XXXXXXXXX---XXXXXXXXXXXXXXXXXXXXXX----------XXXXXXX-----XXXXXXXXXXXXX-XXXXXXXXXXXXXX------XXXXXXXXXXXXXXXXXXXXXXXXXXXX-XXXXXXXXXXXXXXXXXXX-XXXX-XXXXXXXXXXXXXXXXXXXXXXXXXXXXXXXXXXXXXXXXXXXXXXX--XXXXXXXXXXXXXXXXXXXXXXXXXX----------------------------XXXX--XXXXXXXXXXXXXXXXXXXX-XXXXXXXXXXX--XXXX---XXXX-----XXXXXX--X-XXXXXXXX-XXXXXXXXX-----------------------XXXXXXXXXXXXXXXXXXXXXXXXXXXXXXXXXXXXXXXXXXXXXXXXXXXX-XXXXX--XXXXXXXXXXXXX-----XXX--XXXX--XXXXXXXXXXXXXXXXXXXXXXXXX--XXXXXXXXXXXXX-X---XXXXXXXXXXXXXX------XXXXXXX-XXXXXXX----XXXXXXXXXXXXXXXXXXXXXXXXXXXXXXXXXXXXXXXXXXXXXXXXXXXXXXXXXXXXXXXXXXXXXX-------XXXXXXX---XXXXXXXXX--XXXXXXXXXXXXXXXXXXXXXX-X-XX-XXXXXXXX-----XX---XX--XXXXXXXXXX--XXXXXXXXXXXXXXXXXXXXXXXXX-XX--XXXXXXXXXXXXXXXXXXXXXXXXXXXXXXXXXXXXXXXXXXXXXXXXXXXXXX-XXXXXXXXXX---XXXX--------XXXXXXXXX-XXXX--XXXXXXXX---XXXXXXXXXXXXXXXXXXXXXXXXXXXXXXXXXXXXXXXXX-XXXXXXXXX-XX--XXXXXXXXXXXXXXXXXXXXXXXXXXXXXXXXXXXXXXXXXXXXXXXXXXXXXXXXXXXXXXXXXXXXXXXXX---XXXXXXXXXXXXXXXXXXXXXXXXXXXXXXXXXXXXXXXXXXXXXXXXXXXXXXXXXXXXXXXXXXXXXXXXXXXXXXXXXXXXXXXXXXXXXXXXXXXXXXXXXXXXXXXXXXXXX-XXXXXXXXXXXXXXXXXXXXXXXXXXXXXXXXXXXXXXXXXXXXXXXXXXXXXXXXXXX--XXXXXXXXXXXXXXX-XXXXXXXXXX-------XXXXXXXXXX------XXXXXX------XXXXXXXXXXXXXXXXXXXXXXXXXX--XXXXXXXXXXXXXXXXXXXXXXXXXXXXXXX