------------------------------------------------------------------------------------------------------------------------------------------------------------------------------------------------------------------------------------------------------------------------------------------------------------------------------------------------------------------------------------------------------------------------------------------------------------------------------------------------------------------------------------------------------------------------------------------------------------------------------------------------------------------------------------------------------------------------------------------------------------------------------------------------------------------------------------------------------------------------------------------------------------------------------------------------------------------------------------------------------------------------------------------------------------------------------------------------------------------------------------------------------------------------------------------------------------------------------------------------------------------------------------------------------------------------------------------------------------------------------------------------------------------------------------------------------------------------------------------------------------------------------------------------------------------------
------------------------------------------------------------------------------------------------------------------------------------------------------------------------------------------------------------------------------------------------------------------------------------------------------------------------------------------------------------------------------------------------------------------------------------------------------------------------------------------------------------------------------------------------------------------------------------------------------------------------------------------------------------------------------------------------------------------------------------------------------------------------------------------------------------------------------------------------------------------------------------------------------------------------------------------------------------------------------------------------------------------------------------------------------------------------------------------------------------------------------------------------------------------------------------------------------------------------------------------------------------------------------------------------------------------------------------------------------------------------------------------------------------------------------------------------------------------------------------------------------------------------------------------------------------------------
SSSSSSSSSSSSSS?SSSSSSSSSSSSS----------------------------------------------------------------------------------------oo---------------------------------------------------------------------------------------------------------------SS--S------------------------------------------------------------------------------------------------------------------------------------------------------------------------------------------o-------------------------------------------------------SSSSSSSSSSS--SSSSSSSSSSSSSSS-------------------oo-------SSSSSSSSSSSSSSSSSSSSSSSSSSSS--------------------------------------------------------------------------------------------------------------------------------------------------------------------------------------------------------------------------------SSSSSSSSSSSS?SSSSSSSSSSSSSSS----------------------------SSSSSSSSSSSSSSSSSSSSSSSSSSSS--------------------------------------------------------------------------------------------------------------------------------------------------------------------------------------------------------------------------------oo----------------------------------------------------------------------------------SSSSSSSSSSSSSSSSSSSSSSSSSSSS--------------------------------------------------------------------------------------------------------------------------------------------------------------------------------------------------------------------------------------------------------------------------------------------------------------------
SSSSS------------------S-------------------------------------------------------------------------------------------XXXX-------------------------------------------------------------------------------------------------------------------------------?---oS--------------------------------------------------------------------------------------------------------------------------------------------------------------------------------------------------------------------------------------------SSSSSSSSSSSSSSSS------------------XXXX-------------------------------------------------------------------------------------------------------------------------------------------------------------------------------------------------------------------------------------------------------------------SSSS---------------SSSS--SS----------------------------SSSSSSSSSSSSSSSSSSSS----------------------------------------------------------------------------------------------------------------------------------------------------------------------------------------E--E------------------------------------------------E--E----------------------------------------------------------------------------SSSSSSSSSSSSSSSSSSSSSSSSSSSS---------------------------o-------------------------------------------------------------------------------------------------------------------------------------------o--------------------------------------------------------------------------------------------------------------------------------------------
SSSSS------------------S--E---------------------------------oooo---------oo--oo------------------------------------------------------------------------------------------------------------------------------------oo--o----------------------------S-----SS------------------------------------------------------------------ooooooo--------------------------------------------------------------------------------------------------XX---o----o--?----oo---------------------------------------------SSSSSSSSSSSSSSSS-------------o--------------------------------------------------------------------------------------------------------------------------------------------------------------------------------------------------------------------------------------------------------------------------ESSSS---------------SSSS--SS---------------oo-----------SSSSSSSSSSSSSSSSSSSS-----------------------------------------------------------------------------------o---------------------------------------------------------------------------------------------------XXXXXXX---------------------------------------------XXXXXX----------------------------------------------------------------oo--oo-----SSSSSSSSSSSSSSSSSSSSSSSSSSSS---------------E----------------------------------------X----------------------------------------------------------------------------------------------------------------------------------oo-----------------------------------E-----------------------------------------------------------------------------------
-S----oo--ooooo------S----SS--------------------------------XXXX-----------XXX--------------------------------------------------------SS---S--------------------------------SQ----------------------------------------------------------------------SS---------------------------------------------------------XX---SS-----------------------------------------------o------S-----------------------------------------SQSSSS?---------------------X-------------------------------------------------S-SSSSSSSSSSSSSSSSSSo----------------------------------------------------------S------------------------------------------------SSSS---?------------SSS-SS------SSSSS---------oo----?----------------------------------S-----------SSS--SSSS-----------------------SSSSS----SSSS-----------------------------S--------oooo-------SSS----SSSSS-----------------------SSSSSSSSSSSSSSSSSSSS-QQ--------SS------------------?SSSSQ----------------SSSSS------------------------XXXX-----------------------------SS----SSSSQS---------XX-----SSS---S-?----------------SSSS-----------------------------------------------------------------------------------------------------------------------X-o--XXXX----------------SSSSSSSSSSSSSSSSSSSSSSSSSSSS--SSSS-------SSQSSSSSSSSSSSS------S-------------------------Q----Q---------------------------------------------------------QQQQ-SS---------------------------SSSSS--SSSS-----------XXXX----------------------S------------------S-----------------------SSSS---------------SSSSSSS------SSSSS-------XXoo----oo------
-SS------------------S----SS--------------------ooo-------------------SS------------------------------------------E--------------------------------------------------------------------------------------------------ooo---------------------------SSS--------------------------------------------------------XXX----E--------------------------------------------------XXXX---------------------------------------------------X-----------------------o-----------------------------------------------------------------------------------------------------------------------------------------------------------------------------------------------------------------------------------XXX------------------------------------------------------------------------------------------------------------------SS-------------------SSS--------------------------XXX--------------------------------------------------------------------------------------------------------------------------------------------------------------XXX-------------------------------------------------------ooooo------------------------------E----------------------------o----------------------------------------------------------------------------------------------------------------------------------------------------------------------------------------------------------------------------------------------------------------XXX--------------------------------------------oo---------------------------------------------------------------------------------------XX
--S----S--SSSS-------S----S-------------------------------------------------------------------------------------------------------------------------------------------------------------------------------------------------XXXX-------------------SSS-----------------------------XX------------------------XXXX------------------o-------------------------------------------------------------------------------------------------------------------------------------------------------------------------------------------------------------------o----------------------------------------------X---------------------------------------------------------------------------------------------------------------------------------------------------------------------------------------------------------SS--------SSSS-------SSS--------------------------------------------------------------------------E---------------------------------------------------------------------------------------------------------------XXXX----------------------------------------------------------------------------------------XXXXXX--------------------<>-------------------------------E-------------------------------------------------------------------------------------------------------------------------------------E--------------------E-----------------------------------------------------------------------------------------------XXXX-----------------E-------------------------------------------------------------------------------------------oo-
ooSS---SS-SSSS-S---?-SQ---E-S---------S-----------------oo-----------------------------------------------o-------S-SQ-------------------------------------------------------------------------------SSSSSSS---------------------------------ooo--?-SSS--QE------------------------XXX-----------------------XXXXX-----------------------------------------------------------S------E--------------<>-SS--------------------------------------------------------------------------------oo-------------------------------XXXSSS------------------SSSS-----------oo---oo---------oXS-SQo-------------------ooE--------------E--------------S-------------E----------XXS--E--------------------------------------------------------------------------------------------oo------------------------------------------SS----------SS---S??-SSS-EE-SSSS----------------------------?--------E-EEE-----------------------<>--S----------------S-SS----------------------------------------------S--------E---------------SS-E-----------XXXXXX---------------------------------------------------------------------------o------------------XXXX------S------E--[]------------S------------------E------------------------S--------------------?--ooooooooo---------------------------------------------------------------------------<>-------------------<>-------E-----E-------E-------------------------------------------------QSSSSS----------------------S---------------<>------------------------------S-------------------------------------XXX-----------------------
SSSS---SS------------SSS---S---E---------E--?--------------------------XXXX--------------------S-------------------------------E--S--------------------QQQ--------E----------S------------Q-----------------------------------------------E--------SSS-SSSSS-----------Q-QS------XXXX----------------------XXXXXX--------------XXX--------------X------------XXXXXXXX----------E---------E--E--E--[]-------------Q--Q--Q--Q--S--------------XXXX-----------------------------------------------XXX--SS--??SSSSS------------------------E-------------SS----------------------------o--o---------EX--X-----------------E--<>-----------XX---------E----<>----------XX--<>------XXXX--------------QQQ------------------------S-----------XXX-XX----------X----------E----------------X----------------------------SSSS---XXX---S---SS--SSS---X------oo---XXX--------------SSSS?SSSSSSSSSSSSSS--QQ-QQQQ-------------[]-----E--SS-------------o-E-------S---S---Q-Q---XXX----------------------E----<>-----QQQQ---------Q---S?S----XXXXXXX----------oooo-------XXXXX-------------------oo-----------------------------o---------------------------------<>--[]---X--------------S-----------<>--------XXX--------XX-----------SSSS--SSSSSS???SSSSS-SSSSS---SSS------SSSSS-SSSSSSSSS-----SSS-----------------------QSS--QQQ---E-Q--[]-------------------[]------<>----<>--S---<>----SQQQ-----------------------------QQ----QS-------------------XX--------------E---------E--[]-E--------Q---SSS--------S----------SS------------Q-ESSQSSSSQQ---------------XX---XXXX-SSS----
------------------------------<>--------<>--------------------------------E--------o------------------------------------------<>---------------------------------<>------------------------------------------------E---------------------<>-----------EE------------------------XXXXX--------XXX-?--------XXXXXXX-------------E-----------------------------------------------<>--------<>----<>--[]-------------------------------X---------------E------------------------------------------XXXX---S--------------------------------<>------------------------------------------------------E-XX--XX---------------<>--[]----------EXX--------<>----[]--------EXXX--[]--------------------------------------------------------------XXXX-XXX-------EXX---------<>---------------XX--------------------XX------E-----EXXX---------------E-X----------------------------SSSSSSSSSSSSSSSSSSS----------------------[]----<>---------XXXX--X---E--E-E--E-------------------------------------<>----[]----------------------------XXXXXXXX--------------------XXXXXXX------------------------------------------------------E-----------X---E---E--------[]--[]---------------------E--------[]------------------XXX------SS--SSS-oo-SSSSSS----------------------------------------------------------X-----------------------------[]-------------------[]------[]----[]------[]---------------------------------------------------------------------------XX--<>--------<>--[]<>--------------------------E---E-------------------------------------------------------------
------------------------------[]--------[]--------------------------------XXXX---XXXXXXX--------------------------------------[]---------------------------------[]-----------------------------------------------<>---------------------[]------------------------------------XXXXXX--X-----------------XXXXXXXX-----<>-----------------------------X------------------------[]--------[]----[]--[]-------------------------------X---------------------------------------------------------XXXXX---XX-------------------------------[]-----------------------------------------------------X-XXX--XXX--------------[]--[]---------XXXX--------[]----[]-------XXXXX--[]-------------------------------------------------------------XXXXX-XXX-------XXX---------[]--------------XXX----------------------------------XXXX-----------------X----------------------------SSSSSSSSSSSSSSSSSSS----------------------[]----[]--------XXXXXX-X---------------E---------------------------------[]----[]---------------------------XXXXXXXXX---------X---------XXXXXXXX-------E---------------------------------------------------------XX--<>------------[]--[]--------------------<>--------[]--------------XXXXXXXX-----SS---S---SSSSSSS-----------------------------------------------------------------------------------------[]-------------------[]------[]----[]------[]--------------------------------------------------------------------------XXX--[]--------[]--[][]-------------------------<>--<>---------X---------------------------------------------------
E-----------------------------[]--------[]-----------------------XXXXXX--------------------------------------------E-------E--[]-E---------S-----EE-E------EE-E--[]---------------------------EE-E-X--------------[]---------------EE-E--[]----------------------E--E------EE-XXXXXXX--X-----------------XXXXXXXX-----[]-------------------X----------------------------------[]--------[]----[]--[]--------------------------E----X-XXXXXXX------X-----------------------------------------XXXXXX------------E-EE-----E--------------[]----------------------------------------------------XXXXXX--XXX--------EE-E--[]--[]--------XXXXXE--EE-E-[]-E--[]------XXXXXX--[]------------------------------------------------------------XXXXX--XXXX-----XXXX---EE-E--[]-------------XXXX--------E-----EE------------E----XXXXX-----------------X----------------------------SSSSSSSSSSSSSSSSSSS----------------------[]----[]-------XXXXXXX---------------------------------------------------[]E---[]-----------EE-----E-E-----XXXXXXXXXX--------XXE-------XXXXXXXXX-----------------------------------E----------------------------XXX--[]------EE-E--[]--[]--------------E---E-[]--E-----[]-S--ooo-----XXXX----------E--------------S--o-------EE-E----------------------------------------------------EE-E--------------------[]--E-EE-------E-E---[]------[]----[]---E--[]---------E-EE---------E-EE------E---------EE-----------------------------XXXX--[]-----E--[]--[][]----E-EE---EE------E-----[]--[]-----E---X----EE--E---------------------ooo------------------
XXXXXXXXXXXXXXXXXXXXXXXXXXXXX-XXXXXXXXXXXXXXXXXXXXXXXXXX-XXXXXX-----------------------------XX---XXXXXXX---XXX--XXXXXXXXXXXXXXXXXXXXXXXX---XXXXXXXXXXXXXXXXXXXXXXXXXXXXXXXXXXXXXXXXXXXXXXXXXXXXXXXXXXXXXXXXXXXXXXXXXXXXXXXXXX--XXXXXXXXXXXXXXXXXXXXXXXXXXXXXXXXXXXXXXXXXXXXXXXXXXXXX-XXXXXXX-----XX-X-XXXXXXXXXXXXXXXXXXXXX----XXXXXXXXXXXXXX-XX----------------------------XXXXXXXXXXXXXXXXXXXXXXXXXXXXXXXXXXXXXXXXXXXXXXXXXXXXXXXX------------XXXXX-----------XX-XXXXXXXXXXXXXXXXXXXXXXXXXXXXXX-------XXXXXXXXXXXXXXXXXXXXXXXXXXXXXXXXXXXXXXXX----XXXX--XXXX----XX--XXXXXXXXXXXXXXXXXXXXXXXXXXXXXXXXXXXXXXXXXXXXXXXXXXXXXXXXXXXXXXXXXXXXXXXXXXXXXXXXXXXXXXXXXXXXXXXXXXXXXXXX-----XXXXXXXXXXXXXXXXXXXXXXXXX----XXXXXXXXXXXX--XXXXXXXXXXX--XXXXXXXXXXXXXXXXXXXXXXXXXXXXXXXXXXXXXXXXXXXXXXXXXXXXXXXXXXXXXXXXXXXXXXXXXXXXXXXXXXXXXXXXXXXXXX--XXXXXXXXXXX-XX------XX-XXXXXXXXXXXXXXXXXXXXXXXXXXXXXXXXXXXXXXXXXXXXXXXXXXXXXXXXXXXXXXXXXXX----XXXXXXXXXXXXXX-X-XXXXXXXXXXXXXXXX---XXXXXXXXX--XXXXXXXXXXXXXXXXXXXXXXXXXXXXXXXXXXXXXXXXXXXXXXXXXXXXXXXXXXXXXXXXXXXXXXXXXXXX-XXXXX-XXXXXXXXXXXXXXXXXX--XXXXXXXXXXXXXXXXXXXXXXXX----XXXXXXXXX--XXXXXXXXXXXX--XXX-XXXXXXXXXXXXXXXXXXXXXXXXXXXXXXXXXXXX--XXX-----------------------XXXXXXXXXXXXXXXXXXXXXXXXXXXXXXXXX--XXXXXXXXXXXXXXXXXXXXXXXXXXXXXXXX--X---XXXXXXXXXXX--XXXXXXXXXXXXXXXXXXXXXXXXXXXXXXXXXXXXXXXX-XXXXXXXXXXXXXXXXXXXXXXXXXXXXXXXXXXXXXXXXXXXXXXXXXXXXXXXXXXXXXXXXXXXXXXXXXXXXXXXXXXX-------XXXXXXXXXXXXXXXXXXXXXXXXXXXXXXXXXXXXXXXXXXXXXXXXXXXXXXXXXXXXXXXXXXXXXXXXXXXXXXXXXXXXXXXXXXX-----X-XXX------------XXXXXX