------------------------------------------------------------------------------------------------------------------------------------------------------------------------------------------------------------------------------------------------------------------------------------------------------------------------------------------------------------------------------------------------------------------------------------------------------------------------------------------------------------------------------------------------------------------------------------------------------------------------------------------------------------------------------------------------------------------------------------------------------------------------------------------------------------------------------------------------------------------------------------------------------------------------------------------------------------------------------------------------------------------------------------------------------------------------------------------------------------------------------------------------------------------------------------------------------------------------------------------------------------------------------------------------------------------------------------------------------------------------------------------------------------------------------------------------------------------------------------------------------------------------------------------------------------------------
------------------------------------------------------------------------------------------------------------------------------------------------------------------------------------------------------------------------------------------------------------------------------------------------------------------------------------------------------------------------------------------------------------------------------------------------------------------------------------------------------------------------------------------------------------------------------------------------------------------------------------------------------------------------------------------------------------------------------------------------------------------------------------------------------------------------------------------------------------------------------------------------------------------------------------------------------------------------------------------------------------------------------------------------------------------------------------------------------------------------------------------------------------------------------------------------------------------------------------------------------------------------------------------------------------------------------------------------------------------------------------------------------------------------------------------------------------------------------------------------------------------------------------------------------------------------
-------------------------------------------------------------------------------------------------------------------------------------------------------------------------------------------SSSSSSSSS------SS-------------------------------------------------------------------oo---------------------------------------------------------------------------------------------------------------------------------------------------SSSSSSSSSSSSSSSSSSSSSSSSSSSS----------------------------------------------------------------------------------------------------------------------------------------------------------------------------------------------------SSSSSSSSSSSSSSSSSSSSSSSSSSSSSSSSSSSSSSSSSSSSSS--SSSSSSSS---------------------------------------------------------------------------------------------------------------------------------------------------------------------------------------------------------------------------------------------------------------------------------------------------------------------------------------oo-------SSSSSSSSS----------------SS-----------------------------------------------------------------------------------------------------------------------------------------------------------------------------------------------------------------------------------------------------------------------------------------SSSSSSSSSSSSSSSSSSSSSSSSSSSS--------------------------------------------------------------------------------------------------------------------------------------------
------------------------------------------------------------------------------------------------------------------------------------------------------------------------------------------------------------------------------------------------------------------------------XXXX-----------------------------------------------------------------------------------------------------------------------------------------------------------------------------------------------------------------------------------------------------------------------------------------------------------------------------------------------------------------------------------------------------------------SSSS----SSSSSS-------------------------------------------------------------------------------------------------o-------------------------------------------------------------------------------------o---------------------------------------------------------------------------------------------------------------------------------------------------------XXXX--------------------------------------------------------------------------------------------------------------------------------------------------------------------------------------------------------------------------------------------------------------------------------------------------------------------------------------------------------------------------------------------------------------------------------------------------------------------------------------------------
---------------------------------------------------------------------------------------------------------------------------------------------------------------------------------------E-------------------------------------------------------------------------------------------------------------------------------------------------------------------------------------------------------------------------------------------------------------------------------------------------------------------------------------------------------------------------------------------------------EE--------------------------------------------------------------------------------------------------SSSS--E-SSSSSS-------------------------------------------------------------------------------------------------------oo--------------------------oo--oo---------------------------------------------------------------------------------------------------------------------------------------------oo-----------------------------------------------------------------------------------------------------------------Eooo----------------------------------------------------------------------------------------------------------------------------E-------------------------------------------------------------------------------------------------------------------------------------------------------------------------------------------------------------------------------------------Eooo--------------------------------------------------------------
-----------------------------------------------------XX------------------------------SSSS---SQS--E--------------SS--------------------SSSSS----------------------------SS-SSS----SS---SQQQS--?------SSSSS--??------------?------------oo-SS---------?-------SSSSS------------------------------------------------------?-------------------------SSS----------------SSSS------SSS------SSSS-------------------------XXX-----XXX---------------------------------Q-------------------X---------------------------------E------------SSSSS-SSSSS---------?-------------S---SS----SSSSSSS--------SQSS---QQ-------------------------------SS----SSS?---------------------------------------------------SSS---SS---SS-S---?-S---------------------------SSSSSQSSS--------------SSSSS-----------------S---SSSS----S--S----S-S-XXX-------E---------------------------------------------------------------------SSS----SSS--SSSSSSSSSSSS-----------SSS--SSS---------------------------SSSSS-----XX------------------------------------?----------------------------------------------Q----------------SSSSSSQ---Q-----------------XXXXX----------SSS------------------QQS----------------------------SS----------------XXX---------------------------------------SQS--QQQ---------------------------------------SSS-SSSSS----------------------------------S--------------------------------------------------------------------------------------------------------------------------------------------------XXXXX----------------------------------SSS------?SSS--------------
----------oo--------------------oXX------o---o---o-------------------------------------------------XXX---oooo--------------------------------------------------------------------SS---------------------------------------------------------------------XX-----------------XXX---------------------------------------------------------------------------------------------------------------------XX---------------------------------------------------------------------------------------------oooo---------------<>---------------------------------------------------------------------------------------------------------------------------------<>-----------------------------------------------SS----------------------------------------------------------------------------------------------------------------------<>---------------------------S--------------------------------------------------------------------------------------------------------------------------------------------oo----------------------------------------------------oo--------------------------------------------------------------------------------------------------------------------------------------------XX---------------------------------------------------------------------------------------------------------------------------------------------------------------------------------------------------------------------------------------------------------------------------------------------XX--------------------------EX----------------------------
-------------------------------?----XXXXXXX-XXX-XXX----------------------------------------------------------------------------------------------------------------------SSS-----SS------------------------------------------------------------------------------------------------------------------------------------------------------------X------------------------------------------------------------------------------------------------------------------oo-------------------------------------------------[]---------------------------------------------------------------------------------------------------------------------------------[]-----------------------------------------------SS----------------------------------------------------------------------------------------------------------------------[]----------------------------------------------------------------------------------------------------------------------------------------------------------------------------XXXXX--------E--------------------------------------E--------------------------------------oo---------------------------------------------------------------------------------------------------XX--------------------------------------------------------------------------------------------------------------E-----------------------------------------------------------------------------------------------------------------------------------------------------------------------------XoX-------------------------<>X----------------------------
-------E----------------XX----XX------------------o---------------ooo--------------------------------------XXo------------------------------------------------------------SQ-----SS------------------------------------------------E----------------------------------------------------SQSSSSSS-----------------------------------E----------XX---------------E---------------------------------------------S-------------------------------------------------------------------------------S--------------------E--[]------------------------------SQSQ-------S----------S-------E------------------------------------oooo----------------------------[]----------------------------------------E------SS--------------------------------------------------------------------------------------------------------------E--E----XX---------X---oo----------XS--SQ----------SSSS-------------------S------------X----------------S-------------------------X-------------------------oo--------E----------------------------------------S----------------------E--<>-------------------------------E---------------o---------------------S--------------E----------------------E---------E---------------------XX-----------------------------------------------------oo----------------------------------ESS----------------E<>-------------------------------oo------------------E-----------------------------------------------------------------------------------------------------------------------------S--------------------E--[]X-------------------SS-------
---E--<>---------------XXX-XXXXX-XX------------------------------------------QQQ--------XXXXX-------------------SS-------E-----------------X--------------E-----------Q--SSSSS--SSS----SSSQSQQ---------SSSSSSSSSSSSXXXX-----------<>-----XXXX-------------------------X----------------------------------------------QQQ----------<>---------XXX-QQQ-----E----<>---------XXX---QQQ--------------------------------------XXX--SS---------------------------------SS-----EX-oo-------------------------------S-----<>--[]X----Q-Q--Q------S---------XX---------------E------XX-XXXSSSSSS--SS-SSSSQ--Q--Q--Q-QQ----------E---------E--S-------SSS---SSS----S----Q--Q--Q-QQ---------------------------SSSS---SS----QQQQ--QQQ---------E--------------------S-QQQ----QQQ--Q--Q------QQQQ------------XXX-X------oX---------SQS-----XXX--XX------------o--o--------XXX---------------------SS---------------Q---S?S----XXX-XX----S------------------X--X----------XXQQQ---------------S---------------<>-----------QQQ------------S?S---S-----------------------------<>--[]--------E-------------------SSSSSS--S------E--------XXX-------------------<>----E--<>---QE??--------------<>--------<>--oooo------XXX-XX---XX-------------------------------------------Q?SSQSQ-------------Q------------------------<>X-----E-Q-----E--<>[]-----------------------S------------QQQ-----------<>-----E--------------E-------------------XX------oo----------XX-----------------E--?---E------------------------XXXXXXXXX-------------------------<>--XXX--QQ--SQQ-------------------
--<>--[]--------------XXXX--XXXX-------------E-----------------------------------------------------------S--------------<>--------------E-XX-------------<>-------E-----ESSSSS------E------------------SSSSSSSSSSSS------------X--[]--------------------E--S--------------------------o----------------------------X--------------[]--------XXXX--------<>----[]--------XXXX-----------------------------------------XX-------------------------------------EX--------XXX-----------E----------------------------[]--[]X-------------------------XXX--------------<>-----XXX-XXXSSSSSS--ESSSSSSS---------------------<>--------<>-----------SS---------------------------------------------------S---------SS--------------------------------------------------------------------------------XXX--XX---E--E-----------------X[]--XX-----------------------XXXX--------XX---------------------X----------------XXXX-XX----------X------------X--X---------XXX----------------------------------[]-----------------------------------E--------------------------[]--[]------------------------------------------<>------------------------------[]---<>--[]---------------------[]--E-----[]-----------XXX--XX---XX----------------------E------------------E--------------------------------E-------------[]X------------<>--[][]----------------------------------XX--------------[]--E-<>--------E----<>-----------------------------E-------------o--E----------<>-----<>----------------------------------------------------------[]--XXX----------------------------
--[]--[]-------------XXXXX--XXXX------------<>-----------------------------------------------------------S--------------[]------------EXX-XX-------------[]------<>----------S------------------------SSSSSSSSSSSSS------------X--[]-------------------<>---------------------XXXX--------------------------------XX--------------[]----<>-XXXXX--------[]----[]-------XXXXX---------------------------X------------XXX-----------EX----------------------EXXX-------XXXX--XXX----------E------------------------[]--[]X------------------------XXXX--------------[]----XXXX--XXSSSSSS--oSSSSSSS---------------------[]--------[]-----------SS-------------------------------------------------------S-----SS-------------------------------------------------------------------------------XXXX--XXX------------------------[]--XX----------------------XXXXX-------XXX---------------------X---------------XXXXX-XXX---------X-----------XX--XXX------XXXX---------------S------------------[]----------------------------------<>-----------E--------------[]--[]------------------------------------------[]------------------------------[]---[]--[]---------------------[]-<>-----[]----------XXXX--XXX--XX--------------------------E-------------<>-------------------------------<>-------------[]X------------[]--[][]----------------------------------XX--------------[]-<>-[]---X---<>----[]----------------------XXXXXXXX------------XXXXX----------[]-----[]-------------------------------E---EX---------------------[]-XXXX----------------------------
--[]--[]--------E---XXXXXX--XXXX------------[]-------S---------------------E----------------------------------------E---[]-E-------XX-XXX-XX-E-E---------[]------[]---------------------------E-EE----------ooo----------------X--[]--ooo---------E----[]--X-------------------------------------------------EE-XXXX--------------[]----[]XXXXXXEE------[]----[]------XXXX-X----------------------E---XX-----------XXXX---S-------XX----EE-E--------------XXXX-------XXXX---------------------------EE-----E-----[]--[]X-----------------------XXXXX---------E-E--[]-E-XXXXX--XXSS---oooSSSSS-SS-----------E---EE-E--[]--------[]-E--------------------------E-----------------------------------E--------E--------E-E-------E-------------------------------------------------------------XXXXX--XXX------------------------[]--XX-----E---------------XXXXXX-SSSSSSXXX------------------E--X--------------XXXXX--XXXX-------XX---E-----E-XX--XXXX----XXXXX----------------------------------[]-----------------EE---------------[]-----------------------E--[]--[]------------------------------------------[]-------------------------E-E--[]---[]--[]--------E-EE-E-------[]-[]--E--[]--E-E----XXXXX--XXX--XX----E-X---------------------------------[]-------------------------E-----[]-------------[]X------------[]--[][]-----------E----EE-E-------------XXX--------------[]-[]-[]---X---[]----[]-------------------------------------------------------E-[]-----[]-----------------XXXXXXX-----------XX------E-EE-E--EE-----[]--XXX----------------------------
X-XXXXXXXXX-XXXXXXXXXXXXX---XXX------XXXXXXXXXXXX---XXXXXXXXXXXXXXX---XXXXXXXXXX--XXXXXXXXXXXXXXXXXXXX------XXXXXXXXXXXXXXXXXXXXXXXXXXXXXXXXXXXXXXXXXXXXXXXXXXXXXXXXXXXXXXXXXXXXXXXXXXXXXXXXXXXXXXXX-XXXXXXXXXXXXXXXX----XXXXXXX------XXX-----XXXXXXXXXXXXXX-XXXXXX------XXXX-----------XXXXXXXXXXXXXXX--XXXXXXXXXXXXXXXXXXXXXXXXXXXXXXXXXXXXXX-XXXXXXXXXXXXXXXXXXXXXXXXXX--XXXXXXXXXXXX-----XXXXXXXXXXXXXXXXXXXXX-XXX-------XXXXXXXXXXXXXXXXXXX---XXXXXXXXXX--XXXXXXXXX-------XXXXXXXX-X--XXXXXXXXXXXXXXXXXXXXXXXXXXXXX--XXXXXXXXXXXX-XXXXXXXXXXXXXXXXXXXXXXXXXXXXXXXXXXXXX--XXXXXXXXXXXXXXXXXXXXXXXXXXXXXXXXXXXXXXXXXXXXXXXXXXXXXXXXXXXXXXXXXXXXXXXXXXXXXXXXXXXXXXXXXXX--XXXXXXXXXXXXXXXXXX--XXXXXXXXXXXXXXXXXXXXXXXXXXXXXXXXXXXXXXXXXXXXXXXXXXXXXXXXXXXXXXXXXXXXXXX---XXXX-XXXX------XXXXXXXXXXXXXXXXXXXXXXXXXXXXXXXXXXX--XX--XXXXXXXXXXXXXXXXXXXXXXXXXXXX------XXXXXXXXXXXXXXXXXXXXXXXXXXXXXXXX-XXXXXXXXXXXXX--XXXXXXXXXXXXXX-XXXXXXXXXXX--XXXXXXXXXXXXXXXXXXXXXXXXXXXXXXXXXXXXXXXXXXXXXXXXXXXXXXXXX----XXXXXXXXXXXXXXXXXXXXXXXXXXXXXXXXXXXXXXXXXXXXXXXXXXXXXXXXXXXXXX-XXXXXXXXXXXXX--XXXXXXXXXXXX-XXXXXXXXXXXXXXXXX---XXXX--XXXXXXXXXXXXXXXXXXXXX-XXXXXXXX-XXXXXXXXXXXXXXXXXXXXXXXXXXXXXXXXXXXXXXXX--XXXXXXXXXXXXXXXXXX--XX-X-XX-XXXXXXXXXXX-XXXXXXXXXXXXXXXXXXXXXXXXXXXXXXXXXXXXXXXXXXXXXXXXXXXXXXXXXXXXXXXXXXXXX-XXXXXXXXXXXXXXXXX-X-XXXXXXXXXXXXXXXXXXXXXXXXXXXXXXXXXXXXXXXXXXXXXXXXXXXXXXXXXXXXXXXXXXXXXXXXXXXXXXXX----------------------------XXXXXXXXXXXXXXXXXXXXXXXXXXXXXXXXX------------------XXXXXXXXXXXXXXXXXXXXXXXXXXXXX-XXXXXXXXXXXXXXXXX---XXX-XXXXX-X