---------------------------------------------------------------------------------------------------------------------------------------------------------------------------------------------------------------------------------------------------------------------------------------------------------------------------------------------------------------------------------------------------------------------------------------------------------------------------------------------------------------------------------------------------------------------------------------------------------------------------------------------------------------------------------------------------------------------------------E----------o--X------------------------------------------------------------------------------------------------------------------------------------------------------------------------------------------------------------------------------------------------------------------------------------------------------------------------------------------------------------------------------------------------------------------------------------------------------------------------------------------------------------------------------------------------------------------------------------------------------------------------------------------------------------------------------------------------------------------------------------------------------------------------------------------------------------------------
--------------------------------------------------------------------------------------------------------------------------------------------------------------------------------------------------------------------------------------------------------------------------------------------------------------------------------------------------------------------------------------------------------------------------------------------------------------------------------------------------------------------------------------------------------------------------------------------------------------------------------------------------------------------------------------------------------------------------------XEX------------o-------X----------------------------------------------------------------------------------------------------------------------------------------------------------------------------------------------------------------------------------------------------------------------------------------------------------------------------------------------------------------------------------------------------------------------------------------------------------------------------------------------------------------------------------------------------------------------------------------------------------------------------------------------------------------------------------------------------------------------------------------------------------------------------------------------------------------
------------------------------------------------------------------------------------------SSS---------------------------------------------------------------------------------------------------------------------------------------------------------------------------------------------------------------------------------------------------SSSSSSSSSSSSSSSS-----------------------------------------------------------------------------------------------------------------------------------------------------------------------------------------------------------------------------------------------------------------------------------------------------------------------------------------------------------------XX-------o-----------------------------------------------------------------------------------------------------------------------------------------------------------------------------------------------------------------------------------------------------------------------------------------------------SS-S---SSS--------------------------------------------------------------------------------------------------------------------------------------------------------------------------------------------------------------------------------------------------------------------------------------------------------------------------------------------------------------------------------------------------------------------------------------------------------------------------------------------------------------
-----------------------------------------------------------------------------------o-------------------------------------------------------------o------------------------------------------------------------------------------------------------------------------------------------------Q---------------------------------------------------------------------------------------------------------------------------------------------------------------------------------------------------------------------------------------------------------------------------------------------------------------------------------------------------------------------------------------------------------------------------------------------XX--X--X----XX----------------------------------------------------------------------------------------------------------------------------------------------------------------------------------------------------------------------------------------E--E--------------------------------------------SSSS--------------------------------------------------------o---------------------------------------------------------------------------------------------------------------------------------------------------------------------------------------------------------------------------------------------------------------------------------------o-------------------------------------------------------------------------------------------------------------------------------------------------------------------
-------------------------------------------------------------------------oo--oo------------?----------------------------------------------------E------------------------------oooo-----------------------------------------------------------------------------------------------------------------------------------------------------------------------------------------------------------------------------------------------------------------------------E--------------------------------------------------------------------------------------------------------------------------------------------------------------------------------------------------------------------------------------------------------------------------------X----------------------------------E----------------------------------------------------------------------------------------------------------------------------------------------------------------------X-------------------------XXX-------XXXXXXX------------------------------------------SSS-------------------------X---E---------------------------------------------------E-----------------------------------------------------------------------------------------------------------------------------------------------------------------------------------------------------------------E--------------------------------------------------------------------------------------------oo-------------------------------E----E------------------------------------------------------------------------------
----------------------Q-Q---------------------------------XXX-----------------------SSSSS?S??------SS----QQQQ------ooo--XXXX-------------------SQS------QSQQSSSSS--------------XXXX--------------------------------------------------------------------------SS---S-----------------------------XXX----------------------------------------------------------------------------?------------SSSSSS---SSS----------------------------------------------------SSSSS---------------------------S---------------------------------------------------SSSS-S------------------SSSS------------------------------SS------------------------------S-------------SSQ--SSSS-------------------XXX------------?--------------------------XXXX---------------------------------QQQQ---SSS-------SS--SQS---------------SSSSS-S-----------------------Q----------------------------------SSS------SS-------------------------SSS----------------------------------------XX----------XXX-----oo---------------------------------------S--SSSS-Q-Q-----------------S---Q---oooo------------S--SSQQS-?--------------SSSSS--SSS---------SSSS----------SS--SQS----------------?SSSS--------------------------------Q-----------SSS----S------------------------oo---------------------------------S------------------------------------------------------XX------------SSSSSSSSSS------SSSSS-------S-------SSSSS----S--SSS--------XXX---SSSSS--QS---------------------XXX----SSS---S--SSSSS--SSSSSSSSSS----SQS---?-------------------SSS-------------------------SSS-SS?-------------------
--------------------------------------o---o--------------------------------------E--------------------------------XX--------------------------------------------------------------------------------------o-------------------------------------------------------------------------------XXX------------------------------------------------------------------------------------------------------------------------------------------------------------------------------------------------------------ooo-----------------------------------------------------------------------------------------------------------------------------------------------------------------------XXXX---------------Qooo------------------E----------------XX-----------------------------------------------------------------------------------------------E-XXX------------------------------------------------------------------------------------------------------XXX----XXX--------------------------------------oooo---------XX----------------------------------------------------------------------------------------------------------------------------------------------------------------------------------------------------------------------------------------oooo-----------------------------------------------------------------XXX----------------------------------------------------------------------XXXX---------------------------------------------------------X------------------------XSSS----------------------------------------------------------------
-------------------------------------XXX-XXX-----------------------------------XXXXX-------------------------------------------------X-------------------------------------------------------------------------------------------------------------------------------------------------X-------------o----------------------------o------------------------------------------------------------------------------------------------------------------------------------------------------------------------------------------------------------------------------------------------------------------------------------------------------------------------E---E------------------EXXXX-----------------------------------------------------------------X------------------------------------------------------------------------------------<>-ooo-----------------------------------------------------------------------------------------------------XXXX------------------------------------E--------------------XXX-------------------------------S-S-SSSS-----------------------------------------------------------------------------------E---------------------------------------------------------------------------------------------------------------------------------------------------------------------------------XXXX----------------------------------------------------------------------XXXX---------------------------------------------------------------------------------XXX------------------------------------------------------------------
----------------E-------------------oo------------------------------------------------?----------E-EEE-------------------------------X-X----XX-------------------------------------------------oo-------E-------ooo------------X-------------------------------------------E----------XX--S--------------SS------------E--------------------------------E--o-------------------------------------------X------------------------------------------------------------E---------------S------X----E------------------oo----SSSSS--------E-------------------------------------------------------E--S-------------E---------------------E-----------E--------<>--<>-------SSS-------XXXXXX----------S-------------------------XX-------------------------------------------------------E--------------E-----------X--oo------o------------------[]------------------------------------E---------------------------------------------S---------------------XXXXX-------------------XXXXX-------------------E-------------XXX-------------------------o-----SoS--SSSS---------------------------------SSSSS------------------------------E------------<>----------------------------E------------------------------------------------------------------------------E--------------------------------E-----------------------------------XXXXX---------------------------X---------------------SSSSS--------------XXXXXX-------------------------------E---------------E-E-EE----X----------------------XXXX--SQ------SSSS--------------------SSSS----------------------------
---------------<>-------Q---S---------------------------------XXX-----XXXX----------SS?SSSSSSSSSSSSSSSSE-QQQQ--Q-----XXX--SSS------XXX-X----X--SQ--QQQ--?SQQ--------Q--Q-------------------------------<>-----E---------------EXo----------XX--X------------QQ---SSS------<>---------XXX----------SSS----XX-----------<>-------------------------------<>-------------------o----------XXX-XXX--------XX--XXX----------------------S--------------------------X----<>---------E-----E-----XX---<>-----E------------------------------<>-------S-----QQQQ----------------------XX-------------<>-----E--S------<>--------S----S------<>----S-----<>------SS[]--[]----------------XXXXXXX------------------------S----------XXX-----XXXX------------------S----------S?SQS------------QS--S?S-------<>----------XX-----------S----------Q-Q----[]------------------------------S----<>-X--X---------------Q-Q----QQ-------------------------------------XXXXXX--------XXXXXXXX--------------QQ--S?S-----<>---E---------XXX------SSSS-------X------?SSS---SSS--------------------ESSS------------------------------------S-------------XS--SSS---E--[]-----E-----S?QQQQ----------<>--------------SSS--S--------SQ---Q--------X-------------XXXX-----------------<>----------oo-------------------<>------------QQQQ------------------XXXXXX-----------XX--X---SS----<>X--SSS-E---------------------oo--SSS----XXXXXXX----------QQ--S?--------------<>---------SQS------X--XX-XX------------S?S-----XXXXXX---------X------S?S-----------------------SSSQQ-------------------
---------------[]--------------------------------------------------------XX------SS-S-SSSSSSSSSSSSSSSSSS----------XXXXX-----------XXXXXX----S----------------------------------------------------------[]----<>--------------XXX----------XXX--XX-------------------------[]--------XXXX---------E-------XX-XX--------[]----------------------E--------[]------SSS--------E-----------XXXX-XXX-------XXXXXXXX-----------------------------------------E------XX----[]--------<>---E<>----XXX---[]----<>---------E--------------------[]----------------------------X---E-----XXX-----------E-[]----<>---------[]--------------------[]----------[]--------[]--[]---------------XXXXXXXX-S-----EX-----------E-------------XXX---XXX------o------------S------X-------------------------------------[]---------XXX----------------E------------[]-----------------------------------[]-X--XX-----------------------------------------------------------XXXXXXX------------------------------------------[]--<>---------XXX--------------X--X---------------------------------------------------------------------------------------------------<>--[]----<>---------------------[]---------E-----------------------------X-----o-------------------------------[]-----------E-------------------[]-----------X---------------------XXXXXXX----------XXX--XX--E-----[]X--------------------------------------XXXXXXXX------------------------E-----[]--XXX-------------X--XXXXX-------------------XXXXXXX--------EX--------------------------------------------------------
---------------[]---------------------------------X----------------------XXXX-------S-SSSSSSSSSSSSSSSSSS----------XX----------E----X-XXX----S----------------------------------------------------------[]----[]-------------XXXX---------XXXX--XXX------------------------[]----<>-XXXXX------------EE---XX-XXXXX-----[]-----------------X---<>--------[]------SS--------<>----------XXXXX-XXX------XXXXXXXXXX---------------------------------------<>-----XXXX---[]--------[]--<>[]----XXXX--[]----[]--------<>--------------------[]------------X-----------X---X-------EXXXX----------<>-[]----[]---------[]--------------------[]----------[]--------[]--[]--------------XXXXXXXXX-------XX------------------------XXXX------------XXX-----------------X-------------------------------------[]--------XXXX---------------<>------------[]---------------X-------------------XXX---XX--------------------------------X-------------------------XXXXXXXX-----------------o------------------------[]--[]---------XXX-----------------XXX-------------------------------------------------------------------------------------------------[]--[]----[]---------------------[]--------<>-----------------------------X-----XXXX----------------------------[]-------------------------------[]-----------X--------------------XXXXXXXX---------XXXX--XX-------X[]X---------------X---------------------XXXXXXXXX-----------------------<>-----[]----X-------------X--XXXXXX-----------------XXXXXXXX--------XX--------------------------------------------------------
---------------[]-----------------------------E-EE------------XXXXXXXX--------------SSSSSSSSSSSSSSSSSSSS--------S-oSo--------------X-XXX----S-----------E-----E----------------------------------------[]----[]---------E--XXXXX-E-E----XXXXX--XXXX---E-EE--E----------E--[]----[]XXXXXX-----------------XX?XXXX?-----[]---EE-----E-EE-E-X---[]-----E--[]-----E----------[]---------XXXXXX-XXX-----XXXXXX-XXXX---EE-E-EE-------EE-E----EE-E----------[]----XXXXXX--[]----E---[]--[][]--XXXXXX--[]----[]-E-E----[]----------E---------XX------EE-E-XXE----------XE--X-------XXXXX---EE-E---[]-[]----[]-E-------[]----E--E----EE------[]-E-EE-E--E[]--------[]--[]-------------XXXXXXXXXX-----XXXX--------E--E--EE-------XXXXX---X------------------------X---X-----E-E-----EE-----------EE------E--[]-------XXXXX---------------[]------------[]------EE-E-EE--X------------------XXXX---XX----EE-E----------E-E-----------------------E-E-----E----XXXXXXXXX-XXXXXX---------XXX-----------------------[]--[]---------XXX----------EE-E---XX-E-E------------------------------E--------------------EEE----------------E--------E-E------EE-E--[]--[]----[]---------E--------E--[]--------[]-----------------------------X------------------------------EE-E---[]----E-----------------------E--[]-----------X---------------E---XXXXXXXXX----E---XXXXX--XXXX----XX[]X-EE--------E-E-X-E----------E-------XXXXXXXXXX--------XX-------------[]-E---[]----X----------XXXX--XX-XX-------X---------XXXXXXXXX-------XXX---------------------EE-E----E--------------------E--E--
XXXXXXXXXXXXXXXXXXXXXXXXXXX-XX-X-------XXXXXXXXXXXXXXXXX----------------------------XXXXXXXXXXXXXXXXXXXX-XXXXXXXXXXX-------XX-X-XX-XXXXXXXXX--XXXXXXXXXXXXXXXXXXXXXXXXXXXXXXX---XXXXXX---XXXXXXXXXXXXXXXXXXXXXXXXXXXXXXXXXXXXXXXXXXXXXXXXXXXX--XXXXXXXXXXXXXXXXXXXXXXXXXXXXXXXXXXXXXXXXXXXXXXXXXXXXXXXX-XXXXXXXXXXXXXXXXXXXXXXXXXXXXXXXXXXXXXXXXXXXXXXXXXXXXXXXXXX---XXXXXXXXXXXXXXXXXXXX--XXXXXXXXXXXXXXXXXXXXXXXXXXXXXXXXXXXXXXXXXXXXXXXXXXXXXXXXXXXXXXXXXXXXXXXXXXXXXXXXXXXXXXXXXXXXXXXXXX--XXXXXXXXXXXXXXXXXXXXXXXXXXXXXXXXXXXX--XX--XXXXXXXXXXXXXXXXXXXXXXXXXXXXXXXXXXXXXXXXXXXXXXXXXXXXXXXXXXXXXXXXXXXXXXXXXXXXXXXXXXXXXXXXXXXXXXXXXXXXXXXXXXXXXXXXXXXX-XXXXXXXXXXXXXXXXXXXXXXXXXXXXXXXXXXXXXXXXXXXXXXXXXXXXXXXXXXXXXX----------------------------XXXXXXXXXXXXXXXXXXXXXXXXXXXXXXXXXXXXXXXXXXXXXXXXXXXXXXXXXX---XXXXXXXXXXXXXXXXXXXXXXX-XXXXXXXXXXXXXXXXXXXXXXXXXX-XXXXXXXXXXXXX--XXXXXXXXXXXXXX---XXXXXXXXXXX-XXXXXXXXXXXXXXXXXXXXXXX-XXXXXXXXXXXXXXXX----------------------------XXXXXXXXXXXXXXXXX-XXXXXXXXXX-XX---XXXXXXXXXXXXXXXXXXXXXXXXXXXXXXXXXXXXXXXXXXXXXX----XXXXXXXXXXXXXXX-XXXXXXXXXXXXXXXXXXXXXXXXXXXXXXXXXXXXXXXXXXXXXXXXXXXX-XXXXXXXXXXXXXXXXXXXXXXXXXXXXXXXXXXXXXXXXXXX--XXXXXXXXXXXXXXXXXXXXXX---X---------------------------XXXXXXXXXXXXXXXXXXXXXXXXXXXXXXXXXXXXXXXXXXXXXXXXXXXXXX---XXXXXX--XXXXXX-XXXXXXXXXXXXX--XXXXXXXXXXX--XXXXXXXXXXXXXXXXXXXXXXXXXXXXXXXXXXXXXXXXXXXXXXXXXXXXXXXXXXXXXXXXXXXXXXXXXXXXXXXXXXXXXXX--XX--XXXXXXXXXXXXXXXXo--XXXXXXXXXXXXXXXXXXXXXXXXXXXXXXXXoX--XXXXXXXXXXXXXXXXXXX---XXXXXXXXXXXXXXXXXXXXXXXXXXXXXXXXXXXXXXX