------------------------------------------------------------------------------------------------------------------------------------------------------------------------------------------------------------------------------------------------------------------------------------------------------------------------------------------------------------------------------------------------------------------------------------------------------------------------------------------------------------------------------------------------------------------------------------------------------------------------------------------------------------------------------------------------------------------------------------------------------------------------------------------------------------------------------------------------------------------------------------------------------------------------------------------------------------------------------------------------------------------------------------------------------------------------------------------------------------------------------------------------------------------------------------------------------------------------------------------------------------------------------------------------------------------------------------------------------------------------------------------------------------------------------------------------------------------------------------------------------------------------------------------------------------------------
------------------------------------------------------------------------------------------------------------------------------------------------------------------------------------------------------------------------------------------------------------------------------------------------------------------------------------------------------------------------------------------------------------------------------------------------------------------------------------------------------------------------------------------------------------------------------------------------------------------------------------------------------------------------------------------------------------------------------------------------------------------------------------------------------------------------------------------------------------------------------------------------------------------------------------------------------------------------------------------------------------------------------------------------------------------------------------------------------------------------------------------------------------------------------------------------------------------------------------------------------------------------------------------------------------------------------------------------------------------------------------------------------------------------------------------------------------------------------------------------------------------------------------------------------------------------
-----------------------------------------------------------------------------------------------------------------------------------------------------------------------------------------------------------------------------------------------------------------------------------------------------------------------------------------------S---------------------------------------------------------SSS------S--S----------------------------------------------------------------------------------------------------------------------------------------------------------------------------------------------------------------------------------------------------------------------------------------------------------------------------------------------------------------------------------------------------------------------SSSSSSSSSS-----SSSSSSSSSSSSS-----------------------------------------------------------------------------------------------------------------------------------------------------------------------------------------------------------------------------------------------------------S---------------------------------------------------------------------------------------------------------------------------------------------------------------------------------------------------------SSSS---------------------------------------------------------------------------o------------------oo-----------------------------------SSSSSSSSSSSSSSSSSSSSSSSSSSSS-----SSSSSSSSSSSSSSSS-----------------------------------
-------------------------------------------------------------------------------------------------------------------------------------------------------------------------------------------------------------------------------------------------------------------------------------------------------------------------o---------------------------------------------------------------------------------S--------------?----o--oS------------------------------------------------------------------------------------------------------------------------------------------------------------------------------------------------------------------------------------------------------------------------------------------------------------------------------------------------------------------------------------------------------------------------SSSSSSSSSSSS----------------------------------------------------------------------------------------------------------------------------------------------------------------------------------------------------------------------------------------------------------SS-----------------------------------------------------------o-----------------------------o---------------------------------------------------------------?------------------------------------------X-----------------------------------------------------------------------------------------------------XXXX----------------------------------------------------------------------------------------------------------------------
---------------------oooo----------------------------------------------oo-----------------------------------------------------------------------------------------------------------------------------------------------------------------------------------------------------------------------------------------------E---------------------------E-----------------------------------------E-----------SS-----------------------S---------------------------------------------------------------------------------------------------------------------------oo--oo-------------E------------------------------------------------------------------------------------------------------------------------------------------------------------------------------------------------------------------------------------------------------------------------ESSSSSSSSSSSS---------------------------------------E--------------------------------------------------------------------------------------------------------------------oo--------------------------------------------------------------------------------------------S----------------------------------------oo--o---------XXX------------------------------------------------------------------------------oooo----------------------------------------------------------X-----?-------------------------------------------------------------------------------------oo--oo----------------------------------------------------------------------------?----------------XX-------------------------------
---------------------XXXXX----------------------S-------SS------------oo----?------------------SSS--SSS----------------------------XX-------------S----SSS--SSS---SS-------------------SSSSSSS----SS---?----------------SSSS--------------------------------SS----------SSSSSSSSSS---SSQSS-?----------------SSS--------SSS-------SSSSSSS---S------SSQS-----------------------QQ?-------------SQSSSSS-----S---------------S---SSS---S-----------------S---------------------------------------------------------------------------SSSS---------------SS-------------------o--------E--------------------------------------------------------------------------------------------------------------------------------------?--SS----oo----XXoo----o--------------------------------S----------------------------E-------------------------SSSSS-SQ---------SSSSSSSSSSSSSSS--------------------------------------SQS--SSS-----------X------------E-----oo----------------------------------------S------------------S--------------XXX------SS--------------------------------------------------------------------------------S----SS-------------------------XXX--SSSSS----XX-----------------SSSS-------------SSSS----------SSS------SSSSSSSSSSSSSSSS----------------------XXXX---------------------------XX--SSS-Q------SSS--SSSSSSS----S-SSSS??----------Q--------QQQ------------------SSS---------------------------------oo-------------------------------------------------------QQQ-----------------------------S?SS-----------------------------------------------
----------------------------------oooo----------------------------------------XXXX-------------------------------------------------XX-------------------------------------------------------------------------------------------------oooo----------------E---------------------------------------------------------------------------------------------------------------------------------------------ES-------------------SS----------------------------------------oo---------------------------oo------------------------------------------------------------------------------X--XX---------------------------------------------------------------------------------oooo--oooo----------------------------------------XXX-------------------XXXXX---E---------------------ES---------------------------<>------------------------------------------------------------------------------oooo---------------------------------------------------------------------------------------------------------------ES----------------------------XX-------------ooooo------------E-------------------------------oooo--------------SS-----------------------------------------------------------------------------------------------------------------------------------------------------------E----------------------------------------------------------E---------------------------------------------<>-------------------------------------oo---------------------------------------------------------------------------------------------------------------o---------
-------------------------------------------------------------------------------------------------------E-------------------------XoXX--------------------------------------------------------------------------------------------------------------------<>------------------------------------------------------------S-------------------------------------------E--------S---------------------S------S-------------------SS--------------------------------------------------X-----------------------------------------------------------------------------------------------------------------------------------------------------------------------------------------------------------------------------------------------------------------------------------------------S-Q-------------------------[]---------------------------------------------------------------------------------------------------------------------------XX---------------------------------------------------------------------S--------------------------------------------------------------------------------------------------------SSS---SS--------------------------------------------------------------------------------------------------------------------------------------------------------XXXXXX-XX-XX------------------------------------------------------------------------------------------------[]----Q--o-------------------------------E------------------------------------------------------------------------------------------------------------------------
--------------------------------E------------------oo-------------------------------S--------E--S-----<>--------oo---oo--------XXXSXX----------------------------------X--------------------------------------------------------------------E------------[]------------------------E-----------------o-------------X----------------------------------------------<>--------S----------------------------S-------------------SS--E-------------------------------S---------------------oo------------------------E-------------------------------------------------------------------------------------------------S---------------------------------------------------------------------------------------------------------------XXX-------------------S----------------------SS---------------oo-------E--[]---------------E------------------------------------E?---SSS----------------E-----------E----------------------------------XX---------------------------E----------------------------------------SS----------------------------------------E------------------S--------------------------------------------------SS----------------------------XX------------------XXXXXX-----------------------------------------------------------------E--------E------------X-------------------------------------------------E----------------E---------------------------------------------------XXX-------------------XXX------------E--<>--------------oo---------------oo---------------------------------------------------------------------------------------
--------XXXX-------------------<>---------------------------------XXXX---X-------------E----<>-----E--[]-----E----------------EXXX-X--------o----------XX--X----------XX-----------E--ESQQ?SSSQS----oooo-------XX-XX-----------------------<>------------[]X--XX---------S-----SSSSSSSS-SS--------E---------------XX----?S-------SSSSSSSSSSSSS----ESSS--Q---------[]--------SSS-------EX--X------------X--SS-SS--ES----ESS--------SS--------------------E----------------------XXX------------------------------<>---------------QQQQ-------------------------XXXXX---------XX------------------S---------XXSS----------------------XXX----------------S-----------S--------------------------XS---------------S------E--ES-------------XXXXXXXX----X--------------------X--X---SSSS---------------------<>--[]-----------E--<>-----------XX-------XXXX-ES---SSSSSSSSS--------S?S---S-----<>----------<>----QQQQQ--QQQ-----------XX----------XXX-XXXXXXXX--o----------<>-----------SSS--------S-------------X---SSS---------------XXXXX-------------E----<>---------------------------------------------o---E-------------E-----SSSS--------------E----------XXX---------XXXXXX----------------------Q--Q--Q--Q--------------S----<>-------SSSSSSS------<>-------<>-----------XXX----------------------X------?SQS-----XX------SSSSS----SSSSSSSSSSSS------Q-------QQQQQQQ----------E--S----------------------SS--------X------------------<>--[]-------------------------------------SSS----X-----------------------SS--------------------------------------------------
------------------------XXXX---[]------E-------------EX-------------------------------<>----[]----<>--[]----<>-------------EXXXXXX-X------------------XXX--XX--------XXX----------<>--------------------------XXX-XX-----------------------[]------------[]X--XXX-------------X------------------<>--------------XXX----------------------------------------------[]-----------------XXX--XX---E-------X--------<>----<>-----E--E--S-------------------<>------X-----------E----XX-------EEX--------------------[]--XXX----------------------------------------------------------------------------------XXXX---E------------------XXXX---------------------------SS----------------------E---XX---------------------<>-<>-----------------------------------------------X--XX-----S---------------------[]--[]----------<>--[]-----------XX----XX---XXX-------------------------------E--[]-----E----[]---------------------E-------o--------------------------------[]----ES------------------------------X--------------------X----E------------<><>--[]--------------------------------E---------------<>------E-----<>-------SS-------------<>--------EXXXX------------------------------------------------------------------[]X---X---------------[]-------[]----------XXX-----------------------X-------------XXXX--XX--E-------XSSSSSSSSSS--------------------------------<>-----------------------------------X------------------[]--<>--------E----------E------------------------E--XXX-?---------X-------------------XXX------------------------------------
-------------XX--XX----XXX-----[]-----<>------------XXX-------------------------------[]----[]----[]--[]----[]------------<>XXXXXX-X-----------------XXXX--XXXX-----XXXX----------[]-------------------------XXXX-XXX-------o-Eo-----------[]------<>-X-X[]X--XXX-------------X------------------[]-------------XXXX----------------------------------------------[]----------------XXXX--XXX----------X--------[]----[]-----------S-------------------[]------X----------<>-XXXXX--------XX--------------------[]--XXX--------------E------------------------------------------------------------------XXXXX--<>-----------------XXXXX----------------------------S--------------------------XX-----------------<>--[]-[]------XXXX-------------------------------------X--XXX---SS---------------------[]--[]----------[]--[]----------XXX---XXXXX-XXXX-----------------------------<>--[]----<>----[]--------------------<>------XXXXX-----------------------------[]---<>-------------------------------X-------------------X-----XXXXX-o-oo---[][]--[]-------------------------------<>---------------[]-----<>-----[]-------SS-------------[]-------XXXXXX----------------oo-----------------------------------------------X[]X--XXX--------------[]-------[]---------XXXX-----------------------XXX----------XXXXXX-XX------Eo--XSSSSSSSSSS-E------------------------------[]-----------------------------------X------------------[]--[]--------------------------------------------X----------------X--------------E-------------------------------------------
----------------------------E--[]---E-[]-----------X-XXX-------ooo--------------------[]----[]-E--[]--[]----[]------------[]XXXXXX-X-----------E----XXXXX--XXXX----XXXXX---EE-E---[]-E-----E--------E-------XXXXXXXXX--SSS-----------------[]------[]-XXX[]X--XXX-------EE----X---------E--------[]E-----------XXXXX----------------------E------E----------------[]--------E------XXXXX--XXXX---------X-EE-----[]----[]-E-------------------E--E--E---[]------X--------E-[]--XX-X-------XXX----oo--------E-E---[]--X-X-------------------------E-XX-------ooo----------------------------E------------XXXXXX--[]----------------XXXXXX----EE-E-EE-E---------------S----EE--------------------XX------E-E-----EE-[]--[]-[]--------------------------------E-----E----EE--X--XXXX-E------EE-E-------------[]--[]----EE-E--[]--[]------E--XXXX--XXXXXX-XXXE-----------------------------[]--[]----[]-E--[]-----E------------E-[]----------------------------XX---EE-E---[]---[]--------------E----EE-E-E---X--X----E----------XXXXXXX-----------XXE--[][]--[]-E-EE-E----------------E--E----[]-E---------XE--[]---E-[]--E--[]------E-----EE-E------[]------XXXXXXX--XX---ooo------X---------------------------E--------------EE-E-XX[]X--XXX--------------[]-------[]--------XXXXX-------------------E---XXXX-E-E----XXXXXX--XXS--------XXSSSSSSSSSSSSS--------------------------E--[]------------EE--------E-----E--EE--X--X---------------[]--[]----------------------E-------------E-------X----------------X-------------------------E-EE-E---------------------------
-XXX------------------------XXXXXXXXXXXXXXXXXXXXXXXXXXXX-------XXX------------------XXXXXXXXXXXXXXXXXXXXXXXXXXXXXXXXX---XXXXXXXXXXXXXXXXXXXXXXXXXXXXXXXXX--XXXXXXXXXXXXXXXXXXXXXXXXXXXXXXXXXXXXXXXXXXXXXXXXXXXXXXXXXXXXX-XX-XXXXXXXXXX--XXXXXXXXXXXXXXXX-XXXXXXXXXXXXXXXXXXXXXXXXXXXXXXXXXXXXXXXXXXXXXXXXXXXXXXXXXXX--XXXXXXXXXXXXXXXXXXXXXXXXXXXXXXXXXXXXXXXXXXXXXXXXXXXXXXXXXXXXXXXXXXXXXXXXXXXXXX---XXXXXXXXXXXXXXXXXXXXXXXXXXXXXX---XXXXXXXXXXXXXXXXXXXXXXXX----XX--XXXXXXXXXXXXXXXXXXXXXXXXXXXXXXXXXXXXXX--XX--XXXXXXX-XXXXXXXX-X---XXXXXXXXXXX-------XXX------------------X--XXXXXXXXXXXXXXXXXXXXXXXXXXXXXXXXXXXXX---XXXXXXXXXXX--X-XXXXXXXXXXXXXXXXXXXXXXXXXX-XXXXXXXXXXXX-XXXXXXXXXXXXXXXXXXXXXXXXXXXXXXXXXXXXXXXXXX--------------------------XXXXXXXXXXXXX-XXXX-XXXXXXXXXXXXXXXXXXXXXXXXXXXXXXXXXXX-XXXXXXXXXXXXXXXXXXXXXXXXXXXXXXXXXXXX-XXXXXXXXXXXXXXXXXXXXXXXXXXXXXXXXXXXXXXXXXX--XXXXXXXXXXXXXXXXXXXXQ-XXXXXXXXXXXX----------------------------XXXXXXXXXXXXXXXXXXXXXXXXXXX-XXXXXXXXXXXXXXXX-XXXXXXXXXXXXXXXXXXXXXXX------------E---XXXXXXXXXXXXXXXXXXXXXX-XXXXXXXXXXXXXXXXXXXXXXXXXXXXXXXXXXXXXXXXXXXXXXXXXXXXXXXXXXXXXXXXXXXXXXXXXXXXXXXXXXXXXXXXX-------XXX------------------XXXXXXXXXXXXXXXXXXXXXXXXXXXXXXXXXXXXXXXXX-XXXXXXXXXXXX--XXXXXXXXXXXXXXXXXXXXXXXXXXXXXX-X-------XXXXXXXXXXX-XXXXXXXXXXXXXXXXXo-EXXXXXXXXXXXXXXXXXXXXXXXXXXXXXXXXXXXXXXXXXXXXXXXXXXXXXXXXXXXXXXXXXXXXXXXXXXXXXXXXXXXXXXXXXXX-XXXXXXXXXXXXXXXXXXXXXX-XX--------XXXXXX--XXXX--XXXXXXXXXXXXXXXXXXXXXXXX-----XXXXXXXXXXXXXXXX-----XXXXXXXXX--XXXXXXXXXXXXXXXXXXXXXXXXXXXXXXXX-XSX-