------------------------------------------------------------------------------------------------------------------------------------------------------------------------------------------------------------------------------------------------------------------------------------------------------------------------------------------------------------------------------------------------------------------------------------------------------------------------------------------------------------------------------------------------------------------------------------------------------------------------------------------------------------------------------------------------------------------------------------------------------------------------------------------------------------------------------------------------------------------------------------------------------------------------------------------------------------------------------------------------------------------------------------------------------------------------------------------------------------------------------------------------------------------------------------------------------------------------------------------------------------------------------------------------------------------------------------------------------------------------------------------------------------------------------------------------------------------------------------------------------------------------------------------------------------------------
------------------------------------------------------------------------------------------------------------------------------------------------------------------------------------------------------------------------------------------------------------------------------------------------------------------------------------------------------------------------------------------------------------------------------------------------------------------------------------------------------------------------------------------------------------------------------------------------------------------------------------------------------------------------------------------------------------------------------------------------------------------------------------------------------------------------------------------------------------------------------------------------------------------------------------------------------------------------------------------------------------------------------------------------------------------------------------------------------------------------------------------------------------------------------------------------------------------------------------------------------------------------------------------------------------------------------------------------------------------------------------------------------------------------------------------------------------------------------------------------------------------------------------------------------------------------
--------------------------------------------------------------------------------------------------------------------------------------------SSSSSSSSSSSSSSSSSSSSSSSSSSSS------------------------------------------------------------------------------------------------------------------------------------------------------------------------------------------------------------------------------------------------------------SSSSSSSSS---S------SSSSSSSS-------------------------------------------------------------------------------------------------------------------------------------------------oo----------------------------------------------------------------------------------------------------------SSSSSSSSSSSSSSSSSSSSS---------------------------------------------------------------S---SSSSSSS--SSSSSSSSSSSSSSS--------------------------------------------------------------------------------------------------------------------------------------------------------------------------------------------------------------------------------------------------------------------------------------------------------------------SSSSSSSSSSSSSSSSSSSSSSSSSSSS----------------------------------------------------------------------------------------------------------------------------------------------------------------------------------------------------SSSSSSSSSSSSSSSSSSSSSSSSSSSS----------------------------SSSSSSSSSSSSSSSSSSSSSSSSSSSS------------------------------------------------------------------------------------
-------------------------------------------------------------------------------------------------------------------------------------------------SS------SSSSSSSSSSSSSSS-----------------------------------------------------------------------------------------------------------------------------------------------------------------------------------------o------------------------------------------------------------------------------S-----------------------------------------------o-------------------------SS-----------------------------------------------------------------------------------XXXX------------------------------------------------------------------------------------------------------------------------------------------------------------------------------------------------------------SSSSSSSSSSSSS----------------------------------------------------------------------------------------------------------------------------------------------------------------------------------------------------------------------------------------------------------------------------------------------------------------------------------------------S-----------------------------------------------------------------------------------------------------------------------------------------------------------------------oS--------------------------------S-----------------------------------------------------------------------------oS------------------------------------------------------------------------------------
--------------------------------------------------------X------------------------------------------------------------------------------------------------SSSSSSSSSSSSSSS------------------------------------------------------o------------------------------------------E---------------------------------------------------------------------------------------------------------------------------------------------------------------------S--------------------------------------------------------------------------SS-------------------------------------------------------------------------------------------------------------E------------------------------------------------------------------------------------------------------------------------------------------E------------------------------------------SSSSSSSSSSSSS--------------------------------------------------------------------------------------------------------------------------------------------------------------------------------------------------------------------------------------------------------------------------------------------------------------------------------------------------------------------------------------------------------oo------------------------XX----------------------------------------------------------------------------------ES--------------------------------S---E---------------------------------------------------------------------------------------------------------------------------------------------------------------
-----------------------------------------------------------SSSQS----------------------------------------------SQ-------------------------------QS------------S-SSSSSSSSS-------------------------------------SSS-----------------------------------SS---SSS-------S----SSSS-SSSSSSS-----SSS-----E--S-------------------------?SSSS------------------------------SSS--------------------SS---SSSSSS----------------------------------S---SS---SS----------Q-QQ---------------------------------SSS-------------------------S---SS??--------------SS---SSS-------SSSS-SSSS-------S--------------------------------------------------------SS---SSS----------Q-?-----------------------SS------------------------------------------------------------------------------------E---------S---SQS----------------SSSSS---SSQS------SSSSSSSSSSSSSSSSSSS-------E--oo-----?---------?------------XXX------------------------SSSSSSSSS---S---?-----------------------------------SSS------------------------------------------S-------?SSS-----E----------------S--------------------S----oo--XXXX----------------SS------------oo----?---------------------------------X--------------oooooo-----S-o-----------------------------------------------X?SSS-----XXX---o---------------------SSS------SSS-------------------S--------------XXX--------------------------SS----S---S-----------------------------S------------------------SSSSS-------XXoo-----o-----------------------o--------SS--S---S------------------------?---------------?SSS---------------?SSS--------------
-----------------------------------------------ooo--------------------------------------------------------------------------------------------------------------------SS-------o--------------------------------------------------------------------S------------------------------------------<>------------------Q-------------------------------------------------------X-----------------------------------------------------------------SS----------------------------------------------------------------XX---------S---SS----------------SS------------------------------------------------------------------------------------------------<>--------------------------------------------------------------------------------------------------------------------------------------------------------------------------------------------------<>------------XXXX---------------XXXS-----------------------------------------------------------------------------------------------------------------------------------------<>------------------------------------------X---------------------------------------------XXXX-----------------------------------------------------------------------------------------------------------------------------------------XXX---------------------------XXX-----------------XXXX--------------------------SS----------------------------------X---S-----S-----------------------------------------------------------?-------------X------------------------------------------------------------------------------------
------------------------------------------------------------------------------------------------E-----------E---------------------------------------------------------S----------------------------------------------------o-----------------------SS------------------------------------------[]---------------E---------------------------------------------------------XX------------------o----------------------------------------------SS----------------------------------------------------------------SX---------S---SS----------------[]------------------------------------------------------------------------------------------------[]------------------------------------------------------------------------------------------------------------------------------E--------------------------------S----------------------------------[]------------ooo---------------XXXXX----------------------------------------------------------------X------------------------------------------------------------------------[]------------------------o-------X------------------o-----------------------------------------------------------------------------------SSSSSS------------------------------------------------------------------------------------------------------------------------------------------XXXX--------------------------SS---------------------E-----------XX--SS-------------------------------------------------oo---------------SSSSS--------X--------------------------------E---------------------------------------------------
---------------------------------------------------E----------------------------------E-----------------E--<>------------------------------------------------oooooooooSS---------------------------------------------------------------------o-----SS---QE?----------------------------X-------[]-------E------<>------E------------------E------------------o-----------XXX-----------------------------o----o------------------------------SS---------------------------------------------SSSSSS-------------------SSS?oooooSS----------------[]--------------------------------------oo---------------------------------E--<>-SQ-----------------------------E----------------------------E----------------------------------E---------oo--------------------------E-----------E-E-----------------------S-S-----E---------------------------------[]-----------------------------XXXXX-----------------------------------------------------E----------XXS---SSS------------------------------------E--SSSS?--------E------------[]--------------------------------X------------------------------------------------------------------------------------------------------SSSSSS----E-----------------------------o------------------------------------XXX------------XXX--------------------------------X---oo----------XXXXX--------------------------SS-----------------E--<>----------XXX---So??-------------------------------------------------------------SSSS--?-------XX---------------------------------------------------------S--Q-----------------------
-----------------------------------o-----E-Q---E--<>------------E--S--------E------Q-<>----------------<>--[]---------------------------------SSSS------E--SSSSSSSSSSSSS--------------------E----------------S?S----------------Q-------------------S---SSS---QQ--S-------------------XX------SXXS-----<>------[]-----<>---QQSSQS--------<>---------------E-----S-------XXXX-----------Q----SS--------E-------------------------------SSS----S---E--?QQ---QQ-----------o-------------------------------SS----XX-XX--------SSSSSSS-S------S------[]-S-----------------S---oX------------------------------------------E----<>--[]--------SX---SS--S?SS--S-------<>-------------------S-------<>-----------QQQQ---------S--------<>------E--------------------Q--------<>-----E----<>-XS--S?S---E-------X--------------S-----E-----------SSSS?----------XXX---XXX--S------oo-o--------XXXXXX--------------------------SS--------XX--------------<>---------XXX---------------------------------EE-------<>----------S---<>------S-----[]----E-----------SS----S--------XXX-ES--------XX--S-------------------E------XXXX--XX---------------XX--------------------------------------S----SSSS-----------------------------E----------------------------X-----------XXXX---------------------S?S-----------------ooo--o--------XXXXXX---------------------------------SX-S----E--<>--[]---------XXXX---SSS---------SS----Q----------------------XXXX--SSS--------------------S------XXXX------SQS-------------------oooQ---------------------------------------E-----------X
----------------------X------------E----<>----<>--[]-----S-----------------<>--------[]--------<>------[]--[]----------------------------XX---E----------------------------<>------E------E<>---------------------------E------X-----------E----------EE-----------------------------XXX--E------------[]------[]-----[]-----------------[]--------------<>------------XXXXX---E---------------------<>------------------------------------E----<>--------------------------------------------------------E--XX-XX------------------------------[]-S----------XX-------E--E-----------------------------------------<>----[]--<>--------SS------E--------------[]--X------------------------[]------------------------------E--[]-----<>-----------------------------[]----<>----[]----------<>------X------------E-------<>------------------------------------------------------XXXXXXXX------------------<>----------------EX--------------[]--------XXXX---E------------------E-------------------[]--------------[]--E---------[]---<>-------------------------XXXX<>-------------------X-----------------------------------------------------------X---------------XX--------E--E----------------------------X-----------------XX-------------------------------------------------------------------E---------------XXXXXXX----------------------X---------EXX-----<>--[]--XX--------XXXXX-----------------------------------E-----------------------------X------------EXXXXX--------------E-----XX--------------------X---------------------------<>----------XX
----------------------X-----------<>----[]----[]--[]-----------------------[]--------[]--------[]------[]--[]--Q---------------------<>-XXX--------------------------------[]-----<>-----<>[]--------------------------<>------X----------<>-------------------------------X--------XXXX-<>------------[]------[]-----[]-----------------[]--------------[]-----------XXXXXX-------------------------[]-----------------------------------<>----[]------------------------------------------------------E----XX-XXX-----------------------------[]-S---------XXX---X------------------------------------------------[]----[]--[]--------SS-------------X-------[]--X------------------------[]-----------------------------<>--[]-----[]-----------------------------[]----[]----[]----------[]------X--------------------[]-------------------------------------------X---------XXXXXXXXX---------o--------[]-----X-----------X--------------[]----<>-XXXXX---------------------<>-------------------[]--------------[]-<>---------[]---[]-------------------------XXXX[]--XXXXX------------XX----------------------------------------------------------X--------------XXX----------------------------------------X----------------XXX------------XXXXXo------------------------------------------------<>----------XX--XXXXXXXX----------------------X---------XXX-----[]--[]-----------XXXXXX----------------------------------<>-----------------------------X------------XXXXXX-----------------X--XXX------------------XX--------E---E--------------[]---------XXX
--------E-----E-------X-----------[]-E--[]----[]--[]--------------E--------[]--------[]--------[]-E----[]--[]------------------------[]-XXX--------------------------------[]-E-E-[]-----[][]--------------------------[]-----XX----------[]-E-----------------------------X-------XXXXX-[]------------[]------[]-----[]-E--E-----E--E---[]--------E-EE--[]----------XXXXXXX--------EE--E------------[]-----------------------------------[]--E-[]-------------------------------------------------------E---X-?XXXX------EE-------E------------[]----------XXXX-E-X----------------------------E-E-EE--X----EEEE---[]----[]--[]--------S--------------X---E-E-[]--X---E-----E-E-EE------E--[]-----------------------EE-E--[]--[]-----[]-------EE-E---------E--------[]----[]----[]-E--E-----[]------X------E-E-----------[]------------E----------ooo-----------------X--------XXXXXXXXXX--------XX---EE-E-[]-E-E-X-----------X-----------E--[]----[]XXXXXX-----------E---------[]------EE-------E---[]--------------[]-[]---------[]---[]-------------E---------XXXXXX[]--------------------X---SSSS---------ooo---------------------------------------X--EE-E-------XXX--E--------------------------------------X---------------XXXX----------------XX------------------------------------------------[]---------XXXXXXXXXXXXX------X--E-----EE-E---X---------XXXE-E--[]--[]-E--------XXXXXXX-------------------EE-------------[]-----ooo------------E--------X-----------XXXXXXX-EE----------E---X--XXXX----------------XXX------------X---E-----E-E--[]-------XXXXX
-XXXXXXXXXXXXXXXXXXXXXXXXXXXXXXXXXXXXXXXXXXXXXXXXXXXXXXX-XXXXXXXXXXXXXXXXXXXXXXXXXXXXXXXXXXXXXXXXXXXXX-XX--XX--XXXXXXX-XXXXXXX---XXXXXXXXX--XXXXXXXXXXXXXXXXXXXXXXXXXXXXXXXXXXXXXXXXXXXXXXXXXXXXXXXX--XXXXXXXXXX-----XXXXXXXXXXXXXXXXXXXXXXXXXXXXXXXXXXXXXXXXXXXXXXXXXXXX--XXXXXXXXXXXXX-XXXXXXXXXXXXXXXXXXXXXXXXXX-XXXXXXXXXXXXXXXXXXXXXXXXXXXXXXXXXXXXXXXXXXXXXXXXXXXXXXXXX---XXXXXXXXXXXXXXXXXXXXXXXXXXXXXX---XXXXX------------X-XXXXXXXXXXXXXXXXXXX--XXX-------XXXXXXXXXXXXXX--XXXXXXXXXXXXXXXXXXXXXXXXXXX--XXXXXXXXXXXXXXXXXXXXXXXXXXXXXXXXXXXXX-XXXXXXXXXXXXXXXXXXXXXXXXXXXXXXXXXX---XXXXXXXXXXXXXXXXXXXXXXXXXXXXXXXXXX-XXXXXXXXXXX--XXXXXXXXXXXXXXXXXXXXXXX-XXXXXXXXXXXXXXXXXXXXXXXXXXXXXXXXXXXXXXXXXXXX-XXXXXXXXXXXXXXXXXXXXXXXXXXXXXXXXXXXXXXXXXXXXXXXXXXXXXXXXXXXXXXXXXXXXXXXXXXXXXXXXXXXX-XXXXXXXXXXXXXXXXXXXXXXXXXXXXXXXXXXXXXXX-------XXX------------XXXXXXXXXXXXXXXXXXXXXXXXXXXXXXXXXXXXXXXXXXXXXXXXXXXXXXXXXXXXXXXXXXXXXXXXXXXXXXXXXXXXXXXXXXXXX-XXXX-XXXXXXXXXXXXXXXXXXXXXXXXXXXXXXXXXXXXXXXXXXXXXXXXXXXXXXXXXXXXXXXXXXXXXXXXXXXXXXXXXXXXXXXXXXXXXXXXXX-XXXX-----------XXXXXXXXXX----XX-XXXXXXXXXX------------------XXXX-----XXXXXX-XX---XXXXXXXXXXXXXXXXXXXXXXXXXXXXXXXXXXX-------X---XX-XXXXXXX--X-XXXXXXXX--XXXXXXX----XXXXXX--S---------------------------------XXXXXXX------XXXXXXXXXXXXXXXXXXXXXXXXXXXXXXXXXXXXXXXXXXXXXXXXXXXXXXXXXXXXXXXXXXXXXXXXXXX-XXXXXXXXXXXXXXXXXXX--XXXXXXXXXXXXXXXXXXXXXXXXXXXX-XXXXXXX---XXX-------XXXXXXXXXXXXXXXXXXXXXXXXXXXXXXXXXXXXXXXXXXXXXXXXXXX--XXXXXXXXXXXXXXXXXXXXXXX--XXXXXXXX--XXXXXXXXXXXXXXXXXXXXXXXXXXXXX