-----------------------------------------QX--S--------------------------------------------------------------------------------------------------------------------------------------------------------------------------------------------------------------------------------------------------------------------------------------------------------------------------------------------------------------------------------------------------------------------------------------------------------------------------------------------------------------------------------------------------------------------------------------------------------------------------------------------------------------------------------------------------------------------------------------------------------------------------------------------------------------------------------------------------------------------------------------------------------------------------------------------------------------------------------------------------------------------------------------------------------------------------------------------------------------------------------------------------------------------------------------------------------------------------------------------------------------------------------------------------------------------------------------------------------------------------------------------------------------------------------------------------------------------------------------------------------------------------
--------------------------------E-----X---XX------X---------------------------------------------------------------------------------------------------------------------------------------------------------------------------------------------------------------------------------------------------------------------------------------------------------------------------------------------------------------------------------------------------------------------------------------------------------------------------------------------------------------------------------------------------------------------------------------------------------------------------------------------------------------------------------------------------------------------------------------------------------------------------------------------------------------------------------------------------------------------------------------------------------------------------------------------------------------------------------------------------------------------------------------------------------------------------------------------------------------------------------------------------------------------------------------------------------------------------------------------------------------------------------------------------------------------------------------------------------------------------------------------------------------------------------------------------------------------------------------------------------------------
-------------------------------SSS----X--XXX-S----------oo------------------------------------------------------------------------------------------------------------------------------------------------------------------------------------------------------------------------------o---------------------------------------------ooo---------------------------------------------------------------------------------------------------------------------------------------------------------------------------------------------------------------oo---------------------------------------------------------------------------------------------------------------------------------------------------------oo------------------------------------------------------------------------------------------------------------------------------------------------------------------------------------o---------------------------------------------------------------------------------------------------------------------------------------------------------------------------------------------------------------------------------------------oo-----------------------------------------------------------------------------------------------------------------------------------------------------------------------------------------------------------------------------------------------------------------------oo--------------------------------------------------------------------------------------------------------------------------------------
-------o--E--E-----------------Q-----E---[]-------------------------------------------------------------------------------------------------------------------------------------------------------------------------------------------------------------------------------------------------------------------------------------------XXXX------------------------------------------------------------------------------------------------------------------------------------------------------------------------------------------------------------------E--EE-------------------------------------------------------------------------------------------------------------------------------------------------XXXX------------------------------------------------------------------------------------------------------------------------------------------------------------------------------o-----------E-------------------------------------------------------------------------------------------------------------------------------------------------------------------------------------------------------------------------------------XXXX--------------------------------------------------------------------------------------------------------------------------------------------------------------------------------------------------------------------------------------------------------------------------E--E--------------------------------------------------------------------------------------------------------------------------------
-----------XXXXX--------------------XXXX-[]-----XXX--------XXX------------------Eooo--------------------------------------------------------------------------------------------oo--o---------------------------o--oo----------------------------------------------------------------------------------------o-------------------------------------------------------------------------------------------------------------------E-------------------------------------------------------------------------------------------------------------------------XXXXXXX-----------------------------------------------------------------------------------------------------------------------------E---------?---------------ooQ--------------------------------------------------------------------------------------------------------------------------------------------------------------------------------XXXXXX---------------------------------------------------------------------------------------------------------------------------------------------------------------------------------------------------------------------------?----------------------------------------------------------------------------------------------------------------------------------------------------------------------------------------------------------------------------------------ooo------------------------------------------XXXXXXX------------------------------------E---oo-------------------------ooo--------------------------------------------------------
X-----------------------------------------------------S----------------SXoo-----XXXX--E--E-------Q---------XXX--------------SSSSSSSSSSSS-------------------SSSSSSSSS----o-----------------------------------------------------------------------SSSSSSSS-----------------------?SSS-----S-----oo---XXXoo----XXX-----?SSS---------E--E-----------o---------------------------SSSS--SS-------------SSS---------------------------SSSSS----SSS---?SSS--------------------E--------------------S----------------SSS--------S-----------------XXX-----------------------------------S---------------------SSS------------------E-----oo-----------------------------XX--------------QS----SS-------SS---------E?-E------------XX----?-----------------------S--------------------------------E----QQQQQQ-----------------------------SSS---SSSS--------S----SSS---------E-----------------------------------S------------------------SSSSS---?---SSS------------------------------------------------------------------------------------SSS----------Q?SSS------------------S-------?-------------------SS-------------------------------------S-S??-----------------------------E-----------------------E-------------XX----------------------SSSSS--SQ------------QQQQ---------------SS---S---SSSSSSSSS-?------SSSSS---?------------QQQQ---------------------o----QQ-Q-------------------XXXXS-------SQQS----------------SS--------------------------------E-----oo--XXX----oo---E--E-------------------oo---XX--------E---SSSQS-------------------------------------------
---E------------XXXXX-------o-----------------o-----------------------------------------XXXXX-------------XXXX-----------------------------------------------------------------------------ooo-------------------------oo---------------------------------------------------------------XXX------------------------------o---------XXX--------------------------------------SS---------------------------------------------------------------------------------------<>-----------------------------------------------E------------------XXX-------------------------oo--------------------------------------o------------------------------------------------XXX------------------------------------------XXXXXX--------------------------------------X----------------------------------------------------------------------------------------------------------<>-------------------------------------------------oo----------------------------------------------------------------------------------------------------------------ooo---------------------------------------------------------------------------------------------------------------------------------<>---------------------------------------------------------------------XX----------------------------------------------------------------------------------------------------------------------------ooo----------------------------------------------------------ooo--------XXX--XX-E---------------XXXX------------------------------------------------------------------------------------
XXXXXXXXX------------------------------------------------------------------------------------------------XXXXX---------------------------------------------------------------------------------------------------------------------------------------------------------------------------------------------------------------XX---------------------------------------------SS----------------------------------------E----------------------------------------------[]----------------------------------------------<>-----------------XXXX-------------------------------------------------------------------------XXX--------------o----------------------XXXX--------------------------------------------------------------------------------------S----------------------------XX------------------------E----------E----------------------------------------[]-------------------------------------------------------------------------------------------------------------------------------------------------------------------------------------------------------------------------------------------------------XXX---------------------------------------------[]---------------------------E--------------------------------------------------------------------------------------------------------------o-----------------------------------------------------------------------------------------------------------------------E---------------<>---------------------------------------------------------------------------X---------------------------
------------------------------------------------------------------------XXX------------------------------XXXXX----------------------------------------------------------XX---------------------SSS-------------------E-------E---------------------------------SoS---------S--------------------------------------------------------------------SSSSSSS---------------------SS---------------------------------------<>-------------S---------------------E----------[]---------------E----X-------------------------[]----------E-EEE-XXXXX---------S---------------------------S-S-----------------------------------------------------------o------------XXXXX---------------------------------------------------S--------S-----------------------------------------E------------XX------------------------E-S-------<>-------------SSSSS---------------------XXX--oo---------------------------------------------------E---------------o------------------------------------------------------------------E----------------------------------------------------------------------------------------X-------------------XX----------------------------------S-----------[]-----------E-------E------<>----------------------------XS---------------------------------------------------------------------------------o----------------ooo----E--o--------------------------E------------------------------------------------------------E-------------------[]----------XXX------------------------XXX-------S-------------------------------------------------------
--------ooo--------------------E-EE-E---------------------------XXXX--------XXXXXX-------------------SSX-XXXXX---ooo-------XX--X-----------X----------E----------------XS--E---------------------------E------------<>------<>------------------S---------XX------o------XXXX------------XX-------XXXX--XXXXX-XXXXX-----XXXX---oo--------XX------------------X--------S-----SS---SSS--------------o---------------E--[]-----E-----------SQQ-----S--S-----<>-----X--SS[]-S-----E--S---<>----S----------E-----S---oo---[]-----QQQ------X-XXXXX-----------------------E------XXXXXX---------------E----------------------------XXXX--XXXX---------------------XXXXXX----------QQQ--QQQQ------E----Q------SQS-----------------------E-----------------X--XXX-Q-Q----------<>------------XX------Q??SQSQ----------<>----E----[]-----ESSS------------Q--Q-------------XXXX-SS-------------------------------QQ---S?S-----E---E--<>------S?S----------XXXX------------------------S-----<>--ES----------------------<>------------------E-------Q----------SSS-----XX-XX-----------oooo-------XXXXXXX--------XX------------------XXX-----------SXSQS---S-----------------E--------XXX---------<>---E--<>------[]---------E----X------------XXX-XXX--SSSS------------E?QQQQ----------------Q---QQQ--Q--QQ--SS-----XX----SE-----------QXX--QQQ----------<>-----------XXSSSSS-S--------<>-------------------SSSS-----------------------Q-Q----------<>---E---------------XXX--XXXX---------------------XXXX-------------XXS-----QQ?SQQQ------------------------------------X------
----------------------------XXXXXXXXXXXX-----------XXX---------------------------------X---------------X-XXXXX------------XXX--XX---------XX---------<>---------------XX--<>---E----------------------<>------------[]------[]---------------------------XXX------------XXXXX--X------------------------------------------------EE---------------------------X-------------X-------------------------------------<>--[]----<>------X---------------------[]--E--X----[]------<>------[]---------------E--------------[]--------------XXXXXXX----------------------<>-----XXXXXXX--------------<>----------------------------------------------------------XXXXXXX-------------------------E--------------------E------o--------<>----------------XXX-XXX--------------[]---------XX-XX-----------------------[]---<>----[]-------------------------------------XXXXX-SX------------E------E-----------------------<>--<>--[]-------------------------------------------E------E--[]-<>--------------------E--[]-----------------<>-------------------------XXX-XX---------------------XXXXXXXX-------XXX----------E-------XXX---------------------E--X--XX-------<>--------------E-----[]---E--[]------[]-------E<>---------E------XXXX--X---------------------------------------------------------E-----XXX----------------------------X------[]--XXX-----------------------[]-----------------------------------------------------------[]--<>------------------------------------------------------------------------------------------------------------------------
XXXXXXX-----------------------------------------------------------------------------X--X---------------X-XXXXX-----------XXXX--XXX-------XXX---------[]----X---------XXX--[]--<>------<>--------------[]------------[]------[]--------------------------XXXX-----------XXXXXX--X--------------------------------------------XXXXXXX--------------------------XX-----------XX-------------------------------------[]--[]----[]------X---------------------[]-<>--X----[]------[]------[]---XX---------<>--------------[]-------------XX-XXXXX----------------------[]----XXXXXXXX--------------[]---------------------------------------------------------XXXXXXXX------------------------<>-------------------<>---------------[]---------------XXXX-XXX--------------[]------------XX-----------------------[]---[]----[]------------------------------------XXXXXX--SX----------<>-----<>-----------------------[]--[]--[]------------------------------------------<>-----<>-----[]-------------------<>--[]-----------------[]------------------------XXXX-XXX-------------------XXXXXXXXX------XXXX--------------E---XXX------------------------X--XX-------[]-------------<>-----[]------[]------[]------<>[]--------<>-----XXXXX---X-------Eo----------------------------------------------------XXXX----------------------------X------[]-XXXX-----------------------[]----------------------------X---X--------------------------[]--[]-------EXXX-----------------------------------------------------S-----------------------<>------------------------------
--------------------------------------------------------------ooo-------------------X--X----E-EE----E----XXXXX----------XXXXX--XXXX-----XXXX---EE-E--[]E---X--------XXXX--[]--[]------[]--------------[]--------EE--[]------[]-----EE-E--E-E-----------XXX-X----------XXXXXXX--X------XX-------oo------------------------------------------------------------X---X---EE--XXXE-E----------E-----------------EE-E--[]--[]----[]------X---------------------[]-[]-EX-E--[]-E----[]-E-E--[]--XXX-----EE--[]----E---------[]----------XX-X--XXXXX----E--X------E-EE----[]---XXXXXXXXX-----------E--[]---------------------------------------------------------XXXXXXXX--------E----------E-E--[]-------------------[]------------E--[]-E--E-E-------XXXX--XXX--------------[]------------XX---E-EE-------EE-------[]--X[]---E[]-----------------------------------XXXXXXX--SS--------E-[]-----[]---E-E-----------------[]--[]--[]-----------------------------------EE-E---[]---E-[]-----[]-----------------E-[]--[]-----------------[]--E-------------E------XXXX--XXXX----EE-----------XXXXXXXXXX-----XXXXX------------------XXX---EE-E-----------------X--XXXX-----[]--------E----[]-E---[]---X--[]------[]------[][]--------[]----XXXXXX--SS-------XX--------E-E-----EE-E--------------E------E---------XXXXX----------------------------X------[]XXXXX-----------------------[]------------------E---------X-E----------EE-------------E--[]--[]----------------------------------------------------------------S-----------------------[]-E-------EE-E-E---EE----------
----------------XXXX---XXXXX------------XXXX----XX----XX----XXXXX-------------------XXXXXXXXXXXXXXXXXXXXXXXXXXXX-XXXXXXXXXXXX--XXXXXXXXXXXXXX-XXXXXXXXXXXXXXXXXXXXXXXXXXXXXXXXXXXXXXXXXXXXXXXXXXXXXX--XXXXXXXXXXXXXXXXXXXXXXXXXXXXXXXXXXXXXXXXXXXXXXXXXXX--XXXXXXXXXXXXXXXXX---X-XXXXXXX-------XX-------------------XXXXX-----------------------XXXXXXXXXXXXXX---XXXXXXXXXXXXXXXXXXXXXXXXXXXXXXXXXXXXXXXXXXXXXXXXXX--XX--XXXXXXXXXXXXXXXXXXXXXXXXXXXXXXXXXXXXXXXXXXXXXXXXXXXXXXXXXXXXXX--XXXXXXXXXXXXXXXXXXXXXXXXXXXXXXXX---XXXXXXX-XXXXXXXXXXXXXXXXXXXXXXXXXXXXXXXXXXXXXXXXXXXXXXXXXXXXXXXXXXXXXXXXXXXXXXXX----------------------------XXXXXX---XXXX-XXXXXXXXXXXXXXXXXXXXXXXXXXXXXXXXXXXXXXXXXXXXXXXXX-----XXXXXX------S--XXXXXXXXXXXXXXXXXXXXXXXXXXXXXXXXXXXXXXXXXXXXXXXXXXXX-----XXXXXXXXXXXXXXXXXXXXXXXXXXXXXX[]XXXXXXXXXXXXXXXXXXXXX-XXXXXXXXXXXXXXX--XXXXXXXX--XXXXXXXXXXXXXXXXXXXXXXXXXXXXXXXXXXXXXXXXXXXXXXXX-XX--XXXXXXXXXXXXXXXXXXXXX------XXXXXXXXXXXXXXXXXXXXXXXXXXXXXXXXXXXXXXXXXXXXXXXXXXXXXXXXXXXXXXXXXXXXXXXXXXXXXXXXXXXXXXXXXXXXXXXXXXXXXXXX-oXXXXXXXXXXXXXXXXXXXXXXXXXXXXXXXXXXXXXXXXXXX-XX-XX-X-XXXXX--XXXXXXXXXXXXXXXXXXX-XXXXXXXXX-XXXXXXXXXXXXXXXXXXXXXXXXXXXXXXXXXXXXX--XXXXXXXXXXXXXXXXXXXXXXXX-XXXXXXXXXXXXXX---S---XXXXXXXXXXXXXXXXXXXXXXXXXXXXXXXXX-X-XXXXXXXXXXXXXXXXXXXXXXXXXXXXXXXXXXXXXXXXXXXXXX--XXXX---XXXXXXXXXXXXXX-------XXXXX--XXXXXXXXXXXXXXXX---XXXX-X--XXXXXXXXXXXXXXXXXXXXXXXXXXXXXXXXXXXXXXXXXXXXXX-XXXXXXXX-X-------------------------XX---X---XXXX--XXXXXX------------XXXXXXXXXXX---XXXXXXXXXXXXX---XXXXXXXXXXXXXXXXXXXXXXXX