--------------------------------------------------------------------------------------SSS-SSSXo--QXo-S------------------------------------------------------------------------------------------------------------------------------------------------------------------------------------------------------------------------------------------------------------------------------------------------------------------------------------------------------------------------------------------------------------------------------------------------------------------------------------------------------------------------------------------------------------------------------------------------------------------------------------------------------------------------------------------------------------------------------------------------------------------------------------------------------------------------------------------------------------------------------------------------------------------------------------------------------------------------------------------------------------------------------------------------------------------------------------------------------------------------------------------------------------------------------------------------------------------------------------------------------------------------------------------------------------------------------------------------------------------------------------------------------------------------------------------------------------------
--------------------------------------------------------------------------------------S-SXXoSXoX-X-XXX-S----------------------------------------------------------------------------------------------------------------------------------------------------------------------------------------------------------------------------------------------------------------------------------------------------------------------------------------------------------------------------------------------------------------------------------------------------------------------------------------------------------------------------------------------------------------------------------------------------------------------------------------------------------------------------------------------------------------------------------------------------------------------------------------------------------------------------------------------------------------------------------------------------------------------------------------------------------------------------------------------------------------------------------------------------------------------------------------------------------------------------------------------------------------------------------------------------------------------------------------------------------------------------------------------------------------------------------------------------------------------------------------------------------------------------------------------------------------
---------------------------------------------oooo-------SSSSSSSSSSSSSSSSSSSSSSSSSSSS--SoS---XXX--X---S-----------------------------------------------------------------------------------------------------------------------------------------------------------------------------------------------------------------------------------------------------------------------------------------------------------------------------------------------------------------------------------------------------------------------------------------------------------------------------------------------------------o-----------------------------------------------------------------------------------oo-------------------------------------------------------------------------------------------------------------------------------------------------------------------------------------------------------------------------------------------------------------------------------------------------------------------------------------------------------------------------------------------------------------------------------------------------------------------------------------------------------------------------------------------------------------------------------------------------------------------------------------------------------------------------------------------------------------------------------------------------------------------------------------------------------------------------------------SSSSSSSSSSSSSSSSSSSSSSSSSSSS
----------------------------------------------XXXX---------SSS------SSSSSSSSS--SSSSS-------XX-XX-XXX----------X-----------------------------------------------------------------------------------------------------------------------------------------------------------------------------------------------------------------------------------------------------------------o--------------------------------------?------------------------------------------------------------------------------------------------------------------------------------------------------------------------------------------------E------------------------------------------------------------------------------------------------------o----------------------o-------------------------------------------------------------------------------------------------------------------------------------------------------------------------------------------------------------------------------------------------------------------------------------------------------------------------------------------------------------------------------------------------------------------------------------------------------------------------------------------------------------------------------------------------?-----------------------------------------------------------------------------------------------------------------------------------------------------------------------------------------------------------------------------------SSSSSSSSSSSSSSSSSSSSSSSSSSSS
------------------------------------oo----------------------SS--E---SSSSSSSSS--SSSSS----------XX-XXX----X------X-------------------------------------------------------------------------------------------------------------------------------------------------------------------------------------------------------------------E-------------------------------------------------------------------------------------------------------------------------------------------------------------------------------------------------------------------------------------------------------------------------------XXXXXXX--------------------------------------------------oo--oo----------------------------------------------------------------------------------------------------------------------------------------------------------------------------------------------------------------------------------------------XX-------------------------------------------------------------------------------------------------------------------------------------------------------------------------------------------------------------------------------------------------------------------------------------------------E-------------------------------------------------------------------------------------E--------------XXX-------------------------------------------------------------------------------------------------------------------------------------------------------------------------------------------------SSSSSSSSSSSSSSSSSSSSSSSSSSSS
----------------------SSS-----------XXX-------------XXX----S------------S--SS---S-SS---XXX--------------------X?---------------Q-----------------------------------------------------------------------SS------------------SSSSS----------------------------------E--------SQS---------SSSSS-------SSSSSSSSSSSSS----------------SSSSSSSSSSSQQQ------------S-------------------SSS-------------------------------SSSS----------------------------------------------------------------------------SSQSSS--------------S--------------------------------------------------------------------------------------------------------------E--------------------------------o------------------------------------------------------S-S?S--SS--------------S-S------S---QQQ---------------------SS-------------S----SSS--------------------------------------E----------------------------------------------------------Q------------------------------------------------SSSS---------------------------------------?SSS---------------------------------?SSS-------SSS---SSSSS----------------------SSSS-------S----------------SSSSSSSS---------------SS--SSSS----------------------------------------------------------------------------QS--SQQQ-------------------------------------S-------?SSS-----E--?-------------S----SSS-SSS---------S---------------------------?--SSQQS-------------------------------------------SSSS------------------------------QQ---------------------------S------------------------------------------------------SSSSSSSSSSSSSSSSSSSSSSSSSSSS
-----------------------------------------------------------S---------------SS---S-SS-----------------XX-------------------------------------o-------------------o--------------------------------------------------------------E---------------------------------<>--------------------------------------------------------------------------------XXX------------------XX---------------------------------------------------------------------------------------------------------------------------------------------------------------------------------------------------------------------------------------------------oo---<>-------------------------------------------------SSS-------------------------------------S-----------------------------------------------------------------------------------------------------oo--------------<>--<>------------------------------------------------------------------------------------E-----------------------XXXX---------------------------------------------------------------------------------------------------------------------------------------------------------------------------------------------oooo----------------------------------------------------------------------------------------------------------------------<>-----------------------------------------------------------------Q----------------------------------------------------------------------------------------------------------------------------oooo--------------------------------------------------------------------
---------------------------------------------------------S-S---------------SS---S--------------XXX------------------------------------------XX-o-----------------------------------------------------------------------------------------------------------------[]--------------------------------------------------------------------------------------------------------------------------------------------------------------------------------------------------------------------------------------------------------------------------------X--------------------------------------------------------XXXXXX----------------[]-----------------------------------------------XX--------------o-------------------X-----SS--------------------------------------------------------------------------------------------------------------------[]--[]-------------------------------------------------------------------X---------------<>------------------E-------------------------------------------------------------------------------------------------------------------------------------------------------------------X--------------------------------------------------------------------------------------------------------------------------------------XXXXX-----------E----[]----------------------------------------E-------------------------------------------------------------------------------------------------X---------------------------------------------------------------------------------------------------------------------------
-S-SQ-----------------------XXX-------------------SSSSSS-E--E------------?oSS---So??--------------------------XX------------------------------------------------------------------------------E------------E---------------SSSSS-------------------------------SS[]------------------------------------------------------------------------E----SSSSSS-------------XXX-------------------X-S---X----------------------------------------------------------------------------E-------E---------E------------------------------o--------------------XX------------------------------------------------------------------------------XX--o----o------------------------X---oo---------XXSS-SQ-----------------------------XSS--oSS----S----------S---SS-------------------------E---------------------------------------------------------------------[]--[]-----------E-----------------------------------------------------XXX---------------[]----------E--o--------------------------------E-----------------------------------E-------------E------------------------------------------oo-----------------------------------------X-------------------------------E---------------o-ooo-------------------------------------------------------------------------------------------------------[]-oo------------------------------------<>---------------------E--o------------------SSSSSSSS---------------o---------oo------------------XXS------------------------------------------------E--------------------------------E----S----------??--------?--------------
---------------------------X--------------------------------SS-----E-------SS-SSSSS?------XXE----------------------------Q--QQQQ--------------------------------------E----------------------<>---E-S--E--<>------E--------------------------------------------SS[]SS-------S---------SS-?SSQ----------------------X--------------------SSSSSS-------------SS---------------------------XXXXX-XX-----------------SSSS--------------------S----------------------E---------E<>------<>--------<>---S----------------------------------------------XXX---------------------E--E?S-------------E------------------------------------XXX---E-----------------------------o-o--o--------XXX-------------------------E------XX----SSSS---S---------SS---------QQQQ---QQQ-SQS------<>------QQ--Q?S---------------X-----SS---------------------------------XXS-XXS------E--<>----Q--Q-----------------------Q---------------------XXX--------------SS----------<>-------------------------------o--<>-----E----XX---------XX-----------<>---S--------<>-----------o-----------------Q------S------------------SS---------------SSQ-SSSS----XX--Q-----Q--Q--Q----------EX---<>-----<>------E-------------------------------------------------Q--QQ-Q--Q--Q---------S?S---------------------<>-Q--QS?S----[]---------------SS--------S----------XX-[]----S------------E--<>-----ESSS------X---------------Q---------E-------------------------------XXX--XX-------QQQQ---------------------------------<>-------------------------------<>----------S-------SSSSSSS??SSSS--SSSSSSS
--------------------------XX-----------------------------EE-------<>----------E-------XXXXXXXXXXXXX-------------X------------------------<>------------------------XXXXX---------------------[]--XX---<>--[]-----<>------------------E------E----------------------------------------E-----------------------------X----------------X--------------------------------------X-----------XXXXXXXXX-------------------------E--------------------------------------E--------<>[]------[]--------[]-------------------------------------------------XXXX--------------------<>----------------E<>-----------------------------------XXXX--X------------------------------------------XXXXX-------------------E----<>-----XXX--XX---------XX---X---------------------------------[]----------------------------X------------E-----E----------XX----E-------------E--<>--[]-----------------------------------------------------XXX-----------E--------------[]--X-------------------------------[]----<>--XXXX--------EXX-----------[]------------[]---------------X-----------XX--------------------------E--------------------E-------XX------------------------XXX---[]-----[]----E<>-----------------------------------------------------------------------------------------------[]-----------<>-----------------------------E------XXX-[]----------------<>--[]--X-----------XX------------------------<>------------------------------XXXX--XX-----------------------------------------XX-[]-------------------------------[]--E------E--------SSSSSS---SSSS---------
-------------X-----------XXX--------------------------------------[]--------------------------------------------X------------------------[]--------------------------------------------------[]-XXX---[]--[]-----[]-----------------<>-----<>---------------------------------------<>-------------X---X-------E---X---X--------E---X-------------------------------------XX---------EXXXXXXXXXX------------------------<>---------------------S----------------E---<>---[][]------[]--------[]---------------------------------------<>----<>-XXXXX--------------------[]---------------<>[]----------------------------------XXXXX--XX------------------XXX-------------------XXXXXX------------------<>----[]----XXXX--XX--------XXX---X---------------------------------[]--X-X-----------------------X-----------<>----<>---------XXX---<>------------<>--[]--[]-----------------------------------------------------XXX--------------------------[]--X-----SSS-----------------------[]----[]--XXXX-------XXXX-----------[]------------[]-----------E---X-----------XX-------------------------<>----------------X-------E---XX-----------------------XXXX---[]-----[]---<>[]-----------------------------------------------------------------------------------------------[]-----------[]---------------------<>-----<>-----XXXX-[]----------------[]--[]--X------------X------------------------[]---------------------------XXXXXXX--XX-----S----------------------------------XXX-[]------------------------------<]--<>-----<>--------SSSSSS---SSSS---------
-E-E-------E-X----------XXXX---------------------X--------------X-[]-E----------E-------------------------------X---------------E-E---EE-[]-------------------------------E-E-E---------E----[]-XXXX--[]--[]-----[]--E--------E-----[]--E--[]--------------------EE--------------EE-[]-------------X-E-X-----------X---X------------X------------------------------------XXX---------XXXXXX-XXXX---EE-------------------[]-----------E-E------------------E-EE------[]---[][]------[]--------[]---------E-EE-------EE-E----------E----[]----[]-XXXXX--------------------[]---------------[][]------------------------------EE-XXXXXX--E----------------------------------------XXXXXXX-SSSSSS-----------[]----[]---XXXXX--SSE-EE---XXXX---X---------------------------------[]--X---E-----------------E---X----E------[]----[]--------XXXX---[]------------[]--[]--[]-------------------E-E-E-------E----E-EE------EE-E---XXX----------------------E-E-[]--X----------o-----------------E--[]----[]----X-------XXXXX-----E-E---[]------------[]---------------X-----------XX----EE---------E---------[]----E-----E-E-E-X-----------XX-----E----------------XXXXXE--[]-E-E-[]---[][]-------------------------------EE-E------------------------------------------------------------[]-----------[]------------E-EE-----[]-----[]--EEXXXXX-[]--------E-----E-[]--[]--X-EE---------X----SS----E----E--E-EE--[]-------------E----------XXXXXXXXXX--XX---E-X------E-EE------E------------E-EE-XXX-[]--------------------EE-E------[]--[]---E-[]--------------oooSSSS----E-E--
XXXXXXXXXXXXXXX--XXXXXXXXXXXXXXX----XXXXXX---------XXXXXX-XXXXXXXXXXXXXXXXXXXXXXXXXX------------------------------XXXXXXXXXXXXXXXXXXXXXXXXXXXXXXXXXXX-X-XXXX---XXXX-----XXXXXXXXXXXXXXXXXXXXXXXXXXXXXXXXXXXXXXXXXXXXXXXXXXXXXXXXXXXXXXXXXXXXXXXXXXXXXXXXX---XXXXXXXXXXXXXXXXXXXXXXXXXXXXXXXXXXXXXXXXXXXXXXXXXXXXX--XXXXX--XXXXXXX-XXXXXXXXXXXX--XXXXXXXXXXX------X-XXXXXXXXXXXXXXXXXXXXXXXX-XXXXXXXXXXXX-------XXXXX----XXXXXXXXX---XXXXXXXXXXXXXXXXXXXXXXXXXXXXXXXXXXXXXXXXXXXXXXXXXXXXXXXXXXXXXXXXXXXXXXXXXXXXXXXXXXXXXXXXXXXXXXXXXXXXXXXXXXXXXXXXXXXXXXXXXXXX-XXXXXXXXXXXXXXXXXXXXXXXXXXXXXXXXXXXXXXXXXXX--XXXXXX---XXXXXXXXXX-XX--XXXXXX--XXXXX-----------------XXXXXXXXXXXXXXXXX--SS---XXXXXXXXXXXXXXXXXXXXXXXXXQX---SXXXXXXXXXXXXXXXXXXXXXXXXXXXXXXXXXXXXXXXXX----XXXXXX--XXXXXXXXXXXXXXXX---XXXXXXXXXXXXXXXXXXXXXXXXXXXXXXXXXXXXXXX--XXXXXXXXXXXXXXXXXXXXXXXXXX-XXXXXXXXX---XXXXXXXXXXXXXXXXXXXXXXXXXXXXXXXXXXXXXXXXXXXXXXX--XXXXXXXXXXXXXXXXXXXXXX-XXXX--XXXX-X---X-----------XXXXXXXXXXXXXXXXXX--XXXXXXXXXX-XXXXXXXXXXXXXXXXXXXXXXX-XXX---XXXXXXXXX-----XXXXXXXXXXXXXXXXXXXXXXXXXXXXXXXXXXXXXXXX-XXXXXXXXXXXXXXXXXXXXXXXXXXX-XXXXXXXXXXXX-XXXXXXXXXXXXXXXXXXXXXXXXXXXXXXXXXXXXXXXXXX--XXXXXXXXXXX---XXXXXXXXXXXXXXXXXXXXXXXXXXXXXXXXXXXXXXXXXXXXXXXXXXXXX----------XXXXXXXXXXXXXXXXXXXXXXXXXXXXXXXXXXXXXXXXXXXXXXXXXXXXXXXXXXXX-XXXXXXXXXXXXXXXXXXXXXXXX--XXXXXXXXXXXXXXX--XXXXXXXXXXXXXXXXXXXXXXXXXXXXXXXXXXXXXXXXXXXX--XXXXXXXX?X---XX---X-XXXXXXXXXXXXXXXXXXXXXXXXXXXXXXXXXXXXX--XXX---XXXXXXXXXXXXXXXXXXXXXXXXXXXXXXXXXXXXXXXXXXXXXXXXXX-XXXXXXXXXXXXXXXXXX