------------------------------------------------------------------------------------------------------------------------------------------------------------------------------------------------------------------------------------------------------------------------------------------------------------------------------------------------------------------------------------------------------------------------------------------------------------------------------------------------------------------------------------------------------------------------------------------------------------------------------------------------------------------------------------------------------------------------------------------------------------------------------------------------------------------------------------------------------------------------------------------------------------------------------------------------------------------------------------------------------------------------------------------------------------------------------------------------------------------------------------------------------------------------------------------------------------------------------------------------------------------------------------------------------------------------------------------------------------------------------------------------------------------------------------------------------------------------------------------------------------------------------------------------------------------------
------------------------------------------------------------------------------------------------------------------------------------------------------------------------------------------------------------------------------------------------------------------------------------------------------------------------------------------------------------------------------------------------------------------------------------------------------------------------------------------------------------------------------------------------------------------------------------------------------------------------------------------------------------------------------------------------------------------------------------------------------------------------------------------------------------------------------------------------------------------------------------------------------------------------------------------------------------------------------------------------------------------------------------------------------------------------------------------------------------------------------------------------------------------------------------------------------------------------------------------------------------------------------------------------------------------------------------------------------------------------------------------------------------------------------------------------------------------------------------------------------------------------------------------------------------------------
----------------------------------------------------------------------------------------------------------------------------------------------------------------------------------------------------SS------------------------------------------------------------------------------------------------------------------------------------------------SQS-------------------SSSSSSSSSSSSSSSSSSSSSSSSSSSS--------------------------------------------------------------------------------------------------------------------------------------------------------------------------------------------------------------------------------SSSSSSSSSSSSSSSSSSSSSSSSSSSS------------------------------------------------------------------------------------------------------------------------------------------------------------------------------------------------------------------------------------oo-------------------------------------------------------------------------------------------------------------------------------------------------------------------------SS-S-------------------------------------------------------------------------SSSSSSSSSSSSSSSSSSSSSSSSSSS-----------------------------------------------------------------------------------------------------------------------------------------------------------------------------------------------------------------------------------------------------------------------------------------------------------------------------------------------------------------------------
-----------------------------------------------------------------------------------------------------------------------------------------------------------------------------------------------------------------------------------------------------------------------------------------------------------------------------------------------------------------------------------------------------------------------------------------------------------------------------------------------------------------------------------------------------------------------------------------------------------------------------------------SSSSS---Q-?oS--SS--SS----oS-------------------------------------------------------o--------------------------------------------------------------------------------------------------------------------------------------------------------------?-------o----XXXX-------------------------------------------------------------------------------------------------------------------------------------------Q-------------------------------S--S-S----------------------------------------------------------------------------------------------------------------------------------------------------------------------------------------------------------------------------------------------------------------------------------------------------------------------------------------------------------------------------------------------------------------------------------------------------------------------------
----------------------------------------------------------------------------------------------------E--------------------------------------------------------------------------------------------------------------------------------------------------------------------------------------------------------------------------------------------------?---------------------------------------------------------------------------------------------------------------------------------------------------------------------------------------------------------------------------------------------------------------------------------SSSS--E----SS--SS--SS----ES----------------------------------------------------------------------------------------------------------------------------------------------------------------------------------------------------------------------------------------------------------------------------------------------------------------------------------E------------S--------------------------------------------------------X---E----SS------------------------------------------------------------------------------?---------------------------------------------------------------X----------------------------------------------------------------------------------------------------------------------------------------------------------------------------------------------------------------------------------------------------------------------------------------------------------------------------------
------------------------SS--------E---------------------------S-----SS---S---SSSSS------------------E-EE-------------------------S---------S---------------------------S-?SS-------------------------------------------------------------------SQS---?------------------------------------------------E-----oo----------------------------------SSSS-?S??------------------------------------------------------------------XXXX--------SSSSS--------------------------E--------------------S--------------------------XX-oo--------------------------SS---S--------------------S-?SSS-----SSSS--------------SSS-------------oo----XXX-----S---SSS-----------SSS---XS--------------SSSSSSS------------------------S------SSSS------------------XXX-------------------S---SSSSSSSS----------SSSSSSS------------------------------------XX-------------?--------------------S----SS---------S---S-----S-S-?------------------SS---S-------------------------SSS-S??-------------S?-SSSS----------------SSSSSSQS-SSS---S----SSSSSS--------------------S----------------------------SSSSSSS-S-------------------------------------------S----S---?SSSSS----------SSSS---SSS?--------------?-------------------------------------------------------------------------------------------------------------------------S----X----------XXX------------------------------------------XXX-----------------------SSSS-----------------------------S----SSSSSS-----------------------------------------------------XX--------------------QQQS-----------SS-------SSSS-------?-------
------------------------SS-------<>------------------------------------------------------XXX----------XXXXXX----------------------------------------------------------------------------------------------------------------------------------------------------------------------------------o---o------------------------------------------------------------------------------------------------------------------ooo--XXXXX--------------------------------------<>----------------------------------------------XXX--o-------------------------E---------------------------------------------------------------E----------------oo---S---SSS-----------SSS--------------------------------------------------------------------------oo---XXX-----------------------------------------------------------------------------------XXX---------------------------------------SS-------------S----------------------------------------------------------------------------------------------------------------------------------XXX----------------------------------------------------------S----------------------------------------------------------------------------------------------------------------------------------------------------------------------------------------------------------------XX---------------XXX----------------oo------------------------------------------------------------------------------------------------------E--------------------------------------------XX---------------------------------------------------------------
------------------------SS-S-----[]------------------------------------------------------------XX------------XXX---------------------------------------------------------------------------E---------------------------------------------E---------------------------------------------------XXX-XXX-------------Eo------------------------------------------------------------------------------------------------------XXXXXX--------------------------------------[]---------------------------------------------XXXX-----------------------------------------------------E-Q-----------------------------------<>---------------------S---SSS-----------SSS---S--------------------------------------------------------------------------XXXX---------------------------------------------------------------------------------XXXXX------------------------------------------------------S---------------------------------------------------------XXS------------------------------------------------------------------------------------o-----------------------------S-S---------oQQ------------------------------------------------------------------------S-----------------------------------------------------------------------------------------------------------------------------------------------------------XXX------------------------------------------------E--------------------------------------------------------------------------------------------------------------------oX---------------------------------------------------------------
-----------------------oSS-S-----[]------------------------------------------------X-------------------------------------E--S------E--<>--------------------------------SSS---------S--E--<>--<>------------So------------------S-----------------------------------------E--------------------------------------------------E-------E------------?---------E-----------------------------------------------------------XXXXXXX---------------------------SSSSSS---SS[]---------------E----------------------------XXXXX-------------------------------------------------------------------------------------------[]---------------------SoooSSS--------??-SS---ESX-----------------------------------------oo-------------------------------XXX--------SQSQ-------------------------------------------------E--oo---oo----------XXXXX--------------------E---------E--------S-------------S------X---------------E----------------------------------XXX------------------------SS-----------------------------------------E-------------------S-------------------------------------E-EE----S--------------------------------E------------------------E------------------------------------SSSSSS-----------S-SQ-------------------------E------------------------------------------------------------------------------E--XXXXX-----------------------------------------------<>---------------E---------------------------------------------------ESSSS----------------------E-------------------------------------------------------------E------------------------
------------------S---XSSSSS-S---[]------QQQ--QQQQ-----------S-------------------XXXX--------o--------------------------<>-----E--<>--[]--------------------------------------E-------<>--[]--[]-----------------------------------E-----------QQQQ--Q-------------------<>---------------X-------------XXXXXXXXX-----------<>---E--<>----------SS??SSSSSSSSSSS-------------------SS------------------------------------XXXXXXX-------SSSS-------------------------SS[]SS-----E------<>---Q-----------------------XXXXX---XXX-----------------------------SSS--------S------SS--Q-----QQQQ-QQ--QQQQ--QQQ-----------XXS------E--XX----XX---SSSSSSS-S-SS---S---S--S?SS----------<>----E----------------------E--------------SSo----------------XXXX----------o-------X---------------XQ--E?QQQQSQQ-------------<>------------------XXXXXX--------Q-Q--Q-----<>---E----<>-------SSS------------------XX-S-------E----<>---------------------------------XXXX--E-ooo-------X--X------------X-----------XX--X----S-----SX-------<>---------------S------E-----QQQ---QQQ?---------SSSSSSSSSSSSSSSS--Q--Q--Q-QQX---------------------<>-------QQQ---SQS-------<>------------S------------Q----------------------------------------------------E--<>-----------------------S------E--S---------------------------E-------------SS----XXXXX---------E----------------------------------E--[]------------X-<>---E-------------------------------------SS-S-----<>X---------------E--------<>---o--------XX---X---XX--------X----S----S?SQS--------------<>-----QQS----------------
--------------------------SS-----[]---------------------------------------------EXXX--------------------------E---------[]----<>--[]--[]-------------------------XX-------------------[]--[]--[]----------------------------------<>-------------------------------------[]------------X------------------------------------[]--<>--[]----------S---SSSSSSS?SSSS---S-----------X--------------------------------------X-XXXXXXX----------------------------------------------<>------[]--E-----------------------XXXXXX-------------------------------------------------------SS-------------------------------------------<>-----------------------------------E-------------[]--------------------------<>----------E---------E------E---X-XXXX-----------------XX--XX----------XX------------------E------[]-----------------XXXXXXX-------------------[]--<>----[]---------------------------XXX--------<>----[]---------X--------XXXX----------XXXX--------------XX--XX-----------X---------XXXX--XX--E------EX-------[]--XXX--XX------------<>------------------------SSSSSSSSSSSSSSSS-SS---------X---------------------[]-XX--------------------[]-----------------------------------------------------------------------------<>--[]-----------------------------<>--------------------E--------<>-----------E------XXXXXX--------<>---------------------------------<>--[]------------X-[]--<>----------------------------------------------[]X--------------<>--------[]-----------XXX-XXXX--XX--------X----------------------------[]------------------------
--------------------------SS-----[]-------------------------------------------EXXXXX-XXXXXXX-----------------<>---------[]----[]--[]--[]------------------------XXX-------------------[]--[]--[]--------X-------------------------[]-------------------------------------[]------------X-----XXXX-----------------oo--------[]--[]--[]----------S---SSSSSSSSSSSS---S--------X--X---SSS--------------------------------XXXXXXXXX----------------------------------------------[]------[]-<>----------------------XXXXXXXX------------------------------------------<>----------SS----------------------------XXX------------[]------<>------------------X----------------------[]--------------------------[]---------<>--------<>-----<>---X-XXXX----------------XXX---XX--------XXX-----------------<>------[]----------------XXXXXXXX-------------------[]--[]----[]--------------------------XXXX--------[]----[]---------X---------------------XXXXX-------------XXX--XXX------E---X--------XXXXX--XX----------X-------[]--XXX--XXX-----------[]------------------------SSSSSSSSSSSSSSSS------------X---------------------[]--XX-------------------[]-----------------------------------------------------------------------------[]--[]-----------------------------[]-------------------<>--------[]--------------E---XXXXXX--------[]---------------------------------[]--[]-----------XX-[]--[]----------------------------------------------[]X--------------[]--------[]--------XXXXXXXXXXX--XXX-------X----------------------------[]------------------------
-------------E-----------E---EE--[]---------E-E------------------E-E-----E-X--XXXXXX-------------------------[]--EE-E---[]----[]--[]--[]---X-------------------XXXX------E------------[]--[]--[]--------X-------------------------[]-----------------EE---X--------------[]------EE-E--X-------------ooo---------XXX------E-[]--[]--[]----------oooSSSSSSSSSSSSS-------------X-X--------------------------------------X-XXXXXXX------E-------------------------------EE------[]------[]-[]-------E-EE-------E--XXXXXXXXX----------------------------EE-E-------E--[]-E--X-X----S-------------------------------------------[]------[]-----E--------E-E-X---E-----------EE-E---[]-------------------E-EE---[]---------[]--------[]-----[]---XXXXXX------X--------XXXXE--XXX------XXXX-----------------[]------[]---------------XXXXXXXXX------E--------E---[]--[]-E--[]-----EE------E---X-------XXXXXE--EE-E-[]-E--[]---------X-X---------------EE-XXXXXX----E-------XXXX--XXXX---------X----E--XXXXXXE-XXXX--------X----E--[]--XXX--XXX---EE-E----[]------------------------SSSSSSSSSSSSSSSS---------E--X-E--E-EE------EE-E-X-[]--XX-------------------[]-E--------------------------EE-----------------------------------------------[]--[]-------------EE-E-----E--E---[]-E------------E----[]--------[]-----------------XXXXXXX--------[]------------EE-E-----------------[]--[]----------XXX-[]--[]-----E-E-----------E---------EE--EE-E---------[]X--------------[]-----E--[]--E-E--XXXXXXX-XXXX--XXX--E----X----------E-EE--------------[]------------------------
XXXXX-XXXXXXXXXXXXXXXXXXXXXXXXXXXXXXXXXXXXXXXXXXXXX-XXXXXXXXXXXXXXXXXXXXXXXXXXXXXXXXX----------------------XXXXXXXXXXXXXXXXXXXXXX-XXXXXXXXXXXXXXX---XXXXX-XXXXXXXX-----XXXXXXXXXXXXXXXXXX-XX--XXXXXXXXXXX-------XXXXXXXX----XXXXXXXXXXXXXXXXXXXXXXXXXXXXXXXXX--XXXXXXXX--XX--XXXXXXXXXXX-------------XXX------------XXXXXXXXXXXXXXXXXXXXXXXXXXXXXXXXXXXXXXXXXXX--------XXXXXXXXX----------XXXXX-XX-XXXXX-XXXXXXXXXX-XXXXXXXXXXXXXXXXXXXXXXXXXXXXXX-------XXXXXXXXXXXXXXXXXXXXXXXXXXXXXXXXXXX-XXXXXXXXXXXXX-XXXXXXXXXXXXXXXXX-----------------------XXXXXXXXXXXXXXXXXXXXXXXXXXXXXXXXXXXXXXXXXX----XXXXXXXXX---------------XXXXXXXXXXXXXX-XXXXXXXXXXXXXXXXXXXXXXXXXXXXXXXXXXXXXXXXXXXXXXXXXXXXXXXXXXXXXXXXXXXXXXXXXXXXXXXXXXXXXXXXXXXXXXXX-EXXXXXXXXXXXXXX--X-XXXXXXXXXXXXXXXXXXXXXXXXXXXXXXXXXXXXXXXXXXXXXXXXXXXXX---XX---XXXXXXXXXXXXXXXXXXXXXXXXXXXXXXXXXXXX-XXXXXXXXXXXXXXXXXXXXXXXXXXXXXXXXXXXXXXXXXXXXXXXXXXXXXXXXXXXXXXXXXX-X-XX------XXXXXXXXXX-X----XXXXXXXXXXXXXXXXXXXXXXXXXX--X--XXXXXXXXXXXXXXXXXXXXXXXXXXXXXXXXXXXXXXXXXXXXXXXXXXXXXXXXXXXXXXXXXXX---XXXXXXXXXXX-XXXXXXXXXXXXXXXXXXXXXXXXXXXXXXXXXXXXXXXXXXXXXXXXX-XXXXXXXXXXXXXXXXXXXXXXXXXXXXXXXXX-XXXXXXXXXX--XXXXXXXXXXXXXXXXXXXXX-XXXXXXXXXXXXXXXXX-XXXXX-X-XXXXXXXXXXXXXXXXXXXXXXXXXXXXXXXXXXXXXXXXXXXXXXXXXXXXXXXXXXXXXXXXXXXXXXXXXXXXXXXXXXXXXXXXXXXXXXXXXXXXXXXXXXXXXXXXXXXX--XXXXXXXXXXXXXXX---XXXXXXXXXXX--XX--XXXXXXXXXXX-XXX-XXXXXXXXXXXXXXXXXXXXXXX---XXXXXXXXXXXXXXXXXXXXXXXXXXXXXXX-XXXXXXXXXXXXXXXXXXXXXXXXXXXXX-XXXXXXX---XXX-XXXXXXXXXXXXXXXXXXXXXXXXXXXXXXXXXXXXXXXXXXXXXX--XXXXXXXXXXXXX