-----------------------------------------------------------------------------------------------------------------------------------------------------------------------------------------------------------------------------------------------------------------------------------------------------------------------------------------------------------------------------------------------------------------------------------------------------------------------------------------------------------------------------------------------------------------------------------------------------------------------------------------------------------------------------------------------------------------------------------------------------------------------------------------------------------------------------------------------------------------------------------------------------------------Q------------------------------------------------------------------------------------------------------------------------------------------------------------------------------------------------------------------------------------------------------------------------------------------------------------------------------------------------------------------------------------------------------------------------------------------------------------------------------------------------------------------------------------------------------------------------------------------------------------------------------------------------------
------------------------------------------------------------------------------------------------------------------------------------------------------------------------------------------------------------------------------------------------------------------------------------------------------------------------------------------------------------------------------------------------------------------------------------------------------------------------------------------------------------------------------------------------------------------------------------------------------------------------------------------------------------------------------------------------------------------------------------------------------------------------------------------------------------------------------------------------------------------------------------------------------------------------------------------------------------------------------------------------------------------------------------------------------------------------------------------------------------------------------------------------------------------------------------------------------------------------------------------------------------------------------------------------------------------------------------------------------------------------------------------------------------------------------------------------------------------------------------------------------------------------------------------------------------------------
----------------------------------------------------------------------------------------------------------------------------------------------------------------------------------------------------------------------------------------------------------------------------------------------------------------------------------------------------------------------------SSSSSSSSSSS------SSSSSSSSSSS-------------------------------------------------------------------------------------------------------oo-------------------------------------------------------------------------------------------------------------------------------------------------------------------------------------------------------------------------------------------------------------------SSSSSSSSSSSSSSSSSSSSSSSSSSSS--------------------o---------------------------------------------------------------------------------------------------------------------------------------------------------------------------------------------------------------------------------------------------------------------------------------------------------------------------SSSSSSSSS--------------SSSSS----------------------------SSSSSSSSSSSSSSSSSSSSSSSSSSSS-----------------------------------------------------------ooo------------------------------------------------------------------------------------------------------------------------------------SS--------------------------------------------------------SSSSSSSSSSSSSSSSSSSSSSSSSSSS----------------------------
----------------------------------------------------------------------------------------o-----------------------------------------------------------------------------------------------------------------------------------------------------------------------------------------------------ooo-----------------------------------------------------------------------------SSSS-----------SSSSSSS----------------------------------------------------------------------------------------------------------XXXX-----------------------------------------------------------------------------------------------------------------------------------------------------------------------------------------------------------------------------------------------------------------------------------------------------------------XXX-----------------------------------------------------------------------------------o-------------------------------------------------------------------------------------------------------------------------------------------------------------------------------------------------------------------------------------------------------------------------------------------------------------------------------------------------------------------------------------XXXX-----------------------------------------------------------------------------------------------------------------------------------SS----------------------------------------------------------------------------------------------------------------
----------------------------------------------------------------------------------------------------------------------------------------------------------------------------------------------------------------------------------------------------------------E--------------------------------o---------------ooo----------------------------------------------------------SSSS-----------SSSSSSS------------------------------------------------------------------------------------------------oo--oo---------------------------------------------------------------------------------------------------------------oo---------------------------------------------------------------------------------------------------------------------------------oooo-------------oooo---------------------------------------------------------------------------------------------------------------------XX--------oo-----------XXX----------------------------------------------E--------------------------------------------------------------------------------------------------------XX-------------------------------------------------------------Eooo--------------------E-----------------------------------------------------------------------------------------------------------------------------------------------------------------oo--oo--------------------------------------------------------------------------------------E---------SS----------------------------------------------------------------------------------------------------------------
-------------------------?-------------------------------S----S----------SSSSSSS------SSS------SSSS-X----SSSS-----------------------------------------------SS----------S---------------SQ------------------------------------------SSSSS----------------------SSS-S----QQQQ---------------------XXX------oo------XX---------------------------------------------------------S-QQ------------SSSSSSS-----------------------------------------------------------S------S---------------------o--S----------------------------------SQ---------------------------------------------------------------------------------------------------------------SSS--------------------------------------------SSQ--SS---------------------------------------------------XXXX-------------XXXXX-----------------------------------QS---------------SSSS------------------SSS------------------------------------------XXX-----E--E--------o-----o---------E--E------ooo---------------------?SXS----------XXX------------------------------------------------------S----SSS---------------------------------------------------------SSSSSSS---SSS------------X-----XXXXX-----------------SSSSSSSSSSSSS----------------------------------S-------oooo----------------?--------------SSSSS-----E------o-XXX-----------------------------------------?--o---------------------SSSS------------------------------------------------------SSSS--------------SSSSSSSS-SSSSS-------E----------------------------------SSSSSS----------------------------------------------------------------
--------------------------------------------------------E-----------------------------------------XXXS----------------------oooo---------------------------------------X--------------------------------------------------------------------XXX----------------------------------------------------------------------------ooo-----------------------------------------------S------------------------------------------------------------------------------------------------------------------------------XSSS----------------------------------------------------------------------------------------------------------------------------------------------------------oooo--------------------S----------------------------------------------------------------------------------------------------------------------------------------------------------------------------------------------------------------XXXXXX----------------------XXXXXX--------o-o-----------------X-----------------------------------------------------------------------------------------------------------ooooo----------------------------------oooo-----------------------X---------------------------------X-X--o---o-------------------------------------------oo---------------------------X-XX------------------------------------------------------------------o----------------------------------------------------------------------------------------------------XXX---------------------------------------------------------------------------------Qooo------------------
----------------------XX-------------------------------------------------------------------------EXXXX----------------------------------------------------------------XX---------E-------------------------------------------------------------------------------------------------------------------------------------------------------------------------------------------S-----------------------------------------------------------------------------------------------------------------------------XX------------------------------------------------------------------X----------------------------------XXX-XXXX-X----------------------------------------------------------------------S-------------------------------------------------------------------------------X----------------------------------------------------------------------------------------------------------------------------------------------------------------------------------------------X-------------------------------------------------------------------------------------------------------------------------------------------------------------------------------------------------------------------XXX-XXX---------------S-------SSSS------------------------------------------------------------------------------------------------Q-------------------E-----------------------------------------------------X------------------------------------------------------------------------------------------------------------------------------------------------------
----------------------XX------------------------------------------------------------------------XXXXXX--------------------E---------------------------------------E--XXXS-------<>-------E------------------------SS-S----------------------------XXX--------X---------------------------------------------XXXX-------------------------------------------------XX----------?----------------------E------------------------------------------------------E--------------------E-----------XXX--oo--------X-XSS-SQ------S------------------E-----------------------E----------XX----------------------------------------------------------------------------------------------------------------?-So----S-------------------------S----------------------------------------------XX------------o-------------------------------------SSSSSSS---------------E----------------------------------------------------------------XXX--------------------------XX-----------------------------oo----------------------------------------------------oo---------------E----SS---------E------------------------------------------------------------------------------------------S------------E-------------------XX------------------------SSS------------------------------------------------------------------S--------------------------E--XX-------------------SSSSSSS-----------------------------S-SSSSS-E-EE----X----------------------------------------------------------------oo------------------------------oo-----------oo---------------E-----------------------
-----------------SS---XX------------------------S-------Q----S---------X------o----------------XXXXXX----SS--------------<>--------------------------------------<>---XX---E----[]---E--<>-E--<>----ooooo-------XXX-----------------------------------------XXX--------S?SQS---------------------XXXX----------------------------------S-----------------------XXX----------SSSSS------------SSSSSSSS-------------------------E--------------------S-----<>---ES-----S--------<>----------XX---o--o------XXXXX---------X-----------------E<>---------QQQ----------<>----------XX---------------XXXX---------XX------X----------------------QQQ-------X--X-----------QQQ-------------------X-------S?S--SS-----------------------------------------------------------------------XXX----------------------E----------SSS-----------------------------------<>-----------X---------X------------------XX-----XXXXX----------------X---XXXXXXX-XXX----------------------------XXX-----------------XXXX--------------------------------------------------S--------<>--------------<>----------<>---E-----E-------------E--S---------------------------XXXXXXXXXXX-----SSS-------E------SSSSSS-----EEEE--E-------------X-----X---------------------------oooo-------------------------------------------------------------------S--------<>-----------------E---E--------------------------------E?Q-----------E--XX--XX-------------XXX------SSSSSSSSSSSSSSS---------------------XXX-o-------------XX----Q?S--------------------------------Q------<>-----------------------
--------------------X-XX----XXXX?--XXXXXX-----------XXX-----------XX---XX-----E---------------XXXXXXX----------X---------[]--------------------------------------[]--XXX--<>----[]--<>--[]<>--[]---------------XXXX-----------------------------------------XXX-----------------------------------------------------------------------------XX---------------XXXXX--------E-E--------XX----------------X---------------------<>--------------------------[]---QX--------------[]--E------XXX------------XXXXXX--------XX---------------E<>[]-----E----------------[]--------XXXX-----------------------------------------------------o--------------XX--X------------------------------E--X----X-------------------------------------------------------X-----XXXX?--XXXX?------XXXX-----------X---?-----<>------------------------------------------------[]--------EX-X-----XXXX?-------------XXXXX-------------------------------XXX---------------------------XXX------EXXX--X-------------XX-------E-------------------------E-E--------------------------[]--E-----------[]----------[]--<>----<>------------<>---------------------------------------------------------------EE-------XXXXXXXXXXXX-X----------XXXXX--------------------------------------X---X------------------------------------E------------------------XX-[]----------------<>--<>--------X----------------------------------------XX--XX-----------XXXXX--------------------------------------------------E--------XXX---X---------------------------------------X--[]-----------------------
----------------------XX----------------------------XXX----------XXX---XXX-------------------XXXXXXXXX--------XX---------[]--------------------------------------[]--XXX--[]----[]--[]--[][]--<>--------------XXXXX-----------------------------------------XXX-----------------------------------------------------E-----------------------XXX-------------XXXXXX--------XX--------XXXX---------------X---------------------[]-----E--------------------[]---XX--------------[]-<>-----XXXX------------XXXXXX--------XX--------------<][][]----<>----------------[]-------XXXXX------------------------------o---------------------XXXX------------EX--XX------------------------------X-XX---X------------------------------------------------------XX----------------------XXXXX---------------------[]--------------------<>--------------------------[]-------XXX-X----------------------XXXXX-----------------------------XXXX-------------------------------------XXXXX--XX--------------------<>---------XXX------------<><>--------------------------[]--E-----------[]----------[]--[]----[]------------[]------------------------------------------oo-----------------------E--------------------------------X--------------------------------------X---XX----------------------------------<>-----------------------XXX-[]----------------[]--[]--------X----------------------------------------XX--XX-------XX--XXXXX----------------------------------------------------------XXXX--XX---------------------------------------X--[]-----------------------
---------------E------XX----------------------------X-X---------XXXX-E-XXXX-----------------XXXXXXXXXX---E---XXXE-EE-E---[]----E-----------------EE-EE-----E-----[]--XXX--[]----[]--[]--[][]--[]-------------XXXXXX--SSSSS-----------------------------E-E--XXX---------------E--------E----XXXX----------------------------------------EE--XXX-------------XXXXXX-------XXX-------XXXXXE--------------X--------------EE-E---[]--------EE-E-EE-E--EE-E--E[]---XX---EE------E--[]-[]----XXXXX------------XXXXXX--S?SSSXXX------------E-[][][]----[]--------E----E--[]------XXXXXX------EE---------------------------------------------------E---------X--XXX--EE-E-XX----------------------X----X-E----------------------EE-----------------------EE---XX---------------------XXXXXX---------------------[]-------EE--------E--[]------------------E-------[]------XXXXXX---------------------XXXX---XXXXX---------------------------------------------------------------XXXXXX--SX-E------------------[]------------------------[][]-------------E-E-------E--[]-----E--------[]----EE----[]--[]----[]-----EE-E---[]-E-------------X------XXXXXXXXX----------XXX--------------------------------------------------------X----E-E--------E-E-EE-----------------X---X-----------------------------EE--E-[]-E-------E-EE-E--EE-EE-XXX-[]----------------[]--[]-------XX------------------------------E---------XX--XX-----E-XXXXXXXXX-----E-----------E----------------------------------E----XXXXXE-XXXX--EE------------------------------EE-X--[]-----------------------
-X-XXXXXXXXXXXXXXXXXXXXXXXXX-----XXXX---X-XXXX--XX--X---XXXXXXXXXXXXXXXXXXXXXXXXXXXXXXXXXXXXXXXXXXoXXXXXXXXXXXXXXXXXXXXXXXXXXXXXXXXXXXX--XXXXXXXXXXXXXXXXXXXXXXXXXXXXXXXXXXXXXXXXXX-XX--XXXXXXXXXXXXXXXXXXXXXXXXXX---SX--XXXXXXXXXX--XXXXXX---XXXXXXXXXXXXX-XX----XXXXXXXXXXXXXXXXXXXXXXXX--------------------------XXXXXXXXXXXX--XXXXXXXXX-XXXXXXXXXXXXXXXXXXXXXXXXXXXXXXXXXXXXXXXXXXXXXXXXXXXXXXXXX--XXXXXXXXXXXXXXXXXXXXXXXXXXXXXXXXXXXXXXXXXXXXXXXXXXXXX-XXXXXXXXXXXXXXXXXXXXXXXXXXXXXXXXXXXXXXXXXXXXXXXX------XXXXXXXXXXXXXXXXXXXXXXXXXXXXXXXXXXXXXXXXXXXXXXXXXXXXXXXXXXXXX---XXXXXXXXX--------XXXXXXX-----------------------------XXXXXXXXXXXXXX--XXXXXXXXXXXXXXXXXXXXXXXXX--XXXXXXXX----XXXXXXXXXXXXXXXXXXXXXXXXXXXXXXXXXXXXXXXXXXXX--XXXXXXXXXXXXXXX-----XX------XXXXXXXXX--XXXXXXXXX-----XXXXXXXXXXXXXXXXXXXXXXXXXXXXXXXXXXXXXXXXXX-XXXXXXXXXXXXXXXXXXXXXXXXXXX---X--------XX-X--XXXXXXX-----------------------------------------------------------XXXX-----XXXXXXXX--XXXXXXXXXXXXX-----XX-XXXXXXXXXXX-----XXXX---XXXXXXXXXXXXXXXXXX---XXXXXXXXXXXXXXXXXXXXXXXXXX-XXXXXXXXXXXXXXXXXXXXXXXXXXXXXXXXXXXXXXXXXXXXXXXXXXXXXXXXXXXX-------------------------XXXXXXXXXXXXXXXXXXXXXXXXXXXX-------------------XX---------XXXXXXXXXXXXXXXXXXXXXXXXXXXXXXXXXXXXXXXXXXXXXXXXXXXXXXXXXXXXXXXXXXXXXXXXXXXXXXXXXXXXXXXXXXXXXXXXXXXXXXXXXXXXXXXXXXXXXXXXXXXXXXXXXXXXXXXXXXXXXXXXXXX-XXXXXXXXXXXXXXXXXXXXXXXXXXXXX--XXXXXXXXXXXXXXXXXXXXX-XXXXXXXXXXXXXXXXXXXXX-----XXXXX---XXXXXXXX-X-S---X-XXXXXXXXXXXXXXXXXXXXXXXXXX----XXXXXXXXXXXXXXXXXXXXXXXXXX-XXXXXXXXXXX---XXXXXXXXXX-