------------------------------------------------------------------------------------------------------------------------------------------------------------------------------------------------------------------------------------------------------------------------------------------------------------------------------------------------------------------------------------------------------------------------------------------------------------------------------------------------------------------------------------------------------------------------------------------------------------------------------------------------------------------------------------------------------------------------------------------------------------------------------------------------------------------------------------------------------------------------------------------------------------------------------------------------------------------------------------------------------------------------------------------------------------------------------------------------------------------------------------------------------------------------------------------------------------------------------------------------------------------------------------------------------------------------------------------------------------------------------------------------------------------------------------------------------------------------------------------------------------------------------------------------------------------------
------------------------------------------------------------------------------------------------------------------------------------------------------------------------------------------------------------------------------------------------------------------------------------------------------------------------------------------------------------------------------------------------------------------------------------------------------------------------------------------------------------------------------------------------------------------------------------------------------------------------------------------------------------------------------------------------------------------------------------------------------------------------------------------------------------------------------------------------------------------------------------------------------------------------------------------------------------------------------------------------------------------------------------------------------------------------------------------------------------------------------------------------------------------------------------------------------------------------------------------------------------------------------------------------------------------------------------------------------------------------------------------------------------------------------------------------------------------------------------------------------------------------------------------------------------------------
----------------------------------------------------------------------------------------------------------------------------------------------------------------------------------------------------SSSSSSSSSSSSSSSSSSSSSSSSSSSS----------------------------------------------------------------------------------------------------------------SSSSSSSSSSSSSSSSSSSSSSSSSSSS---ooo------------------------------------------------------------------------------------------------o-------------------------------------SSSSSSSSSSSSSSSSSSSSSSSSSSSS------------------------------------------------------------------------------------------------------------------------------------------------------------------------------------------------------------------------------------------------------------SSSSSS-----SSSSSSSSSSS-SSSSS-----------------oo-------------ooo---------------------------------------------------------------------------------------------------------------------------------------------------------------------------------------------------------------------------------------------------------------------------------------------------------------------------------------------------------------------------------------------------------------------------------------------------------------------------------------------------------------------------------------------oo----------------------------------------------------------------------------------SSSSSSSSSSSSSSSSSSSSSSSSSSSS----------------------------
---------------------------------------------------------------------------------------------------------------------------------------------------------------------------------------------------------------------------------------------------------------------------------------------------------------------------------------------------SSS----------SSSSSSSSSSSS---XXXX------------------------------------------------------------------------------------------------------------------------------------------------------SSSSSSSSS---------------------------------------------------------------------------------------------------------------------------------------------------------------------------------------------------------o-----------------------------------------------------SS---------------------------S-------------XXXX-----------------E--E----------------------------------------------------------------------o-------------------------------------------------------------------------------Q---------------------------------------------------------------------------------------o---------------------------------------------------------------------------------------------------------------------------------------------------------------XX-------------------------------------------------------------------------------------------------------------------------------------------------------------------------------------------------------------------------------------------------------------------
-----------------------------------------------------------------------------------------------------------------------------------------------------------------------------------------------------------------------------------------------------------------------oo-ooo--ooo-----------------------------------------------------------------SSS--E-------SSSSSSSSSSSS---------------------------------------------------------------?-----------------------------o---------------------------------------------------------------SSSSSSSSS---------------------------------------------------------------------oo-oooo-ooo------------------------------------------oo--oo-----------ooo--------------------------------------------E-------------------------------------------------------------------SSS-------------------------E------Eoo--------------------------XXXXXXX----------------------------------------------------------------------ooo---------------------------------------------------E-------------------------------------------------------------------------------------------------------------------------------------------------------------------------------------------------------------------------------------------------------------------------E-----------------------------EE-----------------------------------------E--------------------------------Eooo---------------------------------------------------------------------------------------------------------------------------------------------oooooo----------
---------------------XX--------------SSS---------------X------------------------------------------------------------------------------------------------------S------SSS------------XXX------S------SQQ-------------------------Q-----------------SSSSS--SSSS--------X---------------------------------SSSS---------E-----------------E-----------oS-------------SSSSSSSSSSS---------------------------S-----------------------X----SSS---S??----------------------S----XXX----------X---------?----------------SSSS----S--Q-------------SSSSSSSSS------------------------SSSSSSS-Q--------------SSSSSSS----------------XX------------------------------------------oo-----------------------XXX-------------------XXX--------Xooo----XX----E--E---------?SS---------------------------------------------?------S---------------------------S------XXXX------X--------------------------------------S-S-------------SSSSSS---------------SSSS-----------SSSSXXXXX----------------XXXX-------------------SSSSSS---SSQ--XXoo----X--------------------S----SSS--------------------------------SSSSSSSSS----------------------------SSSS------S----SSS-----------------SSQ-SS------------------S-----SS--------------SSSS-------SSS----S----XX----------S?SSS---?SSS----------------X------------E--E-------------------------SSSS---?------------------------------------SS---SS---Q-o-oo--------SS-------XXXXX-------------------------------------------------------------XSSSS---S--------------------------------------------------------------------------------------
--------------------XXX-----------------------------------------------------------E-----------------SSS-------------oo----------------------------------------------------------------SSSS----------S-----------------------------------------------------------------------XX---------------------------------------------------------------------S--------------------------------------------------------------------------XX---------------------------------------------o----EXXX----------------------XS-------------------------------------------------------------------------------------------------------------------------o---------------------------------------------------------------------------XXX------------------------XXXXXX---------------------oo-------------------------------------S---------------------------------------------E--------------------------ooooo----------------------------------------------------------------------------------------------------------------------------------o--------X-----------------------------------------------------------------------------------------------------------------------------SS--------------------------------------------------------------XXXX---------------------------------------------------XXXXX----------------------------------------E--------------------------SS-------------------------------------------------------------------------------------------------XX---------------------------------------------------------------------------------------------
-------------------XXXX-----------------------------------------------------------E----------------X--------------------XXXXXXX---------------------------------------------------------------------S------------------------------------------------------------------------------------------------------E---------------------------------------S-------------------------------------------------------------------------XXX---------------------------o---------------------<>XXX--------------------XXX-----------------------------------------------------E----------------------------------------------------------------XXXXX---------------------------X---------------------------------------------XXXXX-------------------------------------------------------------------------------------ooo--S--------------------------------------------XX---------XXXXXXX--------------------------------------------------------------------------------------------------------------------------------E---------------XXX------XX-------------------------------------------------------------X-----------------------------------------------------------S---SS-------------------------------------------------------------XXXXX-----------------------------------------------------------------------------------------------XXXXXXX------o------------X-SS--------S-S--SS--------S------------------------------------------------------------------------EXX-----------------------------------------E-------------------------------------------XX------
--------------E-SXXXXXX-------------------------------------------------------E--<>----------------XSS---------------------------------o-----------------------------------------------------------------------S------------------------------------------------------------------------S--------E--------<>----------------------E--S-----------E--E-----------oo-----------S--------E--------------------------------------XXX-------------------------------------------------[]XXX----------------------XX---------------------------------------------------<>-------SSSSSS---------S-------------E----------------------------------------------------------XXXXX-o----------E----SS------o---------------XXXXXX----------------------------------SS------------------------------------ooo---------------SE------------------------------------------XXS-------------------------------------------------------------------------------E--S-------------------XXXXXXXX---------------E-------------------------------------------XX-------------------------------------------------------------X---------------------E----------------------------E--------Sooo-S----ooo-----------------------------------------------------XXXXXX---------SSSSS-------------------SSSS---------------------------------------------------------------------------------o--X-SS---S----SoS--SS--------------------------------------------E---------E--o----------------E------XXX---------------------------------------------------------------So---------------------X---o--
-------------------XXXX-----------------S---------------------------E--------<>--[]--oooo---------XXX----------------XXX------------------------------<>---S---------------------------XXXX-SSS-----SSS-----X---E---------------QQQQ------------QS--------------------XXXXX----------------E----<>-----E--[]-----E------<>---S---<>-----E--o--------SS--------SSSSSSS------S---------<>---ES----------XS--------------------XXXX-------------SSS-----XXX-------------XSQ---------XXXXX------oooo-------XXXXXXX---------X--SSS---X-------SSSSSSSSS------E---------[]---Q---------SS-----E----E-------SSSSS-----------------XXX-----------------SS-----------------XXX--------------<>-----------X---------------XXXXXXX-----------XXXX---XXXX------------------S?QQ-----------------X----------------XXXX--------SSSS--------E-------------E-XS--S-S--------XXXX-------------------------------------S------E--S-----SSSSSSSS-----------------<>-----E--S----XXX----------------XXXXXXX-----<>-----E----------S?S---------XXXXX---------XXX-------------------X--XX------------------------E-SS--------XX--------------------<>--------QQ--QQQQ-Q---------<>-----X--SSSSSS-----------------S?----SSS-------------------------QQQ-----XXXXXXX-------------------SS-----E-----------------XXXX-----------------------E------SSS--QQQS----------------XXX---------------X------SS---SSS--S---------S------------------X------------E--<>-----E--<>-------------QQQQ-----XX-XXXX-------------------------XXX---XX------------------------<>----SS---------------------X------
---------X----X---XXXXX----------------------X--------XX-----------<>--------[]--[]-------------XXXXX-------------XXX-------------X-------------------[]------E----------------------XX---X---------------EXX-----------E-----------------------------------------------------------------<>----[]----<>--<>----<>------[]-------[]----<>--------E-------X-------------E-------------[]--<>-------E--XXX---E--------------XXXXXX------------------------------------------------XXXXXX----------------XXXXXXXX--------XX--------XX-----------------X--<>---------[]-------------------XXX--------E-EE------X----------------------------------------------------XXXX--------------[]--E-------XX--------------XXXXXXXX----------XXX------------------o----------------------------XX-------------------------------------XX-----------XXXXX?--------------XXXXX-SSS--------------------------------S------<>---------------------------------[]----<>----------XXXXXXXXX-------------------[]----<>----------------------E-------------XXX-----------------XXX--XX--------------------------E-----E-E-XX--------------------[]---------------------------[]--E----------------------------------------X----------------------------XXXXXXXX-----------<>------------<>-------------------------------------------<>--------------------X----------------------------X----------------------------<>--------------XX-----------<>--[]----<>--[]---------------------XX--XXXX-----------------------------------------?---------------[]---------------------------X------
--------XXX---X----XXXX----------------------X-------XXX-----------[]--------[]--[]-----------XXXXXXX----------XX-XXX--XXXXXX-----X-X-----------------[]-----<>--------X----------XXXXX---XXXXX-o-oo------XXX---------------E-------------------------------------------------------------[]----[]----[]--[]----[]------[]-------[]----[]------X-----E---X---------------------------[]--[]------<>-XXXX-----------------XXXXXXX---------------------------------------------XXXXXXXXXX--------------XXXXXXXXX-------XXX--------XXX----------------X--[]---------[]------------------XXXX--------------EE--X------------------XXXX-----------------------------XXXXX--------------[]-<>------XXX----------<>-XXXXXXXXX-----------------------XXXX---XXXX-------------------------XXX------------------------------------XXE---------------------------<>-XXXXXX----------------------------------X-S------[]---------------------------------[]----[]--------------------------------------[]----[]-----------------------------XXX----XXX----------------XXXXX-XXX-------------------------------XXX-XX--------------------[]---------------------------[]-<>---------------------------------------XXX---X----------------------XXXXXXXXX-------XX--[]------------[]-------------------------------------------[]--------------------X----------------------------X----------------------------[]--------------XX-----------[]--[]----[]--[]--------------------XXX--XXXX-----------------------------------o---------------------[]--------------------<>-----X------
E------XXXX---X----XXXX----------------------X------XXXX-----E-EE--[]-E------[]--[]----------XXXXXXXX--SSS----XXXXXXX-------------X-X---S------EE-E---[]-----[]--EE---XX-------XXXXXXXX-------------E----XXXX----------------------------------------------------------------------E--E---[]--E-[]----[]--[]--E-[]------[]-------[]----[]------X---------X---------------------E--E-E[]--[]------[]-XXXX-------------E--XXXXXXXX----------------------------------------------XXXXXXXXX-------------XXXXXXXXXX------XXXX--------XXX----------------X--[]---------[]-----------X------XXXX------------------X----XXXXXXXXXX--------------------EE--------------XXXXXX--------------[]-[]-----XXXX----XX----[]XXXXXXXXXX--------Soo-----------------------------------------------XXXX---------------------------X--E----XXX----------------------------[]XXXXXXX--SSSS----------------------------X-S--E---[]-----------------------E---------[]----[]-E----X-------------------------------[]-E--[]-------------------oooo-------------XXX-E-------------XXXXX--XXX---EE---X-----------E-E-------XXXX-XX---E--E---------E---[]----------E-EE-------------[]-[]------E--E---------------------E-E----XXXE---X-----------E---------XXXXXXXXXX---E---XX--[]------------[]-----EE-E-XX-------------------------------[]-----E--------------X----------------------------X-----------E--EE-E----------[]--------------XX-----E-----[]--[]-E--[]--[]-------------------XXXX--XXXX-------XX-------------XX-----------------------E---------[]-----------XX-------[]-----X------
XXXXXXXXXXX---XXXXXXXXXXXXXXXXXXXXXXXXXX-XX-X---XXXXXXXXXXXXXXXXXXXXXXXXXXXXXXX--XXXXXXXXXXXXXXXXXXX-----XXXXXXXXXXX--------------XXXXX-XXXXXXXXXXXXXXXXXXXXXXXXXXXXXXXXXXXXXXXXXXXX----------E-----XXXXXXXXXXXXXXXXXXXXXXXXX-XXXXXXXXXXXXXXX--XXXXXXXXXX--XXXXXXXXXXX-------XXXXXXXXXXXXXXXXXXXXXXXXXXXXXXXXXXXXXXXXXXXXXXXXXXXXXXXXXXXXX-XXXXXXXXXXXXXXXXXXXXXXXXXXXXXXXXXXXXXXXXXXXXXXXXXXXXXXXXXXXXXX---XX-X---XX-XXXXXXXXX-XXXX----XXXXXXXX-XX------XXXXXXXXXXXXXXXXXXXXXXXXXXXXXXXXXXXXXXXXXXXXXXXXXXXXXXXXXXXXXXXXXXXXXXXXXXXXXXXXXXXXXXXXXXXXXXXXXXXXXXXXXXXXXXXXXXXXXXXXXXXXXXXX-XXXXXXXXXXXXXX---XXXX--------------------------XXXXXXXXXXXXXXXXXXXXXXXXXXXXXXXXXXXXXXXXXXXXXXXXXXXXXXSXX------X-XXXXXXXXXXXXXXXXXX----------------------------XXXXXXXXXXXXXXXXXXXXXXXXXXXXXXX--XXXX-XXXXX------XXXXXXXXXXXXXXXXXXXXXXXX--XXX--E--XXXX-----X-XXXXXXXXXXX---XXXXXXXXXXXXXXXXXXXXXXXXXXX--XXXXXXXXXXXXXXXXXXXXXXXXXXXXXXXXXXXXXXXXXXXXXXXXXXXXXXXXXXX----------------------------XXXXXXXXXXXXXXXXXXXXXXXXXXXX---XXX------X-X-X-XXXX------XXXX-XXXXXXXXX--XXXXXXXXXXXX--XXXXXXXXXXXXXXXXXXXXXXX-XXXXXXXXXXXXXXXXXXXXXXXXXXXXXXXXXXXXXXXXXXX-XXXXXXXXXXXXXXXXXXXXXXXXXXXXXXXXXXXXXXXXXXXXXXXXXXXXXXXXXXXXXXXXXXXXXXXXXXXXXXXXXXXXXXXXXXXXXXXXXXXXXXXXXXXXXXXXXXXXXXXXXXXXXX----------------------------XXXXXXXXXXXXXXXXXXXXXXXXXXXX-----------XXXXX-XXXXX------X--XXXXXXXXXXXXXXXXXXXXXXXXXXXXXXXX-XXXXXXXX-XXXXXXXXXXXX-XXXXXXXXX-XX--XX----XXXXXX----XXXXXXXXXEoXXXXXXXXXXXXXXXXXXXXXXX---X-------------------XXXXXXXX-XXXXX-XXXXXXXXXXX-------XXXXXXXXX-XXXXXXXX