------------------------------------------------------------------------------------------------------------------------------------------------------------------------------------------------------------------------------------------------------------------------------------------------------------------------------------------------------------------------------------------------------------------------------------------------------------------------------------------------------------------------------------------------------------------------------------------------------------------------------------------------------------------------------------------------------------------------------------------------------------------------------------------------------------------------------------------------------------------------------------------------------------------------------------------------------------------------------------------------------------------------------------------------------------------------------------------------------------------------------------------------------------------------------------------------------------------------------------------------------------------------------------------------------------------------------------------------------------------------------------------------------------------------------------------------------------------------------------------------------------------------------------------------------------------------
------------------------------------------------------------------------------------------------------------------------------------------------------------------------------------------------------------------------------------------------------------------------------------------------------------------------------------------------------------------------------------------------------------------------------------------------------------------------------------------------------------------------------------------------------------------------------------------------------------------------------------------------------------------------------------------------------------------------------------------------------------------------------------------------------------------------------------------------------------------------------------------------------------------------------------------------------------------------------------------------------------------------------------------------------------------------------------------------------------------------------------------------------------------------------------------------------------------------------------------------------------------------------------------------------------------------------------------------------------------------------------------------------------------------------------------------------------------------------------------------------------------------------------------------------------------------
------------------------------------------------------------------------------------SSSSSSSSS------------------------------------------------------------------------------------------------------------------------------------------------------------------------------------------------------------------------------------------------------------------------------------------------------------------------------------------ooo--------------------------------------------------SSSSSSSSSSSSSSSSSSSSSSSSSS----------------------------------------------------------o----------------------------------------------------------------------------------------------------------------------------------------------------------------------------------------------------------------------oo-------------------------------------------------------------------------------------------------------------------------------------------------------------------------------------------------ooo------------o----------------------------------------------------------------------------------------------------------------------------------------------------------------------------------------------------------------------------------------------------------------------------------------------------------------------------------------------------------------------------------------------------------------------------------------------------------------------------------------------------------------------------------------------
-----------------------------------------------------------------------------------------------------------------------o---------------------------------------------------------------------------------------------------------------------------------------------------------------------------------------------------------------------------------------------------------------------------------------------------------------XXXX---------------------------------------------------SSS-----------------------------oo----------------------------------------------------------------------------------------------------------------------------------------------------------------------------------------------------------------------------------------------------------------------XXXX----------------Q-------------------------------------------------------------------------------------------------------------------------------------------------------------------------------XXX---------------E--E----------------------------------------------------------------------------------------------------------------------------------------------------------------------------------------------------------------------------------------------------------------------------------------------------------------------------------------------------------------------------------------------------------------------------------------------------------------------------------------------------------------------------------------
-------------------------------------E---------E-----ooo-----------------------------------------------------------------------ooooo------------------------------------------------------------------------------------------------------------------------------------------Eooo------------------------------------------------------------------------------------------------------------------------------------------------------------------------------------------------------------SSS---E----------------------------------------------------------------------------------------------oooo-------------------------------------------------------------------------------------------------------------------------------------------------------------------------------------------------------------Eooo---------------------------------------------------------------------------------------------------------------------------------------------------------------------------------------------------XXXXXXX-------------------------------------------------------------------------------------------------------------------------------------------------------------------------------------------------------------------------------------------------------------------------------------------------------------------------------------------------------------------------------------------------------------------------------------------------------------------------------------------------------------------------oo-----------
---------------------------S------SSSQS-----ooo----oo---------------E--S---------------------------------QQQQQ-----------XXX-------------------------XXX-------------------------------------------------------SSSSSSSSSSSS---SS---------------------XX-----------------------XXXXX------S------------------SSS----------------QS-----------------------------------XXX----------------------------SSS-------S----QQQQQ-----------------------------------SSS----------SSS--------------------SS---SS-----------------SS--------------------------------------------------------S-----?-----XXoo-----XX--------------------------------------------E------------------------------E-----o?----------------------------------------------------------------------------------------------S-------ES-------------o----XXXXX------------------------------SSSSSXX-------------------------------------------S---QQQQ-----------------------------------S------------------QQ------------------S--S-XXX---------------------------------------------------------------------------------------o-----------------------------------------------------------XXX---------------------------------------------------SSS--------S--------------------SSS-SSS------------------SSSSSS------SS---SS---------S---SSS----------------------------QSQQ-------------Q-Q-------------------SQQ----------------------------------XXX--------------------SSSSSSSSS----------------------------------SS--------------------------------------------------------S-------------o------o------
-------------------------------------------------------------------<>----------------------------------------------XXX---------------------------------------------------------------------------------------------------------------------------------------oo-----------------------------------------XS-XX------------------------------------------------------XXXX-----------------------------------------------------------------------------------------------------------------------SS---SS-----------------S-----------------------------------oooo---------------------------------------------o--------------------------------------<>-----------X-----------------------------------------------------------------------------------------------------------------------------------SSSS-------XX----------o---------------------------------XX-----------------------------------------------------------------------------------------------------------------------------------------------------------------------ooooo------------ooo--------------------------------------------------------------------------------------------XXXX-------------------------oooo------------oooo--------------------------------------SS-----------------------------------------------------------------------------------------------------------------------------------------------------------------XXXX----------------------------------------E--------------------------E---------------------------------------------------------------------------------
-------------------------------------------------------------------[]------------------------------------------------------------------------------------o--------------------------------------------------------------------------------------------------------------------------------------------EXX---X-------X----------------------------------------------XXXX----Q----------------------------XX-----------------------------------------------------X--E---------------------------SS----S-----------------S------------------XX--------------------------------------------------------------EoX--------------------------------------[]-----------------------------------------------------------------------------------------------------------------------------------------------XX-------------------XXXX------------------------------XXXX----------------------------------------------------------------------------------------------------------------------E-------------------------------------------------------------------------------------E-------------------------------------------------------------------------EXXXX-----------------------------------------------------------------------------------SS--------------------------------------E------------------E------------------------------------------------------------------------------------------------------XXXXX-------------------------------------XXXXXXXXX-------------------------------------------------------------------------------------------------------
-------------------------E-------------------------------oo--------[]-----------E-----??------------------------Q-----XX-----------S--------------------------------------------------E------------------------------------------------------------------X--------o-----------------------------------XXXS---------------------------------------S---------------XXXXXX---------------------------------XX----------------oooo---------------------E----------XX-<>---------------------E---X--So??-S-----oo----------SS-----------------XX-------------E------------------oo-------------------------------S-------------------------------------[]---------------------------o----------------------------E-------------E-S--------E-------E-E-----E-----------------E-----------X--------------XXXSS-----------------------XX---------------------E-EXEXXXX--------------------o--XX----------------------------------o----------------E--o-------------------------------------<>-----------------------------------------------------------------------------E---E--<>----------------------------------------------------------o---oo---------XXXX----o----S------------------------------E----------------------X--------------------SS---oo---------------------------------------------------<>-------------------------------------------------------------------------------------------------E--XXXXXXX--------------------E---------------------------------------E-----------------------E-----E---S---------------------------------E--------------------
-----------------E------<>------XXXX--XXXXXX----XX----XX----------SXXS---------<>-----?--SSSSSSS----------QQQQ--------------------X-------------------SSSS-----------------------S---<>-------------------------X--X-----S------------------------------XXX--Q-------------------SSSS---oooo------EXX-XXX--XX-----------QQ-----SS------------E-------------------XXXXXX--SS-------------XX--X----SS-----SX--------?SQSQQ---------------------E----<>---------XXX-[]--------------------<>---X--SSS--SS---E------------SS-------------XX-----E----------<>-----<>------E---o-----XXX--------XX---XXXXXXXXX------E---------E--S---------------X-------SSQQ----E--------XX-------------XXXXXXXX---------------<>---S-------E<>----E----<>---E--<>[]----<>----------------<>----------XX------S-----XXXXX----------X--XXXX------------XXXXXXX-------QQQ-----XX-XXX---S-------------------------XXXXXXX---------QQSSSSQS----------------------<>--------------SS-------E------S-S----E--[]--------XXXX------------X--------QQ--QQQ------E-----------------------------<>--<>--[]------------------S----X------------------------------<>----------------XXXXX-----------------QQQQ------------------<>-----E----S----------XX---S-------XX--X--------SSS------------E--S-E-------------SSSSSS--S------SS---[]---S----------------------SSQ----------------Q-Q------------QQQ----SS------------------------------XXXXXXXX-------------------<>------E----------------------------E--<>---EQQ-------E-----E--<>----<>--------------S--S------------------<>-----E--XXXX---XX---
----------------<>------[]----------------------------------------------E------[]---------SSSSSS---SS-SS-------------------------XX--SS--S-------------------------------------------[]----------E------------X-X--XX--------------------------E------EXXX--E------------------------------------XXXXXXXX--XX-------------------------------<>------------------XXXXXXX----------------XXX--XX----------X-----------------------------------<>----[]--------XXXX-[]--------------------[]------------------------------------------EXXX--XX<>----------[]-----[]----------------------------------------------<>----E---<>-----------------XX--------------<>------------o---------------------------------[]----------<>[]---<>----[]---E--[][]----[]----------------[]--E------XXX-----------EXXXXXX--------XX--------------------------------------XXXX-XXX---------X-----------------------------------------------------------------[]----XXX----E----------<>------------<>--[]------------------------X-------------------E<>-----------------------------[]--[]--XX-----------------------X-----------------------E-E----[]---------------XXXXXX---------------------------------X-----[]----<>--------------XXX----------XXX--XX---------------------<>----------E---------------------------[]------------------------E-------------------------------------------------------------------------XXXXXXXXX-------------------[]----E-----------------------------<>--[]------------<>----<>--[]----[]----------------------------EX------[]----<>--------------
----------------[]------[]---------------------------------------------<>------[]--------SSSSSSS---SS-S-------------------------XXX--XXXX--------------------------------------------[]---------<>-----------XXXX--XXX---------X--------------<>-----XXXXX--------------------------------------oXXXXXXXX--X--------------------------------[]------------<>-XXXXXXXXXX---------------XXXX--XXX-------XXS-----------------------------------[]----[]----<>-XXXXX-[]--------------------[]---------------<>------------------------XXXXX--XX[]------X---[]-----[]----------------------------------------------[]--------[]-----------------XX--------------[]------X----XXXXX------------------------------[]----------[][]---[]----[]--<>--[][]----[]----------------[]-<>-----XXXX----------XXXXXXX--------XXX-------------------------------------XXXXX-XXX--------XX-----------------------------------------------------------------[]----XXX---------------[]------------[]--[]--------------------X---X------------------<>[]-----------------------------[]--[]-----------------------X---X---------<>-----------<>------[]-----------<>-XXXXXXX-------X-------------------------X-----[]----[]----------<>-XXXX--------XXXXX--XXXX-------------------[]--------------------------------------[]-----------------------<>------------------------------------------------------------------------XXXXXXXXXX-------------------[]---<>-----------------------------[]--[]------------[]----[]--[]----[]----------------------------XX------[]----[]--------------
-----EE-E--E----[]---E--[]--XXX----------------------------------------[]--E-E-[]-----oooSSSSSSooSSS--SS--------------o--------XXXX--XXXX----------------------------------E--E-EE---[]-------E-[]-----E----XXXXXE-XXXX-------XX---------E----[]----XXXXXX------------------------------E------XXXXXXXXXX--X------XX-------EE---------------[]-E--------E-[]XXXX-XXXXXX--------------XXXXX--XXX--EE--XXXXS---------------------------E-EE---[]-E--[]-E--[]XXXXXX-[]---------E----------[]-E----E-E------[]--------E---------------XXXXX--XX[]------X---[]---E-[]--------------X--------------ooo---------XXX--[]--------[]--------------EE-XX-------E------[]------X-------------------------XXX-E---------[]--E-E-E-E-[][]---[]----[]--[]--[][]----[]-----EE-E-E--E--[]-[]----XXXXX---------XXXXXXXXS-SS?S--XXX------------------------------------XXXXXX-XXX---EE-XXXX----------------------------S----------------X----------E-E------[]----XXX------------E--[]------------[]--[]-----ooo------------X---X-E----------------[][]--------------------------E--[]--[]-------EE-E-E----------E---X---------[]-----------[]---E--[]-----------[]-XXXXXXX------XX-------------------------X--E--[]-E--[]----------[]XXXXX-------XXXXXX--XXXX---E-----------E-E-[]------------------E----------E---E----[]-------EE--------------[]--------------------------------E----EE-E-------------------E----------XXXXXXXXXXX---E----X---EE-E---[]---[]-----E--------------------EE-XX--[]-----EE-E---[]-E--[]--[]----[]----------EE---------------XXX--E---[]----[]oo------------
XXXXXXXXXXXXXXXXXXXXXXXXXXXXXX--------------------------XXXXXXXXXXXXXXXXXXXXXXXXXXXXXXXXXXXXXXXXXXXXXXXX-XXXXXXXXXX---XXX---XXXoXXXXXXXXXXXXX--------XXXX---XX---XXXXXXXXXXXXXXXXXXXXXXXXXXXXXXXXXXXXXXXXXXXXXXXX--XXXXXXXXXXXXXXXXXXXXXXXXXXXXXXXXXXXXXX---XXXXX-XXXXXXXX--XXXX-XXXX---XXXXXXXXXXXXXXXXXXXXXXX-XXXXX---XXXXXXXXXXXXXXXXXXXXXXXXX-X-XX--XXXXXXXXXXXXXXXXXXXXXXXXXXXXXXXXXX-XXXXXXXXXXXXXX---XXXXXXXXXXXXXXXXXXXXXXXXXXXXXXXXXXXXXXXXXXXXXXXXXXXX-XXXXXXXXXXXXXXXXXXXXXXXXXXXX-XXXXXXXXXXXXXXXXXXXXXXXXXXXXXXXXXXXXXXXXX--XXXXXXXXXXXXXXXXXXXXXXXXXXXXXXXXXXXXXXX-------------XX-------------XXXXXXXXXXXXXXXXXXXXXXXXX---XXXXXXXXXXXXXXXXXXXXXXXXXXXX--------------X--------XXXX-XXXXXXXXXXXXXXXXXXXXXXXXXXXXXXXXXXXXXXXXXXXXXXXXXXXXXXXXXXXXXXXXXXXXXXXXXXXXXXXXXXXXXXXXXXXXXXXXXXXX-S--Q-ESXXXX------------------------------X-XXXXXXXXXX-XXXXXXXXXXXXXXXX--XXXX-------------------X----XXXXXXXXXXXXXXXXXXXXXXXXXXXXXXXXXXX-XXXXXXXXXXXXXXXXXXXXXXXXXXXXXXXXX-XXXXXXX-X-XXXX-----XXXXXXXXXXXX--X---XXXXXXXXXXXXXXXXXXXXXXXXXX-XXXXXXX--XXXXXXXXXXX--XXXXXXXXXXXXXXXXXXXXXXXXXXXXXXXXXXXXXXXXXXXXXXXXXXXXXXXXXXXXXXXXXXXX---XXXXXXXXXXXXXXXXXXXXXXXXXXXXXXXXXXX--XXXXXXXXXXXXXXXXXXXXXXXXXXXXXXXXXXXXXXXXXXXXXXXXXXXXXXXXXXXXXXXXXXXX-X-XXXXXXXXXXXXXXXXXXXXXXXXXXXXXXXXXXXXXXXXXXXXXXXXXXXXXXXXXXXXXXXXXXXXXXXXXXXXXX--XX----XXXXXXXXXXXXXXXXXXXXXXXXXXXXXXXXXXXXX-XXXXXXX--XXXXXXXXXXXXXXXXXXXXXXXXXXXXXXXX-XXXXXXXXXXXXXXXXXXXXXXXXX-X--XXXXX---XXXXXXXXXXXXXXXXXXXXXXXXXXXXXXXXXXXXXXXXXXXXXX---XXXXXXXXXXXXXXXXXXXXXXXX--XXXXXXXXXXXXXX------------