------------------------------------------------------------------------------------------------------------------------------------------------------------------------------------------------------------------------------------------------------------------------------------------------------------------------------------------------------------------------------------------------------------------------------------------------------------------------------------------------------------------------------------------------------------------------------------------------------------------------------------------------------------------------------------------------------------------------------------------------------------------------------------------------------------------------------------------------------------------------------------------------------------------------------------------------------------------------------------------------------------------------------------------------------------------------------------------------------------------------------------------------------------------------------------------------------------------------------------------------------------------------------------------------------------------------------------------------------------------------------------------------------------------------------------------------------------------------------------------------------------------------------------------------------------------------
-----------------------------------------------------------------------------------------------------------------------------------------------------------------------------------------------------------------------------------------------------------------------------------------------------------------------------------------------------------------------------------------------------------------------------------------------------------------------------------------------------------------------------------------------------------------------------------------------------------------------------------------------------------------------------------------------------------------------------------------------------------------------------------------------------------------?-S----------------------------------------------------------------------------------------------------------------------------------------------------------------------------------------------------------------------------------------------------------------------------------------------------------------------------------------------------------------------------------------------------------------------------------------------------------------------------------------------------------------------------------------------------------------------------------------------------------------------------------------------------------------------------------------------------------------------------------------------------
--------------------------------------------------------SSSSSSSS------------SSSSSSSS--------------------------------------------------------SSSSSSSSSSSSSSSSSSSSSSSSSSSS--------------------------------------------------------------------------------------------------------------------------------------------------------------------------------------------------------------------------------------------------------------------------------------------------------------------SSSSSSSSSSSSSSSSSSSSSSSSSSSS-------------------oo-------------------------------------------------------------------------------------------------------------------------------------------------------------------------------------------------------------------------------------------------------------------SSSSS-----S-------------SSSS------------------------------------------------------------oo----------------------S-----------------E----------------------------------------------------------------------------------------------------------------------------------------------------------S-S--------------------------------------------------------------------------------------------------------------------------------------------------------------------------------------------------------------------------------------------------------------------------------------------------------------------------------------------------------------------------------------------------------------------------------------------------------
--------------------------------------------------------------------------------------------------------------------------------------------------------------SS--SSSSSS--------------------------o----XXXX-------------------------------------------------------------------------------------------------------------------------------------------------------------------------------------------------------------------------------------------------------------------------------------------------------------------------------XXXX------------------------------------------------------------------------------------------------------------------------------------------------------------------------------------------------------------------------------------------------------------------SSSS-----Q--------?----oooo------------------------------------------------------------XXXX---------------------------------------?-------oS-------------------------------------------------------------------------------------------------------------------------------------------------------------------------------------------------------------------XXXX-------------------------------------------------------------------------------------------------------------------------------------------------------------------------------------------------------------------------------------------------------------------------------------------------------------------------------------------------------------------------------------
-------------oo-----------------------------------------------------------------------E-----------------------------------------------------------------------SS--SSSSSS------------------------------------------------------------E-------------------------------------------------------------oooooooo-oo------------------E------------------------------------------------------------------------X-------------------------------------------------------------------------------------------------------------------------------------------------------------------------------------------------------------------------------------------------E-----------------------------------------------------------------------------------------------------------------------------------------------------SSSS--EE-------------------S------------------------------------------------------X--------------------------------------------------------S--------------------------------------------------------------------oo-----------------------------------------------------------------------------E--------------------------------oo--------------------------------------------------------------------------------------------------------E---------------------E------------------------------------------------------------------------------------------------------------------------------------------------------------------------------------------------------------------------------EE-------------------------------------------------------
E----oo---XX------------------------------------------XX------------------------------o--E-----------------------------------------------------------------------SSSSSSS--SSQ------------S------SSSS-------------------------------SQS-----QQQQQ------------S-SS--------------------------------XXX----------------------------QS--SSSS---------SS---SS--------------XX------------------------------------SSQ-----------S---------------------------------------------------------------------------S---------------------SS---?-?SSS------------------------SQQ---------------------------------------X---------S-------------------------------------SSSSSSSSSS-S----------------------------------------------------------------E-------------XXX-------------------------------------------------------------S---SS----S----S---SS---SS----------------------XXX-------------------E--------oo----------------------------------------------S---SS-----SSS-----------------------------------------------SSS---S-SSSQ------------------S-----SSQSS----------------SS---SS---------------------------------?---------E------o-----S---S----------------S-------oo---SQS----------XX------------------------------------SSQQ--SSS---------------------SQS---QQQQQ------------SSS-SSS-----------------SS--------SQQ------------------SSSSSQ-------SSSSS----SSSSS------------------------------SSSSS----------------?-------SSSSSS-------SSSSS----SSSSSSSSSS-S???S---------?--------------------------------SSQSS---SSS-----------------SSS----------------SSSSSSSS---S
----XX-----------------------------------------------XXX-----------------------------------XX--------------------------------------SS-----------------------------------------------------------SSS------------------------------------------------------------------------------------------------------------------------------------------------------------------X-----------XXX----o---o--------------S--------------------------------------------------------o---------------------------------S-------------------------------------------------------------------------------------------------X--------------------------------------------------------------------------------------------------------------------------<>-----------------------------------------------------------------------------SS--SS----S--------SS-------------E------------------------oo-----o----------------------------------------------------------------SS------------------------------------------------------------------------------SS-------------------------------------------oooo---------------------------XXX---------------------------------oo------------------------------X---------------------------------------------------E--------------------------------------SS-----------------------------------------------oooo---------------------------------------------------------------------------------------------------------------------------------------------------------------------------SS------------------------------------------------------
----------------------------------------------------XXXX--------------------------------XX---------------------------------------XXSo-----------------------------------------------------S-----SS-------------------------------------------------------------------------------------------------------------------------------------------------------------------XX--------E---XX-XXXXXXXX-----------S-S------------------------X------------------------------XXX-------------------------------SS------------------------------------------------------------------------------------------------XX------------------------------------------------------------------------------------------------------------E-------------[]------------------------------------------------------------------------X----SS--SS----S-SS-S---SS------------<>----------------------------XXXXX-------X---S---------------------------------------------------SS----------------------------E-----------------------------------------------------------------------------------------------------------------------------o-------------------------------------E-------------S-------o------XX--------------------------------------------------<>--------------------------------------SS----------------------<>---------------------------------------------------------------------------------------------------------------------------------------------------------oo-------------------------------------------S-------------------------------------------------------
---------------------------------------------------XXXXX---------SSS--------------------XX--oo-----------------------oo---------XXX-------------------------o-----------------------------S-----SS--------------------------------------------------------------------------------------Q------------------------oo---------------------------E----------------------XX------------------------------------SoS----------------------X----------------------------------------------------------------SS------E--------ooS-------------------------------------------------E--?-------------------------XXX-----------------E---------E-E----------E----------------------------------------------XXXX------------E--<>-----------E-[]---------E--------------------------------------------------------------XX-ooSS---So??-So??-So----------------[]-------------E--------------------------X--------------------------S------------------------??-SSS--E------------------------------S--------E--S----------S-S-S---------------------SSSSSSS---------------------SSSSSSS----E-------------------o----------------------------------------------E--<>SSSSSS-S--------------------XX---------------------E----------X-----------------[]-------S-S----------------------------SS----------------------[]---------------------E-------------------E-EE---------------------------------------------------ooo-------------------------------------------------------E-------------------------------------------S-----S--------------S---------------------------------X
-------XXXX---------------------------------------XXXXXX------------------------------XXXX-------S-----------------------------XXXX-------------XXX--X---------S-------X---SS------------SS-----SSS?----------------------------X------QQ--E?SQQ----------------------SS--------------------------XXXX-------------------------Q---SS--------<>--Q---SS----------X--XXX--SS-o----------------------XX-----ESSS-----------QQ---------X-------------------------------------------S---------------S--------E--<>-------oE-------SQS---S----X-----------------QQ?SSQQS------<>---Q-----------------------XXX---------SSS--SS---EX--X---<>-----------<>----------------------------E--------------SS----------------<>--[]----------<>-XXX-------<>------XXX-----------Q--------ooo----S-----------------------XXXX-SSSS---SSS--SSS--S----X---XX-------XXX-<>--------<>----------XXX------------XX--------------------E------------------------------S--SS--oSSS------------E--------S?S-------E----<>-----E--S-------------S?S-----XX----------------SSSS-------------------------<>------E------E-------S------SSSSSSS----E--X-----XX------?SSS-----<>--[]-------------XXX--SSS-------XX--------Q-----------<>---------XXX---SSS----------[]------------E---E----S?SQS----E-------SS--S?SSS--------S------[]SS--Q---SQS---SS-E-E<>-----E----SSQS-----XX--XX-XX----S----QQQ----------------------E---S?S-----------XXXX--SS--------------------Q----SSS------?SSSSSSS?SSSS---XX------oo---------------------E?QQQQ?S---SSSS------------------XX----------E-----SS--------XX
-----------------XX--XX--------------------E-----XXXXXXX------------------------------XXXX------------------------------------XXXXX-----------XXXXX--X----------------------------X---------------E-----------------------------S----------------------------------------------------------E-----------E-------------------------------------[]------------------X-XXXX-----E-XX---------------X---XX-------------------------------X-------------------------------------------------------------------<>--[]------------------------E--X--XX---------------------------[]----------XXXXX-----------XXXX-----------------E--X--XX--[]-----------[]---------------------------<>--------------SS----------------[]--[]----------[]--------E--[]-----------------------------------E-----------------------XXXXX-----------------------E-E-XX-----------[]--------[]------XXX---------------XXX-------------------<>----------E-----------XX------------EE--X-----------<>-----------------<>----[]----<>------------------------XX---------------------------------------------[]-----<>-----<>-E-E----------SSS?------<>-------------------------[]--[]----------XX-E-------------XXX--------------------[]--------XXXX-------------------------E---<>---E------------<>---------------------------XX----SS--------------<><>[]----<>----E------XXXX--XX-XX---------------------------------<>------------------------------------------------------------SSSSSS--?SSS------------------------------------------------------------------XXX---------<>--------E-----XXX
--o-------------XXX--XXXX-----------------<>----XXXXXXXX----------------------------XXXXXX----------------------------------XXXXXXX----------XXXXXX--XX--------------------------XXX---X----------------------------------------S---------------------------------------------------------<>----------<>-------------------------------------[]------------------XXXXXX-----XXXX----------E----X---XX-------------------------------X--------------X-X--------------------------------------------------[]--[]---------------------------X--XX--------<>-----------------[]------------------------XXXXXX--------------------X--XXXX[]-----------[]---------------------------[]--------------SS----------------[]--[]----------[]-------<>--[]-----------------------------------------------------------XXXXX-----------------------XX--XX-----------[]--------[]-----X-XX----------E-E--XXX-------------------[]---------<>-----------XXX---------------X-----------[]-----------------[]----[]----[]-----------------------XXX---X-----------------------------------------[]-----[]-----[]<>------------SSS-------[]-------------------------[]--[]----------XX---------------XXX--------------------[]----<>-XXXXX------------------------<>---[]--<>------------[]---------------------------XXX---SS--------------[][][]----[]----------XXXXX--XX-XXX--------------------------------[]----------------------------X-------------------------------SSSSSSS-SSSS--------------------------------------------------------------<>-XXXX---------[]-------------XXXX
-XXXXoo--------XXXXE-XXXX-----------EE----[]---XXXXXXXXX----------------------------XXXXXX------E-----EE--------------------XXXXXXX---------XXXXXXX--XX---------EE--------------XXXX-E-X------------------E-E-----EE------------S-----------E-----------EE-E----------------------EE-E----[]----------[]-----------------E------E---------E--[]-E------------E---XXXXXX-------XX---------------X---XXXX--E--------------------EE----X----------E-E-X---------X---------------------------------------E--[]--[]---------------------------X--XX--------[]-E-EE-------E----[]------------------------XXXXXX----------------E---XE-XXXX[]-EE--E--E--[]----------EE----------EE-E-[]-------------E------------EE-E--[]--[]--------E-[]-------[]--[]------------E-E--E------------------------EE-E-------EE---XXXXXX---EE------------------X---XX-------E---[]--E--E--[]-----XXXX---------------XXX---------EE-E------[]---------[]-----------XXXE----E---------X-----------[]-----------------[]----[]----[]-E--------------------X-X----X----EE-----E---------E-E----------E---E--[]---E-[]-----[][]-----------E----oo----[]-------------E--------E--[]--[]---------XX----------------XXX------------EE------[]----[]XXXXXX-E--------------------E-[]---[]--[]------------[]-----E-E--E-------E-E------XXXX-E--------------E-[][][]----[]-E-------XXXXXX--X--XXX-----------E-EE-E---------------[]---------------------------XX-------------------------------SSSSSSSoo-SS------------------------------------------E-E-------E---------[]XXXXX---EE-E--[]------------XXXXX
----XXX-------XXXXXXXXXXXX--XXX-XX-XXXX-XXXXXXXXXXXXXXXXXXXXXXXXXXXXXXXXXXXXXXXXXXXXXXXXX--XXXXXXXXXXXXXXXXXXXXXXXXXXXXXXXXXXXXXXX----X-XXXXXXXXXXX--XXXXXXXXXXXXXXXXXXXX-XXXXXXXXXXXXXXXXXXXXXXXXXXXXXXXXXXXXXXXXXXXXXXXXX----X--XXXXXXXXXXXXXXXXXXXXXXXXXXX----XXXXXXX-----XXXXXXXXXX-XXXXXXXX-X--XXXXXXXXXXXX----XXXXXXXXXXXXXXXXXXXXXXXXXXXXXXXXXXXXXXX-XXXXXXXXXXXXXXXXXS-------X-XX-X-XX-XX--XXXXXXXXXXXXXXXXXXXXXXXXXXXXXXXXXX-XXXXXXXXXXX-XXXXXXXXXXXXXXXXXXXXXXXXXXXXXXXXXXXXXX---XXXX--XXXXXXXXXX-XXX---XXXXXXXXXXXXXXXXXXXX---X-XXXXXXXXXXXXXXXXXXXXXXXXXXXXXXXXXXXXXXXXX-----XXXXX-XXXXXXXXXX--XXXXXXXXXXXXXXXXXXXXXXXXXXXXXXXXXXXXXXXXXXXXXXXXXXXXXXXXXXXXXXXXXXXXXXXXXXXXXXXXXXXXX----XXXXXXXXXXX-XXX-XXXXXXXXXXXXXXXXXXXXXXXXXXXXXXXXXX--XXXXXXXXXXXXXXXXXXXXXXXXXXXXXXXXXXXXXXXXXXXXXXXXXXXXXX--XXXXXXXXXXXXXXXXXXXXXXXXXXXX--XXXXXXXXXXXXXXXXXXXXXXXXXXXXX------X-XX-X-XX-XXXXXXXXXXXXXXXXXXXXXXXXXXXXXXXXXXXXX-XXXXXXXXXXXXXXXXXXXXXXXXXXXXXXXXXXXXXXXXXXXXXXXXXXXXXXXXXXXXXXXXXXXXXXXXXXXXXXX---XXXXXXXXXXXXXXXo-XXXXXXXXXXXXXXXXXXXXXXXXXXXXXXXXXXXXXXXXX-XXXXXXXXXXXXXXXXXXXXXXXXX-XXXXXXXXXXXXXXXXXXX---XXX---XXXXXXXXXXXXXXXXXXXX---XXXXXXXX-------XXX-XXXXXXXXXXXXXXXXXXXXXXXXXXXXXXXXXXXXXXXXX-XXXXXXXXXXXXXXXXXXXXXXXXXXXXXXXXXXXXXXXXXXXXXXXXXXXXXXXXXXXXXXXXXXXXXXX--XXXXXXXXXXXXXXXXXXXXXXXXXXXXXXXX-X-XXXXXXXXXXXXXXXXo--XX-XXXXXXXXXXXXXXXXXXXXXXXX-XXXXXXXXXXXXXXXXXXXXXXX---XXX-----XXXX-XXXXXXXXXXXXXXXXXXXXXXXXXXXXXXXXXXXXXXXXXXXX--------XXXXXXXXXXXXXXXXXXXXXXXXXXXXXXXXXXXXXXXXXXXXXXXXXXXXXXXXXXXXXX-XXXXXXXXXXXXXXXXXXXXXXXXXXX