------------------------------------------------------------------------------------------------------------------------------------------------------------------------------------------------------------------------------------------------------------------------------------------------------------------------------------------------------------------------------------------------------------------------------------------------------------------------------------------------------------------------------------------------------------------------------------------------------------------------------------------------------------------------------------------------------------------------------------------------------------------------------------------------------------------------------------------------------------------------------------------------------------------------------------------------------------------------------------------------------------------------------------------------------------------------------------------------------------------------------------------------------------------------------------------------------------------------------------------------------------------------------------------------------------------------------------------------------------------------------------------------------------------------------------------------------------------------------------------------------------------------------------------------------------------------
--------------------------------------------------------------------------------------------------------------------------------------------------------------------------------------------------------------------------------------------------------------------------------------------------------------------------------------------------------------------------------------------------------------------------------------------------------------------------------------------------------------------------------------------------------------------------------------------------------------------------------------------------------------------------------------------------------------------------------------------------------------------------------------------------------------------------------------------------------------------------------------------------------------------------------------------------X-----------------------------------------------------------------------X---------------------------------------------------------------------------------------------------------------------------------------------------------------------------------------------------------------------------------------------------------------------------------------------------------------------------------------------------------------------------------------------------------------------------------------------------------------------------------------------------------------------------------------------
------------------------------------------------------------------------------------SSSSSSSSSSSSSSSSSSSSSSSSSSSS------------------------------------------------------------oo----------------------------------------------------------------------------------------------------------------------------------------------------------------------------------------------------------------------------------------------------------------------------------------------------------------------------------------------------------------------------------------------------------------------------------------------------------------------------------------------------------------------------------------------------------------oo--------------------------------------------------------------------------------------------SSSSSSSSSSSSSSSSSSSSSSSSSSSS--------------------------------------------------------SSSSSSSSSSSSSSSS-----------S-----------------------------------------------------------o----------------------------------------------------------------------------------------------------------------------------------------------------------------------------------------------------------------------------------------------------------------------------------------------------------------------------------------------------------------------------------------------------SSSSSSSSSSSSSSSSSSSSSSSSSSSS-----ooo-----------------------------------------------------ooo--------------------SSSSSSSSSSSSSSSSSSSSSS-----S
---------------------------------------------------------------------------------------SS------?oS--SSSSS?-SSSSS-------------------------------------------------------------X----------------------------------------------------------------------------------------------------------------------------------------------------------------------------------------------------------------------------------------------------------------------------------------------------------------------------------------------o-----------------------------X-------------------------------------------------------------------------------------------------------------------------------------------------------------------------------?----X-------------------------o-----------------------------------------------------------------------------------------------------------------------------------------------------------------------------------------------------------------------------------------------------------------------------------------------------------------------------------------------------------------------------------------------------------------------------------------------------------------------------------------------------------------------------------------------------------------------------------------------------------------------------------------------------------------------------------XXXX----------------------------------------------------XXXX-----------------------------------------------
XX-------------------------------------------------------------------------------------S-------?SS--SSSSS--SSSSS-------------------------------------------------------------------XXX--------------------------------------------------------------------------------------------------------------------------------------------------------------------------E-----------------------------------------------------------------------------------------------------------------------------------------------------------------------------------------------------------------------------------------------------------------------XXX----------------------------------------------------------------------------------------Eooo----------------o------------------------------------------------------------------------------------------------------------------------------------------------------------------------------------------------------------------------------------------------------------------------------------------------oo--oo---------------------------------------------------------------------------------------------------------------------------------------------------------------------------------------------------------E------------------------------------------------------Eooo--------------------------------------------------------------------------------------------------------------------------------------------------------------------------------------------------------------------------------------
----SSQS---QQ--------------------------------------XXX--XX---------------------------------------------SS---S--------------------------------------S-------------X----------------------------------S-----------------------SSSSSSS-------SS--------Q-Q-Q----------------------------------------------------------------S-----QQQQQ-----------------------X----E--E------------------------S------------------------------------------------SS-----------------SS------------------------------------------XX----------S?SSS-----------SSSSSSS------------------------------------------------------------------------------SSSSSS------------------E----------------S--------------S-------------------------SSSSS---------------XXXXX-------------------------------SSS----SSS-----------------------------------SSSSSS---------------------------------------S-----------------------------------SSS--SS??--S--SSSS-------------------------------------------------------------------S?-----------------SSS-------XXX-----------------------------------------------------------------------------------------------S--------SS-S----SS-------------------S--SS---Q---oo--------S-S--------------QQQQ-------------------------SSS---SS---------SSS--------E----SSSS?S---------------------------------------------XXX----XXXXX----o---SSS------SSSSSSSSSSSSSSSSQ?SS------?SSS-------------------------------------E---S-------------------------------------------------------S----------------XX------------------------------------------------------------------
--------------------------------------------------XXXX-------------------------------------------------SS---S-----------oooo--------------------------------------X----------------------oooo----------------------------------------------------------------------ooo--------------------------------------------------------------------------XXX---------------XXXXXX-----------------------E--------------oooo----------------------------------------------------------ooo-----------------------------XXX-------------------------------------------------------------------------------------------------------------------------------------<>------------------------------------------------------------------------XX-----------------------------------------------------------------------------------------------------------------------------------------------ooo------------------------SS--------------------------------------------------------oo----------------------------------------------------------o---o----------------------------SS-----------------------------------------------------------------E--------------------------S--SS------------------------------------------------------------------------------------------<>---------XXXXX--------------------------------------------------------XX---------------------------------------------------------------------------------------------------------------------------------oooo----------------------XXX-S----------------------------------------------------------------
XX-----------------------------------------------X-XXX----------------oo-------------------------------SS--------------------------------------------------------XX-----------------------------------------------E-------------------------------------------------------------------XX------------------------------------------------------------------------------------------------------<>-----------------------------------------------------------------------------------------------------------XXXX------------------------------------------------------------------------------------------------------------------------------------<[]-----------------------------------------------------------------------------------------------------------E----------------------------------------------------------------------------------------------------------------------------------------SS-------------------------------------------------------------------------------------------------SS---------------XXXX-XXX------XS------------------X--------------------------------------------------------------------S-------------------------o--SS---S-------------------------------------------X-------------------------------------X----[]------------------------------------------XX-------------------------------S------------------------------------------------------------------------------------------------------------------------------------------------------XXXXX-----------------------------------------------------------------
SX----------------oooo--------o----o-------------X-XXX--------------------------oo-------------------SoS----oo??------------------------------------------------XXX--------------------E-------------------S-----<>------------------------------------------------------------------XXX--------------oo--------------------------------------------------------------------S--------E-------E[]------------E-------E------------------E---------------S------------------E------------oo----SSSSSS-------XXXXX---------S---------------------------SS----------S------------------E---------------------------------------------------------------[]X----------------------------------------o---------------------------------------------------------S-------<>-----------------------------------------------------------------------------------------------S------------------------E---------?oooo--S---------------------------------------oo--------------------------S-----------------------------SS----------------------------XXS------------------XSS-SQ-------------------------S------------E-------ooo-------------SS----S---------------XS----?oSQ---SoS----------------------------------------XX---------------------------oo-------XX----[]--------------------E--------------------XXX-----o----------------------------------XS---------E--------------------------------------------S----------E--o--------------------------------------------E-----S-------------------XXXXXX---------------------------------------E-------------------------
SX------Q?SSQQQ--------------------------------X-X-XXX---------XXXXXXX-----------------S-------XX----SSS----SSS?--------------------------------XXXXX----------X-XX-----QQQQ----------<>------------SS--------E--[]-------------S--SQQ--QS?S----E-----Q-Q-oo------------------------X-XX-----------E--------------S-S------QQ?-SQSQQ------------------------XXXX---------------E----<>---E--<>[]-----------<>------<>------------<>---<>------S------E-----------S---S---<>----XXX----o------------------XXXXX-------------E---E--S-----SQS------------------------E--S-----------<>-------------S----E-------SSS-----------QQ?SSSQS---------------XXX----------E-------------------------X----E-----------E---SQ---------XX------XX---------XX--X---------E----[]-----ES----------X------------------E-E--------<>---SS-----S-----------------------E------Q---------SS-----------------<>---E--XXX--SSS--SS-----------------XX--XXX----------------------------------------E----E--S------------EXX-X--------------------XXX-----------XXXX------------------XXX--------------------------------E--S------------E---------------SS-----SSS-------------XXX-SSS-SSS---SSS---S------------------Q--QQ?SQSQS--S---XXX----S--QQQQ--Q----------ooo--------XXX-SSSXXX--XXX---------X---<>-----E-------------XXXX--------------XXXXX-SXX-------ESQS-----XX--XX----SSSSS--QQ-QQQQQQ----------------------------------E------<>-X--------------------------------------------<>----------S--------------XXXXXX---------SSS-------------?----------E-<>---------------------SSQS
SX---------------------------------------------X-X-XXX----------------------SS--------E------XXXX--X-----EE----------E------------------E----------------------XXXX-------------------[]----------------E----<>--[]------------X---------------<>-----------------------------E----XXXXX----------<>------E-E-E-----S---------------------------------------------------------<>----[]--<>--[][]----<>-----[]------[]------------[]---[]------------<>-------------------[]---XXXX-------E--------------XXXXXXX-------EX--<>--<>-----------------------E----------<>--------------[]-----------------<>----------------X---------------------------------------<>-----------------------XXXX-XXX----------<>-------------XXX----------------XXX--XX--S----<>----[]----------------XX-----------E-----<><>--------[]---------------------E-----------<>-----------------------------E-----[]--<>------------------------------XXX----------XXX-------------------------------<>---<>--------------XXX--XX--------E------------------------XXXX-----------------XXXX-------------------------------<>---------E----<>---------------X---------------------XXXX-SSS-----------------------------------------------XXXXX----S-----------------------------XXXX---------------------X---[]------------------EXXXX------------------E-----------E------XXXX--XX-----------------------------------------------------<>------[]-XXX------o----------XXX----------------------[]--------XXS-------------XXXXXXX--------X-------E-----E-----------X---[]-------------------------
S----------------------------------------------X-X-XXX--------------XX------SS--------------XXXXX--XX---------------<>----------------X<>--------------XXXX----XXXX-------------------[]---------------<>----[]--[]-----------XX---------------[]----------------------------<>---XXXXXX----------[]-----<><><>-----X----------------------<>------XXXXX----------------------[]----[]--[]--[][]----[]-----[]------[]------------[]---[]------------[]-------------------[]--XXXXX---------------------XXXXXXXX-------XX--[]--[]-------------------X--<>----------[]--------------[]-----------------[]----------------X---X---------------------------<>------[]----------------------XXXXX---X----------[]------------XXXX---------------XXXX--XXX------[]----[]---------------XXX----------<>-----[][]--------[]-----SS--------------------------[]-----------------------------------[]--[]--E--------------------------XXXX--------------------------------------------[]---[]-------------XXXX--XXXX-----------------------------XXXXXX----------------XXXXX-------------------------------[]--------<>----[]-------------XXX-------------------XXXXXX-SSS----------------------------------------------XXXXXXX---S---------------------------EXXXXX--SSS----------------X---[]----<>-----------XXXXXX------------X-----XXXX--oooo--------XXXXX--XXX----------------------------------------------------[]------[]--XX------XXXX--------------------------------[]-------XXX-------------XXXXXXXX--------X------<>---------------------[]-------------------------
X-------------------------------------------EE-X-X-XXX----XXX---------------SS----------E--XXXXXX--X----------------[]-----------EE--XX[]-E---ooo--------------XXXX---------------EE--[]---------X-----[]----[]--[]----------XXX---------------[]-----------------E-EE-----E-[]--XXXXXXX---EE-E---[]-----[][][]-----S----------------------[]---------------------------------[]----[]--[]--[][]----[]--E--[]----E-[]--E---------[]---[]------------[]------E-E-E-E------[]--XXXXX---------X----------XXXXXXXXX--E---XXX--[]--[]---E--------------XX--[]----EE----[]-E---------E--[]----E-----E-EE---[]------E-E-------X-E-X---E-------X-----------E---[]---E--[]---E-----------------XXXXXX---S---E--E-E-[]-----------XXXXX---o-o--------XXXXX--XXXX-----[]----[]-----------EE-XXXX----------[]---E-[][]--------[]--------E--EE-E------E-EE-E-EE---[]---------E-EE-------------E-----E--[]--[]----------------------------XXXXX-------------------------EE------EE-E-------[]---[]-----EE-----XXXXX--XXXX----------------------------XXXXXXX--------------X-XXXXX---SSSS--------E-EE-----EE--E--[]-----E--[]-E--[]--------E----XXX-E--E-------E--EE-EXXXXXX-SSS--EE-----------------------X-----E-EE-------E-XXXXXX----S--------E------------------XXXXXX-----E---------------X---[]-E--[]----------XXXXXXX---------XXXXXX--------------------XXXXXX--XXXX-------------------------------------------E--E-E--[]--XX--[]--XX-----------------------------E-E-------E--[]------XXXXX-----------XXXXXXXXX---EE--XXEE----[]---------------------[]---------E-E-------------
X--XXXXXXXXXXXXXXXXXXXXXXXXXXXXXXXXX--X-XXXXXXXXXXXXXXXX--------------XXXX--XX-XXXX-XXXXXXXXXXXXoXXXXXXXXXXXXXXXXXXXXXXXXXXXXXXXXXXXXXXXXXX---XXX-----------XXXXXXXXXXXXXXXXXXXXXXXXXXXXXXXXXXXXXXXXXXXXXXXXXXX--XX--XXXXXXXXXXX---XXXXXXXXXXXXXXXXXXXXXXXX-XXXXXXXXXXXXXXXXXXXXXXXXXXXXXXXXXXXXXXXXXXXXXXXXXXXXXXXXX-XXXXXXXXXXXXXXXXXXXXXXXXXX----------------------------XXXXXXXXXXX-XXXXXXXXXXXXXXXXX--XXXXXXXXXXXXXXXXXXXXXXXXXXXXXXXXXXXXXXXXXXXXXXXXXXXXXXXXXXXXXXXXXXXXXX-XXXXXXXXXXXXXXXXXXXXXXXXXXXXXXXXXXXXXXXXXXXXXXXXXXXXXXXXXXXXXXXXXXXXXXXXXXXXXXXXXXXXXXXXXXXXXXXXXXXXXXXXXXXXXXXXXXXXXXXXXXXXXXXXXXXXXXXXXXXXXXXXXXX----X--XXXXXXXXXXXXXXXXXX-XXXXXXXXXXXXXXXXXXXXXXXXXXXX---XXXXXXXXXXXXXXXXXXXXXXXXXXXXXX--XXXX--XXXXXXXXXXXXXXXXXXXXXXXXXXXXXXXXXXXXXXXXXXXXXXXXXXXXXXXXXXXXXXXXXXXXXXXXXXXXXXXXXXXXXXXXXXXXXXXXXXXXXXXXXXXXXXXXXXXXXXXXXXXXXXXXXXXXXXXXXXXXXXXXXXXXXXXXXXXXXXXXXXXXXXXXXXXXXXXXXXXXXXXXXXXXXXX---X-X-----XXXXX---XXXXXXXXXXXXXXXXXXXXXXXXXXXXXXXXXXXXXXXXXXXXXXXXXXXXXXXXXXXXXX---XX----X-XX-X-XXXXXXXX----XXXXXXXXXXXXXXXXX-------XXXXXXXXXXXXXXXXXXXXXXXX-XXXXXXXXXXXXXXXXXXXXXXXXXXXXXXXXXXXXXXXXXXXXXXXXXXXXXXXXXX--SSXXXXXXXXXXXXXXXXXXXXXXXXXXXXXXXXXXXXXXXXXXXXXXXXXXXXXQ--XX-XXXXXXXXXXXX-XXXXXXXXXXXXXXXXXX------XXXX-----XXXXXXXXXXXXXXXXXXXXXXXXXXXXXXXXXXXXXXXXXX--XX-S----------------XXXXXXXXXXXXo--XXXXXXXXXXX--XXXXXXXXXXXXX---XXXXXXXXXXXXXXXXXXXXXXXXXXXXXXXX--XXX-XXXXXX-----------------X--XXXXXXXXXXXXXXXXXXXXXXXXXXXXXXXXX---XXXXXXXXXXXXXXXXXXXXXXXXXXXXXXXXXXXXXXXXXXXXXXXX---XXXXXXXXXXXXXXXXXXXXXXXXXXXXX