------------------------------------------------------------------------------------------------------------------------------------------------------------------------------------------------------------------------------------------------------------------------------------------------------------------------------------------------------------------------------------------------------------------------------------------------------------------------------------------------------------------------------------------------------------------------------------------------------------------------------------------------------------------------------------------------------------------------------------------------------------------------------------------------------------------------------------------------------------------------------------------------------------------------------------------------------------------------------------------------------------------------------------------------------------------------------------------------------------------------------------------------------------------------------------------------------------------------------------------------------------------------------------------------------------------------------------------------------------------------------------------------------------------------------------------------------------------------------------------------------------------------------------------------------------------------
------------------------------------------------------------------------------------------------------------------------------------------------------------------------------------------------------------------------------------------------------------------------------------------------------------------------------------------------------------------------------------------------------------------------------------------------------------------------------------------------------------------------------------------------------------------------------------------------------------------------------------------------------------------------------------------------------------------------------------------------------------------------------------------------------------------------------------------------------------------------------------------------------------------------------------------------------------------------------------------------------------------------------------------------------------------------------------------------------------------------------------------------------------------------------------------------------------------------------------------------------------------------------------------------------------------------------------------------------------------------------------------------------------------------------------------------------------------------------------------------------------------------------------------------------------------------
-----------------------------------------------------------------------------------------------------------------------------------------------------------------------------------------------------------------------------------------------------------------------------------------------------------------------ooo--------------------------------------------------------------------------------------------------------------------------------------------------------------------------------------------------------------------------------------------------------------------------------------oo--------------------------------------------------------------------------------------------------------------------------------------------------------------------------------------------------------------------------SSSS-----SS-ESS-----------------------------------------------------------------------------------------------------------------------------------------------------------------------------------------------------------------SSSSSSSSSS-------------------------------------------------------------------------------oo-------------------------oo------------------------------------------------------------------------------------------------------------------------------------------------------------------SSSSSSSSS----SSSSSSSSSSS-SSS------------------------------------------------------------------------------------SSSSSSSSSSS----SSSSSSSSSSSSS-----------------oo---------SSSSSSSSSSSSSSSSSSSSSSSSSSSS
-----------------------------------------------------------------------------------------------------------------------------------------------------------------------------------------------------------------------------------------------------------------------------------------------------------------------XXXX----------------------------------------------------o--------------------------------------------------------------------------------------------------------------------------------------------------------------------------------------------------------------------------------------------------------------------------------------------------------------------------------------------------------------------------------------------------------------------------------------------------------------SS-----Q------SS?-------oS--------------------------------------------------------------------------------------------------------------------------------------------------------------------------------------------------------------------------------------------------------------------------------------------XXXX-----------------------XXXX-----------------------------------------------------------------------------------------------------------------------------------------------------------------SS----S------SSSSSSS-----------------------------------------------------------------------------------------------------------SSSSSSSSSSSSS------------------------------SSSS--------------SSSS---S
-----------------------------------------------------------------------------------------------------------------------------------------------------------------------------------------------------------------------------------------------------------------------------------------------------------------------------------------------------------------------------------------------------------------------------------------------------------------------------------------------------------------------------------------------------------------------------------------------------------------------XXX-----------------------------------E----------------------------------oo--------------------------------------------------------------------------------------------------------------------------------------------SS--E----------S--------ES---------------------------------------------------------------------------------------------------------------------------------------------------------------------------------------------------------------------------------------------------------------------------------------------------------------------------------------------------------------------------------------------------------------------------E--E-------------------------------------------------------------SS----?------SSSSSSS-----------------------------------------------------------------------------------------------------------SSSSSSSSSSSSS--------oo------------------ESSSS---------------SSSS--E-
---------------------------S-----------------------------------------SQQSSSSSS-S-------------------SSQS---------------------------------------------------------------XX-------------------------------------------------XX---------------------------------SSSS----------SSSSSSS-------------------------------------------------------------------S-----------------------SSSS--------X------?SSS--------------------------Q-QQ------------------SQS-----S--SS-----------SSS--SSSS----------------------------------------------------XX-------------------------------------S----S-SSSSSSSS------------------------------------------------------------SSSSS--------------------SSS-----S---SX-----------------------------------------------------------------------SQSS-------------------SSS--SSSSSS-----------------------SSSSSSSSS--------SSS--------S------SSSS--------?SSSS--------------------Q-----------------SSS-----------SSQS-------------------SSS--------------Q-QQ----S----S--------------------S-----------S-S---------------------------------------------S--------------------SSSSQQ---------------SSSSSQ----------------------------------S----SS-------------------S---------------------------E---------------XXX-------------SS---?--S------------SS---------------------E--E--E-----SS---------------------------SSSS--------------Q-Q---S----S??-----SSSSSSS--QS--Q-SSSS-----------------QQQQ-------QSS---?SSS------------------------SS-------------------oo----------SSSSSSSSSSSSS-------XXXX-----------------SS--------oooo-------S---oo-
---------------------------------------------------------------------------------------------------------------------------------------------------------------------XXX-----------------------------------------------------------------------------------------------------------------------------------------------------------------------------------------------------------------------------------------------------------------------------------------------------------------------------------------------------------------------------------------------------------------------------------------------------oo-----------------------------------------------------------------------XXX---------------o-------------------------------------------------------------------------------------------------------------------------SS------------------------------------------------------------------------------------------------------------------------------------------------------------------------------------------------------------------------------------------------------------------------------------------------------------------------------------------E---------------------------------------------------------------------------------XXX---------------------XXXX----------------XS-------------------------------------------------------------------------------------------------------------------------------------------------------------------------------------------------------------ESS-------------------S------
----------------------X---------------------------------------------------------------------------------------------------------------------------------------------XXXX-------------------------------------------------------------------------------------------------------------------------------------------------------------------------------------------------------------------------------------------------------------------------------------------------------------------------------------------------------------------------------------------------------------------------------------------------------E-----------------------------------------------------------------------------------------------------------------------------------------oo-----------------------------------------------------------------------SS----------------XX-----------------------------------------------------------------------------------------------------------------------------------------------------------------------------------------------------------------------------------------------------------------------------------------------------------------------------------------------------------------------------------------------------------------------------------------------------XX------------------------------------------------------------------------------------------------------------------------E--------------------------E-----------------------------------------------------------SS--------SSSS-------S-S--S-
---------------------XXX------------------------------------------------------------S--------E-------------------------------------------E-------------------------XXXXX-----------------------------------E---------------------------------------S----------------------------------------------o-------------E-------------------------------SSSSSS----------X----Q---------------o-----------------------------oo------------------------E-------------------S-------------------------X--------------------S-----------------------XXS----------S-------------------------X----------------------------SS-------E--S--E-----------------------------------------S-S-----------E-------------------------------------------SSS--------------S---S----------------------------------------------------------------------E-EE--------E--------o-SS-----o----?-----[]---------------------------------------------E-----SSSSSSS---E--------------------------S------EE-E----------------------------------------------------------------------X------------E-----------------------------o--------------------------------------------------------------------------------------------------S-------------------------XXXX-------------------------S-SS------------------E----------------------------------------------XXXXX-----------------------------------------??--------?------------------------ooo----------------------------------------E----E--S----------E------<>-------E----------------------------S-------------------SSSSS--------SSSS-------SQS--S-
---------------------XXX--S---------------------------E-X-----------SSQSSSSSSSSSS------E----<>----E?QQ?--QQQ----------------------------<>------------------------XXXXXX--------------------E-------Q-----<>----------------XXX---E----------------------------SS-o-----E------SSS-----------------------------<>----------------------------------------------XXX--X-------S--------------XXXX--------------E-----------Q?--QQQ------------<>----E?QQQ-------SS---------------S----------XX----Q------XXX-XX----------X-----E---------XXX-------------------------S----------XXQ--E?QQQ-QQQ--------E--S------oo----<>----<>------------------------------------X--E--------------<>----------XXXXX---------------------------------------------------------------------S?S------------QQQQ--------------S---------------------X--X---SSSS--------SSS---SS---SS-----[]SS-----Q--Q--------E------<>------SSE-------<>--------------<>---QQ?SQ---------<>------SSSSS--SSSSSSS--QQ--QQQQ--Q-----SSS------------------SS----------<>---S----------XX-----------<>-------------E-------------------------SSSSQ?QQQQ----------------QQQ-----------------E-----E--S----------SS--S----E---------ESS--------------------------XX--------XXXX-------------------------------------<>-----------------XXXXXX-----------o----------XXXXX----SS-------SSSS--SSSSS---Q-Q--QQQQ--Q-SSS--SSSSSSS??SS----SSSSSQS----S------------XXX---SS-------SSS-----------------<>---<>-----E--S---<>---E--[]----------------------SSSSSSSS-------------S----X----------SSSS----X------------SSS--SS
--------------------XXXX-----------------------------<>-X-----------------------------<>----[]-----------------------------E---------X--[]-----------------------XXXXXXX-------------------<>-------------[]---------------XXXX------XXXXX------------------------------E--E----------------------------E------[]---------------------------------------------XXXX--XX----------------------------------------------------------------------[]------E------------------------------------XXX-----------XXX-XX---------XX----<>--------XXXXX-SSS------------------------------XXX-------------------<>---------<>----[]----[]--<>-----E---------XX?-------------XX------------E----[]---------XXX----------------------------------------------E---E------------------------------XXX-------------------E-----------------X--------XX--------------------------------[]SS----------------<>------[]----------------[]--------------[]-----------------[]------SSSSS--ESSSSSS---------------------------------------ES----------[]------E------XXX-----------[]------------<>---------------------E----------------------------------------------E-<>----<>---------------------<>--------<>SS-------------------------XXX---------------------X---S-----------------------[]--------------------------------------------XXXX--------------SSSS---ES-SS----------------S----SSSSSS---SSSS-------------------------------------------------------------[]---[]----<>------[]--<>--[]--X-----------------------E---------------------X--XX-----------E--E----------------E--
-------------------XXXX------------------------------[]-X-----------------------------[]----[]----------------------------<>--------X---[]----------------------XXXXXXXX-------------------[]-------------[]--------------XXXXX------------------------------------------------------------------------<>------[]-----------------------<>-------------------XXXXX--XXX-------------------------------X----------------------------X--------[]---------------------------------X--------XXXX---------XXXXX-XXX-------XXX----[]-------XXXXXX------------------------------<>-XXXX-------------------[]---------[]----[]----[]--[]----<>------------------------XXX-----------<>----[]--------XXXX----XXX--------------------------------------<>--<>-----------------------------XXXX-----------------------E---X--------XXX-------XXX-------X-----------------------[]SS----------------[]------[]----------------[]--------------[]-----------------[]--------SSS--oSSSSSS---------------------------------------------------[]-----<>-----XXXX-----------[]------------[]--------------------<>---------------------------------------------<>-[]----[]---------------------[]--------[]SS-----------------X------XXXX-----------------E---X---------------------------[]-----XXXXX----------------------X----------XXXXXX--------o-oo---SSS---S-SS---------------------SSSSSS---SSSS-------------------------------------------------------------[]---[]----[]------[]--[]--[]--X-----------------------------------------E-X-XX-----------------X-------------------
---------------E--XXXXX--------------E------------E--[]-X--------E--E-----E-----------[]---E[]----------------------------[]------E-X---[]-----------------E---XXXXXXXXX-------------------[]--------E--E-[]-------------XXXXXX------------------E-E----------------------------------XX---------------[]------[]-------E-E-E-----------[]------------------XXXXXX--XXXX---------------------------------E-----------------E------XX-EE-E---[]-----------E--------------EE-E---X-------XXXXX---EE----XXXXX-XXXX--E--XXXX----[]------XXXXXXX--SSSS------E----EE-E--EE-E---[]XXXXX-------------------[]---------[]----[]-E--[]--[]----[]-----------------------XXXX----E-EE---[]-E--[]-------XXXXX---------------------------------------------[]--[]--------------EE-E--E-------XXXXX---------------------------X-------XXXX-------XXX-------X----EE--------E-E------[]SS----------E-EE--[]----E-[]---E------------[]-----EE-E-----[]-E-EE-------E----[]----------oooSSSSSSS----------------E-------E-----E--------XX---EE-E-E-[]-----[]--E-XXXXX-----E-EE--[]------E-----[]-----EE-E-----------[]-----------EE-E--------------------------E-E-[]-[]----[]-E-E-E----E-------E--[]-E------[]SS--------EE-E-----X----XXXXXX--ooo----------------X---X---E-EE-------------E--[]-E-E----------------------------X---------XXXXXXX-SSSS-----XX-------o-SESS------------------oo-S-----oooSSSS--------------------------------------E-E-----------------E--[]---[]----[]------[]--[]--[]--X----E------------------------------------XXX-X---X-X------------X-------------------
XXXXXXXX---XXXXXXXXXXXX--XXXX---XXXXXXXX---XXXXXXXXXXXXXXXXXXXXXXXXXXXXXXXXXXXXXXXXXXXXXXXXXXXXXXXXXXXXXXXXXX---XXXXXX----XXXXXXXXXXXXXXXXXX-XXXXX--XXXXX--XXXXXXXXXXXXXXXXXXXXXXXXXXXX--XXXXXXXXXX-XXXXXXXXXXXXXXXXXXXXXXXXXX--XXX-------XXXXXXXXXXXXXXXXXXXXXXXXXXXXXXXXXXXXXXXXXXXXXXXXXXXXXXX----XXXXXXXXXXXXXXXXXXXXXXXXXXXXXXXXXXXXXXXX-XXXXXXXXXXXXXXXXXXXX--XXXXXXXXXXXXXXXXXX-XXXXX----XXX-----XXXXXXXXXXX---XXXXX-XXXXXXXXXXXXXXXXXXXXXXXXXXXXXXXXXXXXX-XXXXXXXXXXXXXXXXXXXXXXXXXXXXXXXXXXXXXXX--XXXXXXXXXXXXXXXXXXXXXXXXXXXXXXXoX----XXXXXXXXXXXXXXXXXXXXXXXXXXXXXXXXXXXXXXXXXXXX----XXXXXXXXXXXXXXXXXXXXXXXXXXXXXXXXXXXXXXXXXXXX------X-XX-XXXXXXXXXX--XXXXXXXXXXXXXXXXXXXXXXXXXXXXX-------------------------XXXXXXXXXXXXXXXXXXXXXXXXXXXXX-XXXX-XXXXXXXXXXXXXXXXXXXXXXX-X-XXXXXXXXXXX--XXXXXXXXXXX--XXXXXXXXXX----XE--XXXXXXXXXXXXXXXXXXXXXXXXXXXXXXXXXXXXXXXXXXXXXXXXXXXXXXXXXXXXXXXXXXXXXXXXXXXXXXXXXXXXXXXXXXXXXXXXXXXXXXXXXXXXXXXXXXXXXXXXXXXXXXXXXXXXXXXXXXXXXXXXXXXXXXXXXXXXXXXXXXXXXXXXXXXXXXXXXXXXXXXXXXXXXXXXXXXXXXXXXXXXXXXXXXXXXXXXXXXXXXXXXXXXXXXXXXXXXXXXXXXXXXXXXXXXXXXXXXXXXXXXXXXXXXXXXX---XXXXXXXXXXX--XXXXXXXXXXXXXXXXXXXXXXXXXXXXXXXXXXXXXXXXXXXXXXXXXXXXXXXXXXXXXXXXXXXXXXXXX-XXXXXXXXXX--XXX-------------XX-X------XXXXXXXXXXXXXXXXXXXXXXXXXXXX--------XXX------------XXXXXXXXXXXXXXXXXXXX--S---XXXXXXXXXXXXXXXXXXXXXXXXXXXXXXXXXX-XXXXXXXXXXXXXXXXXXX-XXXXXXXXXXXXXXXXXXXX---------XXXXXXXXXXXXXXXXXXXXXXXXXXXXXXXXXXXXXXXXXXXXXXXXXXXXX-XX--XX--XXXXXXXXXXXXXXXXXXXXXXXXXXXXXXXXXXXXXXXX-XXXXXX--XXXXXXXXXXXXXXXXXXXXXXXXXXXXXXXXXXXX