------------------------------------------?-----------------------------------------------------------------------------------------------------------------------------------------------------------------------------------------------------------------------------------------------------------------------------------------------------------------------------------------------------------------------------------------------------------------------------------------------------------------------------------------------------------------------------------------------------------------------------------------------------------------------------------------------------------------------------------------------------------------------------------------------------------------------------------------------------------------------------------------------------------------------------------------------------------------------------------------------------------------------------------------------------------------------------------------------------------------------------------------------------------------------------------------------------------------------------------------------------------------------------------------------------------------------------------------------------------------------------------------------------------------------------------------------------------------------------------------------------------------------------------------------------------------------------
------------------------------------------------------------------------------------------------------------------------------------------------------------------------------------------------------------------------------------------------------------------------------------------------------------------------------------------------------------------------------------------------------------------------------------------------------------------------------------------------------------------------------------------------------------------------------------------------------------------------------------------------------------------------------------------------------------------------------------------------------------------------------------------------------------------------------------------------------------------------------------------------------------------------------------------------------------------------------------------------------------------------------------------------------------------------------------------------------------------------------------------------------------------------------------------------------------------------------------------------------------------------------------------------------------------------------------------------------------------------------------------------------------------------------------------------------------------------------------------------------------------------------------------------------------------------
-------------------------------------------oo------------------------------------------------------------------------------------------------------------------------------------------------------------------------------------------------------------------------------------------------------------------------------------------------------------------------------------------------------------------------------------------------------------------------------------------------------------------oo-------SSSSSSSSSSSSSSSSSSSSSSSSSSSS--------------------------------------------------------------------------------------------------------------------------------------------------------------------------------------------------------------------------------------------------------------------------------------------------------------------------------------------------------------------------------------------------------SSSSSSSSSSSSSSS--SSSSSSSSSSS------------------------------------------------------------------------------------SSSSSSSSSSSSSSSSS----SSSSSSS--------------------------------------------ooo-----------------------------------------------------------------------------------------------------------------------------------------------------------------------------------------------------------------------SSSS-----------S--------------------------------------------------------------------------------------------------------------------------------------------------------------------------
---------------------------------------------------------------------------------------------------------------------------------------------------------------------------------------------------------------------------------------------------------------------------------------o----------------------------------------------------------------------------------------------------------------------------------------------------------------------------------------------------------------------XXXX-------------------------------------------------------------------------------------------------------------------------------------------------------------------------------------------------------------S--------------------------------------------------------------------------------------S-----------------------------------------oX----oo--------------------------------o---------------------------------------------------------------------------------------------------------------o---------------------------------------------------------------------------------------------------------------------------XXX-------------------------------------------------------------------------------------------------------------------------------------------------------------------------------------------------------------------------------------------------------------------------------------------------------------------------------------------------------------o---------------------------------------------------
-------------------------------Eooo-----------------------------------------------------------------------------------------------------------------------------------------------------------------------------------------------------------------------------------------------------------------------------------------------------------------------------------------------------oo-----------------------------oo-----------------------------E-----------------------------------------------------------------------------------------------------------------------------------------------------E------------------------------------------------------------------------------------------------------------------S--------------E----------------------------------XXX----------------------------------------------------------------------X------------------------------------------------------------------------------------------------------------------XX-----------------------------------------------------------------------------------------------------------------------------------------------------------------------------------------------------------------------------------------------------------------------------------------------------------------------------------------------oo---------------------------------------------------------------------------------------------------------oooooo--oo---------------------------------------------------------------------------------------------------------------------
-------------------------------XXXXX------XXXX-----oo-----SSQS------QSQQS-----------S----------------------------QQQQ-------SSSSSSSSSSSS-----------------------------------------------SSSS--------------------------S--------------------------SSS--SSSS--S--SSS---------------SSSSSSSS-------------------------------------------------------------------SS---SSS---------o---------------------------S-----------XXoo----oo-----------------------SSSSSS-------------------SSS-----------------S---?SSS-------------------------oooo-------------------------------------------------------------------SSSSSSSQS----------------SSSSS----------------------------?SSSS--SSS-SSS----SS-----SQSSSSSQ------SSSS--SSSSS-------S??--S----------SQ--SSS---S-XXoo----XXX---------------------------------------------------------------------------o------------E------X----Q---------------QQ-----------?SSS------------------------S-------------------SSSS------------------------------------------------S------------SSS-------------XX--------SSSS-----------------SSSSS------------------------------SSSSS---?------------?------------SSSS------------------------------SSSSSSSSS---SSSS-------SS------------------S--------------SSSSSS-------S----------SSSS---------------------------------------------------------------------------------SS---S--------------------------------------------------------S----------------------X-----------------------XXX-----XXX---------------------------XXX---------SSS---?---------------------------------------------XX
-------------------------------------------------------o---------------------------------XXX-------------------------------------------------------------------------------------------------------------------------------------------------------------------------------------------------------------------------------oooo-------------------------------------------------------------------------XXX-----------------------------------------------------------------------------------------------------------------------------------------------------------------------------------------------------------------------------------oo---------------------------------------------------------------------------------------------------------------------------X---------------------------------------------o-----------o--o------------------------XXX------------------------------------------------------------------------------------------------------o----------------------------------------------------------XXXX----------------------------------------------------------------------------------------XXX-----------------------------------------------S---------------SS-------------------------------------------------------------------------------------------------------------------------------------------------------------------------------------------------------------------------------------------------------------------XXX----------------------o----XX-------------------------------------------------------------XXX
--------------------------------------------------------------------------------------------------------------------------------------------------------------------------------------------------------------------------------------------------------------------------------------------------------XX---------------------------------------------------------E---------------------------------------------------------------------------------------------------------------------------------------------------------------SSSSSS-----------------------------------------------------------------X--------------------------------------------------------------------------------o------------------------------------E--------------------------------------------------------------------------------------------------------------------XXXXX------XX-S-------------------------------------------------------------------------------------------------XX---XX--------------------------------------------------------XXXX--------------------------------------------------------------o-------------------------o-o-------------------------------------------------S--------------SS--------------------------------------------------------------------------------------------------------------------------------------------------------------------------------------------------------------------------------------------------------------------XX-------------------------XXXX------------------------------------------------------------XXXX
---------E-------------E----E-------------XXX------------------------------------------------------------------------------------------E--------------------------------------------oo-------------------------E-------------------------E---------------------------------S----------------------------XX-------------------------E--SSSS---------------E--S--E------------QQ--S--------------------------------------------------------------------------E------------------EE------------S--------------------Q----------------SSSSSSS-----------------------------------S-------E---------o--------------------------------------------------------------------------------------------------------------------------------------------------S---------------------------XXX--------------------------------S------------------E----------------------------XX-------------E-------------------------------------------------------------------------------------------------------------------------------E----SSSSSSS-------XXXXXX----------------------------------XX------------------------------SS---------------------------------------------------------------E------------E------ooooS-----------------------------------------------X--------------------------EX-----------------------------------o---------------------------------------------E-------------------------E-------------------E------------------------------------------------------XX-XX------------------E------XXXX--------SSSSS----------------S-----------------------------XXXXX
---E----<>-----E---E--<>----E------XXXX----------X----XX---SS-------QSQS----------------------XXXX---------------?SSQ------XX--------SSSSS--QQ------------------------------------E----------------X----------<>------------------------<>----E?SSS--------S------------X------------------------------XXX------------------------<>--------------------<>----<>----------XX---------XXXX-------------------------XXXX--XXXX---XXXX--SS--------------S----<>---S-SS-----ES-SSSSSS-----------------SQS------E------------S--------------------------S---------------S---------------<>-----E-------------E-X-----SSS---------------------------------------E-------------S-----SSSS------SS------??SSS--QQQ--Q--Q-Q---SQS------SS--S----X--------------------XXXXX-XXXXXX----------------------QQ----<>-------------------XXX---E--<>--------X----XXX-----------XXX------S--E--<>--------S?S--------------E--Q-----<>-----------------------XX-----------------X--------------------------------Q-Q--Q--Q------<>-----------------XXXXXXX--------SS-----------------------XXX----------ooo-------------------S----------XXXX--SSS----Q---XXXXX-----------------------------<>-------SS-SSSSS----SSSSSS-S----S-----<>--------------Q-----SS--------<>X----QQQ--QQQQ--Q---------<>X------------------Q----------------------------------------E-------Q---S--------<>--oo------E------------SSSS------------ES---<>--------------------XXX------------------S-----------XX--XX-------------------------X-XX----------------------------------------------------------XXX-XX
--<>----[]---E<>--<>--[]-------------------------------------------------------------------------------------------------XXXX--XX----E--------------------------------------E----<>---------------XX----------[]------------------------[]--------------E--------------XXX---X------------------------XXXX-------EE------E--------[]--E---E-------------[]----[]---------XXX---------------E-----------------------------------------------------------EE-[]-----SS----SSSSSSSSSSS------------------------<>----------------------------------------------------------E------------[]----<>------------EXXX----------------------------------------------<><>---------XX--------------------------------------------------------------XX---X----------------------------------------------E---------[]------------------------<>--[]-----E--XXXX---------------XXX-S------<>--[]-----E----------------------------[]----------------------XXX--XX----------------------------XXX------------------------------[]---------------EXXXXXXXX--------------------------------XXXX-------------o------E-------------------------------------------------------------------------[]----------EE-------------------------[]--E---------------------------[]X-------------------------[]X----------------------------------------------------------<>--------------------[]---------XXX----------E---------------<>----[]-----------------------------------------------------[]-XXX-------E---XX------------XXXX---------------------------------------------------------XXXX-XX
--[]----[]--<>[]--[]--[]----X-------------------------------------------------------------------------------------------XXXXX--XX------------------------------------------<>----[]--------------XXX----------[]---X--------------------[]----------------------------XXXX----X-------------------<>-XXXXX--------XX----<>--------[]-<>--<>-------------[]----[]--------XXXX--------------<>--------------------------------------------------------------[]-----------SSSSSSSSSSS------------------------[]---------------------------------------------------------<>------------[]----[]-----------XXXXX----------------------------------------------[][]---------XX-------------------------------------------------------------XXX---XX--------------------------------------------<>---------[]------------------------[]--[]----<>--XXXX----------E-E--X-X-X------[]--[]-----------------X----------------[]---------------------XXXX--XXX---------X-----XXXXX----------------------------------------[]---------------XXXXXXXXX-------X-----------------------XXXXX--------XXXXXXX---------E--------------------------------------------------E------------------[]-------------------------------------[]-<>--------------------------X[]X------------------------X[]X----------------------------------------------------------[]--------------------[]--------XXXXXX-----------EE-----------[]----[]------------------------XXX---XXXXX------------------[]--XX--------X--XX----------X-X-XXX----------------------------------X--------------------XXXXX-XX
--[]E---[]--[][]--[]--[]----X---------------------------------------------------E-E------------------------------------XXXXXX--XX-------------------E-------EE-------------[]----[]-------------XXXX---EE-E-X-[]-E-X---E-EE-------E-E-E-[]----E------------S---------XXXXX---SS--------X--------E-[]XXXXXX-------XXX----[]--------[]-[]--[]------E-EE---[]-E--[]-------XXXXX--------------[]-------------------ooo--------------------------------X-------[]---------------SSSSSSS--------EE--------------[]-------------------------------------------EE------E-----[]-----E------[]-E--[]----------XXXXXX--E-E-------E---------EEE---------E-E---------[][]---------XX-----------------------X-----------------------------EE-----XXXX---XXEX---------XXX------------------------------[]-----E---[]------------------------[]--[]----[]--XXXX---------------X-X-X-XX---[]--[]----------------------------------[]-----EE-E----E------XXXXX--XXX-E-E----XX--------------------------------------------E-E---[]--------------XXXXXXXXXX------XXE---------------------XXXXXX--------------------------------------------------------------------------------E------EE-E-X-[]-E----------------E--E---------------[]-[]--------------------------X[]X-----------------------XX[]X----E----------------EE-----------------------------------[]--E-EE-E--EE-----E--[]-XX----XXXXXX------------------E-EE---[]-E--[]-------------XXXXXXX---------------------------------XXXXXX-------XX--XX--------------XXX---E--E--------------------------XX----------------E--XXXXXX-XX
XXXXXXXXXXXXXXXXX-XXXXXXXXXXXXXXXXX---------------------XXXXXXXXXXXXXXXXXXXXXXXXXXXX-------XXXX-----------------XXXXXXXXXXXXXXXXXXXXXXXXXX-XXXXXXXXXXXXXXXXXXXXXXXXXXXXXXXXXXXXXXXXXXXXXXXXXXXXXXXXXXXXXXXXXXXXXXXXXXXXXXXXXXXXXXXXXXXXXXXXXXXXXXXXXXXXXXXXXXXXXXXXXXXXXX----XX--XXXXXXXXXXXXXXXXXXXXXXXXXXXXXXXXXXXXXXXXXXXXXXXXXXXXXXXXXXXX---XXXXXXXXXXXXXXXXXXXXXXXXXXXXXXXXXXXXX-XXXXXXXXXXXXXXXXXX-------XXX------------------XX-XXXXXXXXXXXXXXXXXXXXXXXXXXXXXXXXXXXXXXXXXX---XXXXXXXXXXXXXXXXXXXXXXXXXXXX-XXXXXXXXXXXXXXXXXXXXXXXXXXXXXXXXXXXXXXXXXXXXXXXXXXXXXXXXXXXXXXXXXXXXXXXXXXXXXXXXXXXXXXXXXX-XXXXXXXXXXXXXXXXXXXXXXXXXXXXXXXXXXXXXXXXXXXXXXXXXXXXXXXXXXXX-XXXXXXXXXX-XXXXXXXXXXXXXXXXXXXXXXXXXXXXXXXXXXXX----XXXXXXXXXXXXXXXXXXXXXXXXXXXX----------------------------XXXXXXXXXXXXXXXXXXXXXXXXXXXXXXX---XXX-XXXXXXXXXXX---XXXXXSX--------XX-XXXX-XXX-XXXXXXXXXXXXXXXXXXXXXXXXXXXXX----XXXXXXXXXXXXXXXXXXXXXXXXXXXXXXXXXXXXXXXXXXXXXXXXXXXXXXXX------------------------XXXXXXXXXXXXXXXXXXXXXXXXX-XXXXXXXXXXXXXXXXXXXXXXXXXXXXXXXXXXXXXXXXXXXXXXXX-XXXXXXXXXXXXXXXXXXXXX-------------X--X-XXXXXXXXXXXXXXXX-------XXXXXXXXXXXX-----XXX---XX-XXXXXXXXXXXXXXXXXXXXXXXXXXXXXXXXXXXX-XXXXXXXXXXXXXXXXXXXXXXXXXXXX--XXXXXXXXXXXXXXXXXXXXXXXXXX--XXXXXXXXXX------XXXXXXXXXXXXXXXXXXXXXXXXXXXXXXXXXXXXXXXXX-XX---XXXXXX-----XXX---XXXXXXXXXXXXXXXXXXXXXXXXXXXXXXXXXXXXXXXXX----------XXXXXXXXXXXXXXXXXXXXXXXXXXXXXXXXX-X----------------------------XXXXXXXXXXX--XX--XXXXXXXXXXXXXXX--XXXX--XXXX-XXXXXXXXXXXXXXXXXXXXXXXXXX-XXXXXXXXXXXXXXXXXXXXX--XXXXXXXXXXXXXX-XX