------------------------------------------------------------------------------------------------------------------------------------------------------------------------------------------------------------------------------------------------------------------------------------------------------------------------------------------------------------------------------------------------------------------------------------------------------------------------------------------------------------------------------------------------------------------------------------------------------------------------------------------------------------------------------------------------------------------------------------------------------------------------------------------------------------------------------------------------------------------------------------------------------------------------------------------------------------------------------------------------------------------------------------------------------------------------------------------------------------------------------------------------------------------------------------------------------------------------------------------------------------------------------------------------------------------------------------------------------------------------------------------------------------------------------------------------------------------------------------------------------------------------------------------------------------------------
-----------------------------------------------------------------------------------------------------------------------X------------------------------------------------------------------------------------------------------------------------------------------------------------------------------------------------------------------------------------------------------------------------------------------------------------------------------------------------------------------------------------------------------------------------------------------------------------------------------------------------------------------------------------------------------------------------------------------------------------------------------------------------------------------------------------------------------------------------------------------------------------------------------------------------------------------------------------------------------------------------------------------------------------------------------------------------------------------------------------------------------------------------------------------------------------------------------------------------------------------------------------------------------------------------------------------------------------------------------------------------------------------------------------------------------------------------------------------------------------------------------------------------------------------------------------------------
------------------------------------------------------------------------------------SSSSSSSSSSSSSSSSSSSSSSSSSSSSSS-S-S-------SS--S?SSSSSSSSSSSSSSS-----------------SSSSS------------------------------------------------------------------------------------------------------------------------------------------------------------------------------------------------------------------------------------------------------------------------------------------------------------------------------------------------------------------------------------------------------------------------------------SSSSSSSSSSSSSSSSSSSSSSSSSSS---------------------------------------------------------E-----------------------------------------------------------------------------------SSSSSSSSSSSSSSSSSSSSSSSSSSSS-------------------------------------------------------------------------------------------------------------------S------------------------------------------------------------------------------------------------------------------------------------------------------------------------------------------------S------------------------------------------------------------------------------------------------------------------------------------------------------------------------------------------oo----------------------------------------------------------------------------------------------S----------------------------------------------------------------------------------------------------------------------------------------
----?--o--X---------------------------------------------------------------------------SSSS-------SSSSSSSSSSS--SS---------------------------------------------------------------------------------------------------------------------------------------------------------------------------------------------------------------------------------------------------------------------oo--------X-------------------------------------------------------------------------------------------------------------------------------------------------o----------------------------------------------------------SSSSSSSSSSSSSSSSSSSSS----------XXXX---------------------------------------------------------------------------------------------------------------------------------------------------------------------------------------------------------------------------------------------------------------------------------oS------------------------------------------------------------------------------------------------------------------------------------------------------------------------------------------------------------------------------------Q-------------------------------------------------------------------------------------------------------------------------------------------------------XXXX--------------------------------------------------------------------------------------------SS-----Q----------------------------------------------------------------------------------------------------------------------------------
o-----------o---E---------------------------------------------------------------------SSSS--E----SSSSSSSSSSS--SS---------------------------------------------------------------------------------------------------------oo---------------------------------------------------------------------------------------------------------------------------------------------------------------------------------------------------------------------------------------------------------------------------------------------E--------?--------------------------------------------------------------------------SSSSSSSSSSSSSSSSSSSS--------------------------------------------oo--ooo--------------------------oo--oo--------------------------------------------------------------------------------------------------------------------------------------E-------------------------------------------------------------------------------X--------------------------------------------------------------------------------------------------------------------------------------------------------------------------------------------oo---------------------------------------------------------------------------------------------------------ooo--------------------------------------------------------------------------------------------------------------------------------------------------------------------------SS--E-----------------------------------------------------oooo----------------------------------------------------------------------------
XX--------------E--E-----o-------------------SQSSSSS-----------------------------------S----S-XSS--------S----SS--------------------------S-oooo----------SSSSSSS------------------SSS-------------X-----XXX-----XXXX-----------Q-----S---?SSS----SSS-----------------SSSS---SSSSS--------------------------------------?SSS---SSS----------------------------------------?S------------XXX------------o----------------------------SSSS-----------------------------------------SSSSS----------------------------------S---SQS--??-----------SSSS------SSQS-------------------------------------E-----o----SSSSSSSSSSSSSSSSSSSSSSSS-------?----------------SSS----Soo----------------------------XXXoo-----------------------------------------------------------------------------SQ?--------ooo----------------------------------------------SS-----SSSSSSS---------------------SSSS-SSSSSSS-----SS?S-----------------SSSS---------------------------------------------------------------------------QQQ---------------------------------------S----S?-------------------------E---------------------------------------------------------------E---------------SSS------------------SSSSS-----------------------------oo------------oooo---------Q?SSS---------------SSSSS--------------SSS------SS----------------------------------SSSSS--------------E?---------------------------SSS-----SS-?-SS--------------SSS----------SS------------------SS------o----------------XX-------XXXX--------------------------------------oo------------------------------------
------------------XXXXXX--------------------------------------------------------------SS----S--X---------S----SS-----E---------------------------------------------------------------------------XXXo---------------------------------------------------------------------------------------------------------XX--------------------------------------------------------------------------------------XX--------------E-------------------------------------------o--------------------------------------------oooo---------------------XSS------------------------------------------------------------------------------------------------------------------------------------------oo-----------------------------------------------------------------------------E---------------S---------------------------------------------------------------------------------------------------------------SS---------------------------------------------------------------------------------------------------------------------------------------------------------------------------<>------------------------------------------------------XXX--o-----------------------------------------------------------------------------------X-------------------------------------------------------------------------------------------S-------------------------------XXXXX---------------------------------------------------------------SS-------------------------------------------------------------------------------XXX--------------------------------------------------
--XXXXXXX-----------------------------------------------------------------------------SS-------S---------S----SS---o-------------------------------------E--------------------------------------XXXX----------------------------------------------------------------------------------------------------------------XX------------------------------------------------XXS----------------------------oo---------------XX---------------------------------------------------------------------------------------------------------------XX---------------------------------------------------------------------------------------------------------------------------------------------------------------------------------------------------------X---------------XXXX--------------So-----------S--------------------------------------------------------------------------------------------------SS--------------------------S--XXX---S--------------------E---------------------E--------------------------------XXX---------o---------------------------------E-------------[]----------------------------------------------------------XXX----------------------------------------------------------------------------------------------------------------------------------------------------------------------------------------------------------------------------------------------------------------------------------SS------S----------------------------------------------------------------------------------o------------------------------------------
-------------------------XXX----------E--o--------------------------------------------SS--?-----?ooooooooSo-ooSS------------------------------------------------------------------------------XX-XXX---------------XXXXXX-------------------------------------------------------------------------------------------S-------------------------------------------S-----XX--------------------------------------------------------------------------------------------------------------------S----------------E----------E---------------XSS-SQSSSS----------------E------------------------------------------------------------------------------------------------------------------------XXX----------------------------------------------S--------------------------------------XS----------S-------------------------------E----S-----------------------------------------------X---------------SS-------------------------------------SS----------------<>--------------------<>------------E-------------------XXX---------------------------o--------------<>-------------[]---------------E---------------------------E---------------------------------SSSSSS---------------SSSSSSS---E---------------S-----------------------XXXXX-------------------------------------------------------E--------SSSSSS--------------SQ--------------------------------------oo-----------------------S-------------------------Xo-----SS----SoS------------------XXXX-------------------o-----------------------oo--------------------------------------------E------------X
--------ooo--------------------------<>------SSSS-o-o---------------------------------SSSS------?SSSSSSSSSSSSSSSSSS--------------------------------------S?SSSSSSSS--------------------------XXX-XX--------XXXXX----------------QQ----QQSSSQQ-------------------QQ--QQQ-Q--QQQ---SQQQ----------------XXX------------S--QQQQ----Q-------------------------------------XXX--X----------------XXXX---XXX---------------------------------SSS-oo----E---------------S------------------------------E---------E--<>----------XS--S?S--------XXX---------------S-------<>----------------------S------E---XXXXXXX-S?SSSSSSSSSSSSSSSSS--SSSS-S--Q----------------S------SSS--------XXXX----------------------XXXXX--------------------------<>----------oX-----------XXXX----oo------------SSS----EX---------------------Q-----------<>----------S-----SQS--Q--Q--------------X---Q-------XXX-XX----------XSS--------------------------SSS----------------E---------[]-----------------E--[]--X--------<>----E?QQQ----------XXX-------SSS----------------SSS-ES-----E--SS[]-----------SS[]-S-----S------<>-------------------E------<>---Q--S----------------XXXXXX----------------------------------<>-------------E----E--S----XXXXX--XXXX-----------------SSS----------------SSSS---------------------<>----------------------------------------------XXXXXXXXX------------------------E-----------XSS---SS----XX--X----------XXSSS---SSS---SSS--SS----------------------------------XXX-------XXXX---------------------------SSS-----X----------S--------E--<>-----------XX
----------E--------------------------[]-----------E-----------------------------------E--------------------------------XXX-?-----------------E----------------------------------------------XXXX-XXX---XXXXX-------------------------------------------------------------------------------------------------------------------------------------------------------XXXXX-SXX-------------XX---X-------------------------XXXXXX------------------E---------------------------------------------<>--------<>--[]------XX----------------XXXX-----------------------[]---------------E------------<>-----------SSSSSSSSSSSSSSSS-SS-----------------------------------SS---------------E-----------------------------------SSS-----------[]-----------X-----------------o---------------------EXX---------------------------------[]--E-----------------------------------XX----------XXXX-XX---------XX------------------------X---------------------<>-----XXX-[]----------------<>--[]--X--------[]------------------XXXX------------------------------------<>----[]-----E-------[]--------------[]------------------<>------[]---------------------------------------------------------------[]------------<>---<>-------------------------------------------X-X---------------------------------[]-------------------------X-----------------------------------------E----------<>-----------X----------XXX--XX--------XXX--------------------------------------------------------------XXX--------------------XXX-----EE------XXX-----------------<>--[]----------XXX
---XXXXX-XXX-------------------------[]-----------------------------------X---X------------------------------------------------------------------------------------------------------------XXXXX-XXX-------------o--------------------------------------------------------------------------XXXXX------------------------------------------------------------------XXXXX--XX------------XXX---XXXXX---Eo-----XXXXXX---------------------------------------------------------------------------[]--------[]--[]------XX---------------XXXXX-----------------------[]--------------<>------------[]-----------SSSSSSSSSSSSSSSSSSS------------------------X----------SS--------------<>---XXX------------------XXX----------------------[]---------X-X----------------XXXXX---XXX------------XXX---------------------------------[]-<>----------------------------------XXX---------XXXXX-XXX-------XXX----------E-----------------------------------[]---------[]----------------[]--[]--X--------[]------------------XXXX----------E-------------------------[]----[]----<>-------[]--------------[]------------------[]------[]---------------------------------------------------------------[]------------[]---[]-------------------o----------------------XXXX---------------------------------[-------------------------------------------------------------------<>----------[]-------XX--X---------XXXX--XXX------XXXX----------------------<>-------------------------------------------XXXX--------------XXX------------XXXX-----oo----------[]--[]---------XXXX
------------------------ooo---XXX-E--[]-----------------------------------E---X-------------------------E-E------------------------------E------------------------------S------E-E--------XXXXXX-XXX-XX----------------------------------------------------------------------------------------------------------EE-------------------------------EE-E------------XXXXXX--XX--------XXXXXXX-----------XX---------------------------E----------------------EE-E--------------------------------[]--------[]--[]-------X----E---------XXXXXX--S--------------------[]--------E-EE--[]------------[]-----------SSSSSSSSSSSSSSSSSSS---------E-------EE-E--EX-E--------SS-----X--------[]------------XXXXX-------------------------EE-E-E-[]---X-------X-------ooo------------------E----E----XXXX------------------E----E-E-------[]-[]------X-----E-------E---------EE-XXXX---E----XXXXXX-XXXX--EE-XXXXE-E-----X-------------------------------------[]---------[]--------EE-EE---[]--[]--X-EE-E---[]------------------XXXX--------------------EE-E-E----------[]----[]----[]----E--[]---------E-E--[]-------E--EE-E----[]------[]--------------------------------X---------------------EE-E-----[]-E-EE--E----[]---[]-E---ooo----------XXX-------------E------XXX-------------------------EE-E--E---------------------------------SS-------------ooo--------------------[]---X---E--[]------XXX--XE-------XXXXX--XXXX---XXXXXX--E------------E------[]----------ooo--------E---------------------------------------SXX-----------XXXXX-----XXX---------[]--[]--------XXXXX
------------------------XXX-XXXXXXX--XXXXXXXXXXXXXXXXXXXXXXXXXXXXXXXXXXXXXXXXXXXXXXX--XXXXXXXXXXXXXXXXXXXXXXXXXX---XXX-----XXXXX----XXXXXXXXX-XXXXXXXXXXXXXXXXXXXXXXXXXX---XXXXXXXXXX---XXXXXXX--XXX----------------------------XXXXXXXXXXXXX---XXXXXXXXXXXXX--XXXXXXXXXX---XXXXXXXXX--------------X---------XXXXXXXXXXXXXXXXXXXX---XXXXXXXXXX--XXXXXXXXXXXX---XXXXXXXX--XXXXXXXXXXXXX-Q-X--------E-----XXXX--------------------XXXXXXXXXXXXXXXXXXXXXXXXXXXXXXXXXXXXXXXXXXXXXXXXXXXXXXX----XX-[]XXXXXXXXXXX-XX--XXXXX---XXXXXXXXXXXXXXXXX-------XXXXXXXXXXXXXXX--XXXXXXXXXXXXXXXXXXXXXXXXXXXXXXXXXXXX-------XXXXXXXXXXXXXXXXX----XXXXXXXXXXXXXXXXXXXXXXXXXXXXXXXX-XX-------------XXXXX------E-------------------------------XXXXXXXXXXXXXXXXXXXXXXXXXXXX--XXX-----------------------XXXXXXXXXXXXXXXXXXXXXXXXXXXXXXXXXXXXXXXXXXXXXXXXXXXXXX--XXXXXXXXXXXXXXXXXXXXXXXXXXXXXXXXXXXXXXXXX--XXXXXXXXXXXXXXXXXXXXXXXXXXXXXX--XXXX-X-XXXXXXXXXXXXXXXXXXX-XXXXX------XXXXXXXXXXXXXXXXX-XXX-XX--XXXXXXXXXXXXXXXXXXXXXXXXXXXXXXXX-----XXXXX----XXXXXXXXXXXXXXXXXXXXXXXXXXXXXXXXXXXXXXXXXXXXXXXXXXXXXXXXXXXXXXXXXXXXXXXXXXXXXXXXXXXXXXXXXXXXXXXXXXXXXXXX-----XXXXXXXXXX----XXXXXXXXXXX--X---XXXXXXXXXXXXXXXXXXXXXXXXXXXXXXXXXXXXXXXXXX-------------------------XXXXXXXXXXXXo-XXXXXXXXXXXXXXXXXXXXXXXXXXXXXXXXXXXXXXXXXXXXXXXXXXXXXXXXXXX-------XXXXX------XXX-------------XXX--XXXXXXXXXXXXXXXXXXXXXXXXX-X-XXXXXXXXXXXXXXXXXXXXXXXXXXXXXXXXXXXXXXXXXXXXXXXXXXXXXXXX------XXX-----XXXXXX-X-X-----XXXX------------------------XX--XXXXXXXXXXXXX-----XXXXXXXXXXXXXXXXX-XX--XXXXXXXXXXX