-------------------------------------------------------------------------------------------------------------------------------------------------------------------------------------------------------------------------------------------------------------------------------------------------------------------------------------------------------------------------------------------------------------------------------------------------------------------------------------------------------------------------------------------------------------X---Q------------------------------------------------------------------------------------------------------------------------------------------------------------------------------------------------------------------------------------------------------------------------------------------------------------------------------------------------------------------------------------------------------------------------------------------------------------------------------------------------------------------------------------------------------------------------------------------------------------------------------------------------------------------------------------------------------------------------------------------------------------------------------------------------------------------------------------------------------------------------------------------------------------------------------------------------------------------------------------------------------
------------------------------------------------------------------------------------------------------------------------------------------------------------------------------------------------------------------------------------------------------------------------------------------------------------------------------------------------------------------------------------------------------------------------------------------------------------------------------------------------------------------------------------------------------------------------------------------------------------------------------------------------------------------------------------------------------------------------------------------------------------------------------------------------------------------------------------------------------------------------------------------------------------------------------------------------------------------------------------------------------------------------------------------------------------------------------------------------------------------------------------------------------------------------------------------------------------------------------------------------------------------------------------------------------------------------------------------------------------------------------------------------------------------------------------------------------------------------------------------------------------------------------------------------------------------------
---------------------------------------------------------------------------------------------------------------------------------------------------------------------------------------------------------------------------------------------------------------------------------------------------------------------------------------------------------------------------------------------------------------------------------------------------------------------------------------------------------------------------------------------------------------------S----------SSSSSSSSSSSSSSSSSSSSSSSSSSSS--------------------------------------------------------------------------------------------------------------------------------------------SSSSSSSSSSSSSSSSSSSSSSSSSSSS-----------------------------------------------------------------------------------------------------------------------------------------------------------------------------------------------------------------------------------------------------------------------------------------------------------------------------------------------------------------------------------------------------------------------oo-----------------------------------------------------------------------------------------------------------------------------------------------------------------------------------SS--------------------------------------------------------------------------------------------------------------SSSSSSSSSSSSSSSSSSSSSSSSSS------------------------------
-----------------------------------------------------------------------------------------------------------------------------------------------------------------------------------------------------------------------------------------------------------------------------------------------------------------------------------------------------------------------o-----------------------------------------------------------------------------------------------------------------------------------------------------------------------------------X--X---X----------------------------------------------------------------------------------------------------------------------------------------------------------------------------------------SSSS-----SSSSSSSSSSSSSSSS-----------------------------------------------------------------------------------------------------------------------------------------------------------------------------------------------------------oo-----?---------------------------------------------------------------------------Q-------------------------------------------------------------------------------------------------------------------------------------------------------------------------E--E---------------------------------------------------------------------------------------------------------------------------------------------------------------------------------------------------------------------------------------------------SSSS-SS--SS------------------------------------------
-----------------------------------------------E------------------------------------------------------E-oo-oo-----------------------------------------------------------------------------------------------------------------------------------------------------------------------------------------------------------E-------------------------------------E-----------------------------------------------------------------------------------------------------------------------------------------------------------------------------------------------XX--XX----XX------------------------------------------------------------------------------------------E-------o------------------------------------------------------------------------------SSSS-----SSSSSSSSSSSSSSSS--------------------------------------------E----------------------------------------------------------------------------------------------------------------------------------------------------------------oo------------------------------------------E-------------------------------------------------------o-----------------------------------------------------------------------------------------Eooo--------------------------------------------------------XXXXXXX------------------------------------------------------------------------------------------------------------------------------------------------E------------------------------------------------------------------------------------------------SSSS-SS-------------------------------------------ooo
----------------------------SSSSS--------------E--E-------------------oo----XXX---------XXXX----------XXXXXXX-----E-------------SSS-------------E------SQQQQ-------------SS---SS----------------------------------------------------------QQQQ------------------------------SS------------------------------------------SS-----SSS------------------QS------SSSSSSQ--SSS---------------------------------S------------------XXX-------------------------------------S----S-----------------------------------------------------------------------oo----XXX--------------------S--------------------------------------------SSSS----SS--------------QQQQQ------------SS------XXX---------------------o---SSS------------------------SSSS--------------------SS-------SSSSSSSSSSSSSSSS-----------Q------------------SSSSS-------SSS----?--Q-----------------------------------S----SSSS-----------SSSS-----------------------E-----------------------------------------------SSSS---SSSSSS--------XXXX------E----------------------------------XXX------E-----QQQQSSS---------S-------------oS------XX----------------------S?SSS--------?-------------------------------------------------------XXXXX------XXXX-----oo--------------SSS------------------------------------------------------------------SSS-S------------------------SQ----------------------------S-----------------SSSSSSSSSSS---S------------SSQ---SS--------------SQS---------------SS-------SSQS--------------------------SSS----SSSSS--------SS---SSS---------------S---------?SSS-----E----XX----
-------------------------------------------------XXXXX--------------------------------------------E-----------------XXX-----------------------------------------------------------------------------------oooo---------------XXX---------------------------------------------------------------------------ooo-------------------------------------------------------------------------------------------------------------XXXX------------------------------------------------------------------------------------------------o----o---------S------------o----------------------------------------------------------------------------------------------------------------------------------------------------------------------------------------------------------------------------------------------------------------------------------------------E----------------------------------------------XXX--------------<>--------------------------------------------------------------XXXX-------------------------------------------------------<>-------------------E-------------------------------------------------------------------------------------------------------------------------------------------oo-------------------------------------------------------------------------------------------------------------X-X--------------------------------------------------------------------------------------------------------------------------------------------------------------------------------------------------------------------<>----------
-------------------------------------------------------------------------------------------------<>-----------------------------------------XX------------------------------------------------------------------------------XXXS-------------------------------------------------------------------------------------------------------------------------------------------------------------------------------------------XXXX--------------------------------------------------------------------------------E------------------XXXX-XXX-------S--------XXX-XXXXXX-XX-------------------------------------------------------------------------------------------------------------------------------------oo---------------------------------------------S-------------------------------------------------XX--------------o------------------X-------------------------------------------------------------------------[]-------------------------------------------------------------------------------------------------------------------------[]------------------<>---------------------------------------------------------------------------------------------------------------------------------------------------------------o------------------E---------E---------------------------------------------------------------------------------------------------------------------------S---------------------------------------------------------------------------------------------------------------S-----------------E----S-----------------[]----------
-------------ooo-------------------------------------------XX------------------------------------[]-------------------------E-------------E--X----------------------------------------------------------E------------------XXXXX----------------------------S--------E---------------E-------------------E---------------------------------oo----------------------------------------------------E-------------------------XXXX-------------------------------------------S--------------------------------E--<>----------------------------------o----------------------------X--------------------o-------S--------E----------------------------------------------E--------------------------------------------------------------------------------------EE---------?-oooooo-E-----------------------------XX--------------------------------XX-------------------------------------E--o--------------------------------[]-----------o-----------------------------E-----------------------------------------------------------------S-----------SS[]------------------[]---------------------------------QSS------------------oo-SQ-SQS------S------------------E------------------------E------------XX--------------S-------------------------XS-------<>--------<>----------------------E---------SSSS-ooo----Eooo----------------S---------------------E-----------------------------E------S---------------------------E-------------------E----------------------oooo-------------------------------------So----S----------<>----So---------------------E------
--------------------------------------XXX-------------------------------XXXX--XXXX---------XXXX--XXXX--XXXXXXX--X----------<>------------<>--XX--------S?SQQ-------------------SS------------o-----S---<>-----------------XXXXX-----Q--QQ?SQQQQ-------E--------E----<>--------------<>-----E---------E--<>-------------QQQQ---<>---S--------------SSSS-----XX-------------------<>----E---------<>------oS---------------X-XXXX----------------------------------E--S--------E--?-------------------------<>--[]-----------------------------------EXX--------------------------------S------------------------E----<>---E--?S---QQQ-----X-----Q---S?QQQ------------XS--S?S--------------------------XXX-SSSSS------------------XXXX----------------------SSSS--X-----??SSSSSSSSSS--QQQQQ----Q-QQ---Q-------XXX-----SSS-----SSS------S?SQ--Q--XXX-----------------------S---QQQ--S---<>-----E--?--------------------------[]----------------------------E------E----<>-----?QQ--------XX--------------------------------------------------E--S--X--SS[]S---E?SQS---S-S---<>----------XXXX----------XXXX-----------------S-S------------E-----------E--S-----------<>-----------S---------E---------XXXX---------------XX---------------------------X---E----[]--------[]-----E---------------<>--------------------<>------------SSS--QS---------------------<>----S------------X--X---S---SSSS-----S-----------SSSS-S-----S--<>---QQ?SQQ----SS---<>-----------QQSSS----E-----------QQ---------XXX-XX--------------SSS---S-------E--[]----SS---------S-S--------<>------
--------------------<>-----------------------------------------E------------------------------------------------X----------[]------------[]-XXX---------------------------------------------------E----[]----------------XXXXXX----------------------<>-------<>----[]--------------[]----<>--------<>--[]--------------------[]------------------E-------XXX--XX---------------[]---<>---------[]----------E---------XXXXXXXXX--------E------------------------------EE----<>---------------------E-E----[]--[]------------------E------------X-------X-------------------XXXXX------------------------------<>----[]--<>---------------------------------------------------------------X-------XXX-----------------------------------------------------EE-----XXX----------------------------------------XXXX----------------------------XX-XXX------------------------------------[]----<>---------------------------X-[]---------------E------------X-----<>----[]---------------XXX-----------------X-------------------------------<>-----X------------------------[]-----------------------------------------------------------<>----------<>--------------[]--------------------<>--S----------------------------------------------------XXX--<>----[]--------[]----<>---------------[]--------------------[]----------------------------------------[]---------------XXX--XX-----E---------------------E-------------[]------------------[]------XX-----------<>---------------------XXX--XX---------------------------<>--[]--------------------E-----[]------
--------------------[]---------X------------------------------<>-----------------------------------------------------------[]------------[]-XXX--------------------------------------------------------[]---------------XXXXXXX----------------------[]-------[]----[]--------------[]----[]--------[]--[]--------------------[]-------------------------XXXX--XXX--------------[]---[]---------[]---------<>-----<>-XXXXXXXXXX-------<>------------------------------------[]--------------------<><>----[]--[]--<>----X-------------E----XX--X-------X------------------------------------------------------[]----[]--[]--------------------------------X--------------------------X---X-------XXX------------<>---X-------------------------E-------------E--XXXX-------------------------------------XXXXXX-------------------------------XXX-------------X---X------------------[]----[]------X-------------------XX-[]--------------------------XXXXX---[]----[]--------------XXXX-----------------X-------------------------------[]----------------<>------------[]--------------------------------------------------------o--[]----<>----[]--------------[]--------------------[]------------------------------------------------------XXXX--[]----[]--------[]----[]---------------[]--------------------[]----------------------------------------[]--------------XXXX--XXX----------------------------------------[]------------------[]------[]-----------[]--------------------XXXXX-XXX---------X----------------[]--[]-------------------<>-----[]------
--E--E--------------[]-------E-X------------------------------[]-----ooo----------------ooo---------------------X----E-EE--[]-----EE-----[]-XXX---------E---------------E-EE-----------E------------E--[]----------E---XXXXXXXXX-----E-EE-------EE-E-[]-------[]----[]-E------------[]----[]-----E--[]--[]--------------------[]----------E-EE---E------XXXXXE-XXXX-------------[]---[]---------[]------E--[]-----[]XXXXXXXXXXX-------[]---------------------------------E--[]--------------------[][]----[]--[]--[]----------------------XXX--X-----------------------------------------------------------E--[]----[]--[]--------------------------------X-----EE-EE--------------E-X---X-------XXX------------[]---X----E--ooo--------------------E-----------XXXXX---------------------EE-------EE-E--XXXXXX---------------E------------X--XXX-------------X-E-X--------------E---[]----[]------X--------E------EE-XXX-[]--E---------------------E-XXXXX---[]---E[]-E-----------XXXXX-----------------X------------------E-----EE-EE--[]-E-----E--------[]-----EE-----[]--------oo-------------------------------------------------[]----[]----[]--------------[]--E-E------E--------[]-----------------------------------------------X-----XXXXX--[]----[]--E-----[]----[]---------------[]-------E-E-------E--[]-----------------------EE-E-E--EE-E-----[]--------EE-E-XXXXX--XXXX----------------------E----------------[]----E-------E-----[]------[]-E-E-------[]-------------------XXXXX--XXXX-------XX----------EE-E--[]--[]-E---------------E-[]-----[]------
XXXXXXXXXXXXXXXXXXXXXXXXXXXXXXXXXXXXXXXXX----------XXXXXXXXXXXXXXX---XXX----------------XXX----------------------XXXXXXXXXXXXXXXXXXXXXXXXXXXXXX--XXXXXXXXXXXXXXXXXXXXXXXXXXXXXXXXXXXXXXXXXXXXXXXXXXXXXXXXX-XXXX----XXXXXXXXXXXXXXXXXXXXXXXXXXXXXXXXXXXXXXXXXXXXXXXXXXXXXXXXXXXXXXXXXXXXXXXXXXXXXXXXXXXXXXXX-XXXXXXXXX-XXXXXXXXXXXXXXXXXXXXXXXXXX-XXXXXXXXXXXXXXXXXXXXXXXXXXXXXXXXXXXXXXXXXXXXXXXXXXXXXXXXXXXXXXXXXXXXXXXXXXXXXXXXXXXX-XXXX-X-XXXX-------XXXXXXXX--XXXXXXXXXXXXXXXXXXXXXX-XXXXXXXXXXXXXXXXXXXX-XXXXXXXXXX----X-XX-X-XX---XXXXXX----------------------------------XX------XXXXXXXXXXXX---XXXXXXXXXXXXXXXXXXXXXXXXXXXXXXXXXXXXXX-XXXXXXXXXXXXX-XXXXXXXXXXXXXXXXXXXXXXXXXXXXXXXXXXXXXXX-----XXXXXXXXXXXXXXXXXXXXXXXX----XXXXX-------------XXXXXXXXXXXXXXXXXXXXXXXXXXXXXXXXXXXXXXXXXXXXXXXXXXXXXXXXXXX-XXXXXXXXXXXXXXXXXXXXXXXXXXXXXX--XX---XXXXXXXXXXXXXXXXXXXXXXXXXXXXXXXXXXXXXXXXXXXXXX---XXXXXXXXXXXXXXXX--XXX-XXXXXXXXXXXXXX---XXXXXXXXXXXXXXXXXXXXXXXXXXXXXXXXXXXXXXXXXXXXXXXXXXXXXXXXX-XXXXXXXXXX-XXXXXXXXXXXXXXXXXXXXXXXXXXXX-XXXXXXXXXXXXXXXXXXXXXXXXXXX---X--XXX---XX--------------XXX-XX-X-XXXXX-XXXXXXXXX----XXXXXXXXXXXXXXXXXXXXXXXXXXXXXXXXXXXXXXXXXXXXXXXXXXXXXXXX--------------------------------XX--XXXXXXX---XXXXXXXXXXXXXXXXXXXXXXXXXXXXXXXXXXXXXXXXXXXXXXXXXXXXXXXXXXXXXXXXXXXXXXXXXXXXXXXXXXXX---XXXXXXXXXXXXXXXXXXXXXXXXXXXXXXXXXXXXXXXXXXXXXXXX--XXXXXXXXXXXX---XXXXXXXXXXXXXXXXXXXXXXXXXXXXXXXXXXXXXXXXXXXXXXXXXXXXXXS-XXXXXXXXXXXXXXXXXXXXXXXXX-XXXXXXXXXXXXX--XXXXXXXXXXX-XXXXXXXXXXXXXXXX-XXX-XXXXXXXXXXXXXXXXXXXXXXXXXXXXXXXXX---