---------------------------------------------------------------------------------------------------------------------------------------------------------------------------------------------------------------------------------------------------------------------------------------------------------------------------------------------------------------------------------------------------------------------------------------------------------------------------------------------------------------------------------------------------------------------------------------------------------------------------------------------------------------------------------------------------------------------------------------------------------------------------------------------------------------------------------------------------------------------------------------------------------------------------------------------Q--------------------------------------------------------------------------------------------------------------------------------------------------------------------------------------------------------------------------------------------------------------------------------------------------------------------------------------------------------------------------------------------------------------------------------------------------------------------------------------------------------------------------------------------------------------------------------------------------------------------------
------------------------------------------------------------------------------------------------------------------------------------------------------------------------------------------------------------------------------------------------------------------------------------------------------------------------------------------------------------------------------------------------------------------------------------------------------------------------------------------------------------------------------------------------------------------------------------------------------------------------------------------------------------------------------------------------------------------------------------------------------------------------------------------------------------------------------------------------------------------------------------------------------------------------------------------------------------------------------------------------------------------------------------------------------------------------------------------------------------------------------------------------------------------------------------------------------------------------------------------------------------------------------------------------------------------------------------------------------------------------------------------------------------------------------------------------------------------------------------------------------------------------------------------------------------------------
-------------------------------------------------------------------------------------------------------------------------------------------------------------------------------------------------------------------------------------------------------------------------------------------------------------------------------------------------------------------oo--------------------------------------------------------------------------------------------------------------------------------------------------------------------------------------------------------------------------------------------------------------------------------------------------------------------------------------------------------------------------------------------------------------------------------------------------------------------------------------------------------------------------------------------------------------------------------------------------------------------------------------------------------------------------------------------------------------------------------------------------------------------------------------------------------------------------------SS-E-------------------------------------------SSSSSSSSSSSSSSSSSSSSS-----------------------------------------------------------------------------------------------------------------------------------------------------------------------------------------------------------------------------------------------------------------------------------------------
------------------------------------------------------------------------------------------------------------------------------------------------------------------------------------------------------------------------------------------------------------------------------------------------------------------------------------------------------------------XXXX-----------------------------------------------------------------------------------------------------------------------------------------------------------------------------------------------------------------------------------------------------------------------------------------------------------------------------------------------------------------------------------------o--------------------------------------------------------------------------------------------------------------------------------------------------------------------------E--E-----------------------------------------------------------------------------o-------------------------------------------------------------------------------------------------------------------------------------------------------------------SS------------S?--------S--------------------------------------------------------------------------------------------------------------------------------------------------------------------------------------------------------------------------------------------E---------------------------------------------------------------------o-----------------------------
-----------------------------------------------------------------------------------------------------------------------------------------------------------------------------------E----------------------------------------------------------------------------------------------------------------------------------------------------------------------------------------------------------------------------------------------------------------------------------------------------------------------------------------------------------------------------------------------------------------------------------------------------------------------------------------------------------------------------------------------------------------------------------------------oo--------------------------------------------------------------------------------------------------------------------E-----------------------oo--------XXXXXX-----------------------------------------------------------------------------------------------------------------------------------------------------------------------------------------------------------------------------------------------S-----------------------S---------------------------------------------------XX---------------------------------------------------------------------------------------------------------------------------------------------------------------------------------------XX--------------------------------------------------------------------------------------------------
-------------------------------------------------------------------------SSSSS---SQS---------------XXX----XXX---------SS---------S--------SSSQQS------------SSSSSS----------------SQS--SQSSS-----------------------SSS---SSS---S-----------SSSSSSSS------------------------------------S-----SQSSSSQSS------------------E-----QQQS--------------Q?SSQ---S-SSSS-----------------------------SSSS----------------------------------------------------------------------------------S--------E--SQS-----------------S-S----SSS---------X-oo----?------------------------------------------------------SS-----------------------------------------------------S-----------------------------------E------------------------------------------------------------------XXX------o-------------------------------------------------------SSSS------------------------------SSSS---SSS--------SSSSSS-?-SS-----SSQS-----SSSSS------------XX--------------------------Q-----------------SSSSSSSSSS-?SSS-------------S-----SSSS---------XXXX-------------------SSS---?-----------------SSSS--------------SSS--------------------------------------------------SSS--------SS----------------------------------SS------------SS----------------------SSSS-----------------------------------------------SSS-------------------------Q---QSSSS------------------------SSSSSS-----------------S---------------------------SSS--------------------S--------------------S--------------------------------------------------------------------------------S--S---SS------------------SS---
------------------------------E-------------------------------------------------------------E-------------------------SS---------------------------------------------------------------------------------------------------------------------------------------------------------------------?--------------------E-------------------------------------------------------------------------------------------Qooo-----------------------------------------------------------------------<>-------------------o--------------------------------XXX-------------------------------------------------SS---------------------------------------------------------------------oooo---------------<>X--------------------------------------------XSSSX---------XXXX------------------------------------XX-------------------------------------XXX-----------------------------------------------------------------------------------------X----------XXXooo---E------------------------------------------------------------XXXXX----------------------------------------------------------------------XXX-----------------------------------------------------------------------------------------------S------------SS------------oooo------------------------------------------------------------------------------------------------------------------oo-o-----------------------------------------------------------------------------------------------------------------oo---------------------------------------------------------------------------------------------
-------------------------------------------------------------------------------o-----------<>--------------------------------------------------------------------------------------------------------------------------------------------------------------------------------------------------------------------<>----------------------------------------------------------------------------------------------------------------------------------------------------------------------[]-S---------------------------------------------------------------------------------X--------------------SS----------------------------------------------------------------------------------------[]X-------------------------------------------XXX------------------------------------------------------------------------------------------XXXX------------------------------------------------------------------------------------------------------------XXX---------------------------------------------------------------------------------------------------------------------------------------------------------------------------------------------------------------------------------------SS------------SS-------------------------------------------------------------------------------------------------------------------------------------------------------------------------------------------------------------------------------------o----------------------------------------------------------------------------------------------------------------
-----------------------------SQSQ----------------------X-----------------------------------[]-------------------------S--------E-------------------------------------------E----------------------------------------------S----X----------------------------------------------------------------------------E----[]-----------------------------------------------------SSSS---E----------------------------E--------oo-----E--------SSSSSS----------------------------------------------[]----------S---------------------E---------------------------------------------------------o-------oo--?-SS--------oo----o----------------------------oooo-----------------------------------------[]X----------------------------X-------------XXXS--SQ-------------------------XXXX--------------------------------------------------------XX-XX------------oo----------------------------------------------------------------------------XXXX----------oo--------------------------------------------------------------Q-----XX-----------------------------------E----SSSSSS------------------------------SQSSSSSSS-----------SS--------------------------------EX--------------E--o-------------oooS------ooo----SS--------------------------------EX---------------------E---X---S-------------------------X--------------------------------------E----------------X---E-------------------------S-SSS-----------------------------------------------E-E-------------------------------------------E------------------------------S---------S--------E------------SSSSSS
------------------------------------------------------XX---------------XX----SS----X-------XXX----------XXX--XXX------SS------<>----------SS?SS-------E---SSSSSSQS--------<>---Q-Q--Q--Q--QSQQ-----------------------Q--------XXS--QQQ--------SSQ------------------------E--S------------X----S----S-S-----<>----[]------------S?S------E--S--------?-QQ?SSQQ-----------------<>-----------SSS----------E--<>--------------<>-------------------S------------>-------------E-------------[]X-SS?----------------------EE--<>------XXXX----------------------------------------XX-----SS----E--------S----SSS-------------------------------------------XXXX---------------------E------------[]X-------o---------------------------------XXXXX--------------------XXX----------------------XXX----------------------------------------XXX-XX----------E-------------S-S----------------?SSSSS-------S--SQS--QQ--Q--Q------------XXX-------------------------QQ--------E----------SSSS------S-S-----XX--X-----SSSSSS------------SS-------------------S?SQ------<>----------------S----------XXXX-----------------------------------------------E----S---------<>X-----E-------<>-----------------SSSS--<>--------------S-----E--------------------<>X-S------------------<>--XXX---------------------------XX-------QQQ--QQQQ----------------E----<>---------------XX--<>-----QQQQ-------------------------------------------------S-----S-----------<>-S---------S-----E-------------o------------<>-----------------------------S--ooo---SS---E----<>------------------
-----------------------------------------------------XXX---------------------------X------------------------------------------[]---------XS----------<>-------------------[]---------------------------------E---------------XXXS-------------------------E-------------<>---------------X-----------------[]----<>------------S-------<>-------------------------------------[]------------------E--E-----[]------E-------[]----------------------E------XX[]------------<>-------------[]X-----------------------XXXXX--[]---------------------------E-----------------XX---XX----------<>----------EE-----------------------------------------------------------------------<>------------[]X------------------<>--------------------XXXXXX---------------------------------------------------------------------------------------XXXX-XX---------<>---------E-EE-----E--------XX---------------------------------------------------------------------------------<>---------------------------XXX--XX----------------------------XX--X---S----------------[]---------------------------E-------------------------------------------------<>--------------[]X----<>-------[]-----<>----------------[]-------------------<>--------------------[]X----E-E----<>-------[]-XXXX--------------------------XXX-------------------------------<>----[]-------------EXXX--[]---------------------E---------------------------------------------E-----X--[]-SX-------------<>--------------------------[]---------------------XX--------E--E-------<>----[]------------------
-------------X--------------------------------------XXXX---------------------------X----------------------------E-------------[]---------XXX---------[]-------------------[]-----------------------X--------<>--------------XXXXS------------------------<>-------------[]---------------X-----------------[]----[]--------------------[]-------------------------------------[]-----------------<>-<>--X--[]-----<>-------[]---------------------<>--------[]------------[]-------------[]S------------------------------[]--------------------------<>----------------XXXXX-XX----------[]-----------------------------------------------------------------------------------[]-----------X[]X------------------[]------------------XXXXXXXX--------------------------------------------------------------------------------------XXXXX-XX---------[]--------<>----------------XXX---X---------------------------------------X----XXXX-----------------------------[]--------------------------XXXX---XXX--------X------------E---XXX--X--------------------[]-----------------------------------------------------------------------------[]--------------[]X----[]-------[]-----[]----------------[]-------------------[]-------------------X[]X---<>------[]-------[]XXXXX-------------------------XXXX----X--------------------------[]----[]-----------EXXXXX--[]--------------------<>------------------------------X-------------<>--------[]ESX-------------[]---------X----------------[]---------XXX---------XXX------------------[]----[]------------------
-------------X---------EE-E---------EE-E-----------XXXXX------------E-E-X----------X------ooo-----------------------E-E----E--[]---------XXX-----EE--[]-------------------[]----E-------E-E--------X-E-EE---[]-E-E---------XXXXXS------E-E--EE--------E--[]---E-E-------[]---------------X-----E-----------[]----[]-----------X--------[]-E-E-E-------------------------------[]--E-EE----EE-----[]-[]--X--[]-----[]-------[]----------------E--E-[]-EE-----[]----------E-[]-------------[]S------------------------------[]---ooo--------------------[]---------------XXXXX--XX---E-E----[]------------------------------EE----------------------------------------------E----[]----------XX[]X------------------[]----------------XXXXXXXXXX--S-S?--XX---------------------------------------------------------------------------XXXXXX-XX---EE-E--[]--------[]-------------E-XXXX-E-X-----EE-E-------------------------E-E--X--------------------------E-----E----[]------------------E-E----XXXXX--XXXX---E---XX---------------XXXX--XX------E-E-------E--[]-----------------------------------------------------------------------EE-E--[]--------------[]X----[]-------[]--E--[]-EE-E----EE-E---[]-------E-EE--------[]----E-------------XX[]X---[]------[]-------[]XXXXX----E-----E-E-----------XXXXX----X----EE-E---E-E------------[]----[]-----------XXXXXX--[]----EE-E------------[]------------------------E-E---X-----E--E----[]-EE-----[]SSX-----EE-E----[]---------X----------------[]--------------EE-E-E-XXXX------------E---E[]E---[]-E--E---------E-E-
X---XXXXXXXX-X---XXXXXXXXXXXXXXXXXXXXXXXXXXX--X-XXXXXXXXXXXXXXXXXXXXXXXXXXXXXXXXXXXX--XXXXXXX----XXXXXXX--------XXXXXXXXXXXXXXXXXXXXXXXXXXXXXXXXXXXXXXXXXXXXXXXXXXXXXXXXXXXXXXXXXXXXXXXXXXXXXXXXXXXXXXXXXXXXXXXXXXXXXXXXXXXXXXXXX-XXXXXXXXXXXXXXXXXXXXXXXXXXXXXXXXXXXXXXXXXXXXXXXXXXXXXXXXXXXXXXXXXXXXXXXXXXXXXXXXXXXXXXXXXXXXXXXXXXXXXXXXXXXXXXXXXXXXXXXXXXX----XXXXXXXXX--XXXXXXXXXXXXXXXXXXXXXXXXXXX-X--XXXXXXXXXXXXXXXXXXXXXXXXXXXXXXXXXXXXXXXXXXXXXXXX-XXXXXXXXXXXXXXXXXXXXXXXXXXXXXXXXXXXXXXXXXXXXXXXXX-XXXXX----XXXXXXXXXXX------------------XXXXXX-XXXX-XXXXXXXXXXXXX-XXXXXXXXXXXXXXXXXXXXXXXXXXXXXXX---XXXX-XXXXXXXXXXXXXXXXXXXXXXXXXX----XXXX-----X--XXXXXXXXXXXXXXXXXXXXXXXXXXXXX-XXX-XXXXXXXXX-XXXXXXXXXXX---X-XXXXXXXXXXXXXXXXXX--S---XXXXXXX---X--X-------XXXXX---XXXX-------------------------X------XX---XXX---XXXXXXXXXXXXXXXXXXXXXXXXXXXXXXXXXXXXXXXX-XXXXXXXXXXXXXXXXXXXXXXXXXXXXXXXXXXXXXXXXXXXXXXXXXXXXXXXX------------XXXXXXX---XXXXXXXXXXXXXXXXXXXXXXXXXXXXXXXXXXXXXXXXXXXXXXXEXXXXXXXXXXXXXXXXX-XXXXX-XXXXXXXX-XXXXXXXXXXXXXXXXXXXXXXXXXXXXXXXXXXXXXXXXX---XXXXXXXX------XXXXXXXXXXXXXXXXXXXXXXXXXXXXXXXXXXXXXXXXXXXXXXXXXXXXXXXXXXXXXXXXXXXXXXXXXXXXXXXXXXXXXXXXXXXXXXXXXXXXXXXXXXXXXXXXXXXXXXXXXXXXXXXXXXX-XXXXXXXXXXXXXXXXXXXXXXXXXXXXXXXXXXXXXXXXXXXXXXXXXXXXXXXXXX---XXXXXXXXXXX-XXXXXXXXXXXXXXXXXXXXXXXXXX-XXXXXXXXXXXXXXXXXXXXXXXXXXXXXXXXXXXXXXXXX--XXXXXXXXXXXXXXXXXXXXXXXXXXXXXXXXXXXXXXXXXXXXXXXXXXXXXXXXXXXXXXXXXSSX--XXXXXXXXXXXXXXXXXXXXXXXXXXXXXXXXXXXXXXXXXXXXXXXXX-----XXXXXXXXXXXXXXXXXXXXXXXXXXXXXXXXXXXXXXXXXXXXXXXXXXXXXXXX