------------------------------------------------------------------------------------------------------------------------------------------------------------------------------------------------------------------------------------------------------------------------------------------------------------------------------------------------------------------------------------------------------------------------------------------------------------------------------------------------------------------------------------------------------------------------------------------------------------------------------------------------------------------------------------------------------------------------------------------------------------------------------------------------------------------------------------------------------------------------------------------------------------------------------------------------------------------------------------------------------------------------------------------------------------------------------------------------------------------------------------------------------------------------------------------------------------------------------------------------------------------------------------------------------------------------------------------------------------------------------------------------------------------------------------------------------------------------------------------------------------------------------------------------------------------------
-------------------------------------------------------------------------------------------------------------------------------------------------------------------------------------------------------------------------------------------------------------------------------------------------------------------------------------------------------------------------------------------------------------------------------------------------------------------------------------------------------------------------------------------------------S----------------------------------------------------------------------------------------------------------------------------------------------------------------------------------------------------------------------------------------------------------------------------------------------------------------------------------------------------------------------------------------------------------------------------------------------------------------------------------------------------------------------------------------------------------------------------------------------------------------------------------------------------------------------------------------------------------------------------------------------------------------------------------------------------------------------------------------------------------------------------------------------------------------------------------------------------------------------------------------------------------------
--------------------------------------------------------SSSSSSSSSS-------SSSSSSSSSSS--------------------------------------------------------------------------------------------------------------------------------------------------------------------------------------------------------------------------------------------------oo-------------------------------------------------------------------------------------------------------------------------------------------------------------------------------------------------------------S-S--oo------------------------------------------------SSSSSSSSSSSSSSSSSSSSSSSSSSSSSSSSSSSSSSSSSSSSSSSSSSSSSSSS---------------------------------------------------------------------------------------------------------------------------------------------------------------------------------------------------------------------oo----------------------------------------------------------------------------------------------------------------------------------------------------------------------------------------------------------------------------------------------------------oo-------------------------------------------------------------------------------------------------------------------------SSSSSSSSSSSSSSSSSSSSSSSSSSSSSSSSSSSSSSSSSSSSSSSSSSSSSSSS----------------------------------------------------------------------------------------------------------------SSSSS----SSSESSSSS----------------------------------------------------------------------------------------------
------------------------------------------------------------------------------------------------------------------------ooo-------------------------------------------------------------------------------------------------------------------------------------------------------------------------------------------------------?--------------------------------------------------------------------------------------------------------------------------------------------------------------------------------------------------------------------S-XXXX-------------------------------------------------SSSS------SS--SSS-SSSSSSSS---SSSS------SSSS-------------------------------------o---------------------------------------------------------------------------------------------------------------------------------------------------------------------------S--------------XXX--------------------------------------------------------------------------------------------------------------------------------------------------------------------------------------------------------------------------------------------------------XX----------------------------------------------------------------------------------------------------------------------------------------------------------------------------------------------------------------------------------------------------------------------------------------------------SSS----Q-?-S--SS?--o----oS------------------------------------------------------------------------------------
------------------------------------------------------------------------------------oo------------------------------------------------------------------------Eooo---------------------------------------------------------------------------------------------------------------------------------------------------------Eooo------------------------------o-----------------------------oooo--oo---------------------------------------------------Eoo--------------------------------o------------------------------------------------------------S-------------------------------------------------------SSSS--E---SS--SSS-SSSSSSSS---SSSS--E---SSSS---------------------------------------------------------------------------------------------------E-------------------------------------------------------------------------------------------------------------------oo--------------------------------------------------------------------------------------------------------------------------------------------------------------------------------------------------o------------------------------------------------------------------X-----------------------------------------ooo--------------------------------------E-------------------------------------S-------------------------------------------------------------------------------------------------------------------------------------------------------------------------SSS--E----SS--SS--S-----ES------------------------------------------------------------------------------------
-----------QQQQ------------------------SSSS-------------------------SSSSSSSSSSS-------------E--S---XXXo---XXX-------------XXXX--------------------------------XXXX------SS---SS--------------SSS----------------------------Q-Q-----------------SS---------------SS---?SSS--------------SSSSS---Q-SSSS---------------------XXXXX-----XXX--------o--------------------------------------XXXX------------E---------------------------S------------------XXSXS---------------------------XX------------------------------------------?------------------S---------------------------------------------------------S----------------SSSSSSSS---X-----SS---------------S--------------------SS---SS------------------------------SSSS--------SS------SSSS-------SQS------SSSSS------------SQS---------------XXXX-------S-Q----------------?SSS----------------------------------S---XXXXX-------X--------------------------------------SSS---?-SSS------------SSSE?SSS-------------E---------Q?SSSS---SSSSS---------------------------------------------------?SSSS--------Q-Q-----------XXX-------------------------------------XXX-------------XXX-------XX-----------------------------------S----------------------------SS?S-------------SQSSSSS--------------------------------S----------oooo--------------S?----------oooooo--------X---------------------------------------------------------------------------------------------------------------S-------SS-----------SS--SSSS---------------------SSSSSSS-S----S--------------------S---?-------------SSSSSS-----
-------------------------------------------------------------------------------------------<>---------------------XXX-----------------------XXX-------------------------ES--------------------------------------------------------------------------------------------------------------------------------------------XX-------------XXXSS--------------------XX--------------------------SSSS--------XX---------------------------------------------------------------ooooo---------------------------------oo--------------------------------------S---------------------------------------------------------S-----S-----------SS-----SS-------SS------------------------------------SS---SS--------------------------------------------------------------------------------------------------------------------------------------------------------------------------------------------SXS-----------------------------------------------------------------------------------------XX-----------------------------------------------------------------------------------------------------------------------------------XXXX------------------oo--XXXSS---------------------------------------XXX--o---o----------------------------------------------------------------------------------------------------------------------------------------------------------------------------------------------------------------------------------------------------SS-----------SS----------------------------------E-------------------------------------------------------
---XX-----------------------X--------------------------------------------------------------[]-----------------------------------XX---------------------------------------S-----------------------------------------------------------------------------------------------------------------------------------------------------------XXX--------------------------------------------------------------XXX----------------------X-S-----------------------------------------------------------------------------E-------------------------------------------------------E---------------------------------------S-----------------SS-----S--------SS------------------------------------SS---S--------------------------------------------------------------------------------------------------------------------------------------------------------------------------------------------XSXX--------------------------------------------------------------------------------------ooo-------------------------------------------------------------------------------------------------------------------------------------XXXX---------------------XXXXX-----------------------------------------XXXXXX-XXX----------o---------------------------------------------------------So---------SSSSS-------------oo----------SSSSSS-------------------------------------------------------------------------------------------------------------------XSSS-o-------SS-----------SS------------------------------------------------------------------------------------------
--XXX--------------------------------------------------------------o-----------------------[]----------------------------------XXX-------------------oo------------------S-------------E-----SSS----------------E-------------------------------------------------------------------------------------------------------------------XXXS--------------------------XXX----------------------------------------------------------X-----------oooo------------------------------------------------------------E---S-SQ-----S-----------------S-SQ-------o-------------E--<>------------------E--------------------SE----------ooooooSS--------------SS-----?-----o---SS-------------------SS---So-----------------E--------------------------------------------------------------------------------------------------------------------------------------------------------S---------------XXXXX--------S-----------------------E----SQ-------------------------SSSSS----------------------------------------------------------------------------------------------------------------------------------------SSSSSS---------XXXXXX--------------------XXXXXX-----------------S------E-------------------------------------------------------------E------------------------S------------------SSSSS---------------------------SSSS-------XX-----------------------------------------------------E--------------E----------------S-------------------XXX-S-----ooooSS----oo--??-SS-------------------------------------------------------S----------------------------------
-XXXX------SSSQS-------X--------Q--------------------X----SSS---------------SSSS----------SXXS----------XXX-XXXX--------------XXXXX-----------------------XXXXXXXXX-----SS--SSS-------<>-----------X--E--------<>-----------QQ?Q------------------Q-------------SSS-------------------XXE?-QQQ-QQQQ-Q--Q--Q--SQQ-------------------XXXXX----------------XXXX------------------------------XXXXX---------X----------QSQS--SS----X-------------------XXX--SS----------<>-------------------XXX---------E----<>------------------S?S------E-------------SS?--SS------<>--[]--------S--------<>--------------------SSS---------?SSSSSSS---SSSSSSS----SSSSSSSS----SSS--SS-----------XX--X----S---SSS------E--------<>-----E------------SS--------------------S--S?S-------S-------------X----------------XXX---XX-------SS-----------SQQQ------------------------------E-----------SS-------XXXXXX-------------------------------<>-------Q--Q--S---------------------------S---XXX---SS--------QQQQ--QQQQ-------------------------------------QQQ---E--QQQ--QQQQ----------QQQ---------------S--------------------------SS----XXXXXX--------------------XXXXXX--------------------E--<>-------------XX------ooo------XXXXX---So--------XX-----S----X--------------------------------XSSS-----X----------------X--SS------XXX--------------XXX---------------------------EQQ---------------E------<>-------------<>-----------------------------------XXXX-SSS---SSSSSSS----------SS--SSSS---------------------------------SS--------------------S-ooo-----------------o------
XXXXX------------------X----S------------------------XXX-------------------EE---------E-------------------------------------XXXXXXXX-----------------------------------X--------------[]-----------X-<>--------[]--------------------------------------------------------------------XXX------------------------------------------XXXXXX-SS---------------------------------------------------E---------X-------------------E--X------------------------------------[]------------E-----------------<>----[]--------------------------<>--------------------------[]--[]-----------------[]--------------------------XX----------------------------SSSS---XX------------------XXX--XX-----E---------<>--------[]----<>---------------------X---------------------------------------X------------------------XXXX-------------------------------------------------<>-------------------XXXXXXX----S--------------------------[]----------------E--------------------------------------------------------------------X------------E----------------------------------------------------------------XX----------------------XXXXXX-------------------XXXXXXX-------------------<>--[]-----------------------E---------------------E-XXX--XX---E--E----------------E------E------EXX------EXX---------------XX--------XXX<>-XX----------XXXX--------------------------------------------<>------[]-------------[]-------------E----------E---------XXXXX---S--------------------------S--------------------------------------------------------S----------XX----------------
XXXXXX-----------------XXXX-X----------------------X-XXX-----------------------E---X-<>------------------------o----------XXXXXXXXXX-------X--------------------------XX--------------[]-----------X-[]--------[]----------------------------------------------------------X--------XXXX--------------------------------------<>-XXXXXXX---------------------o-X------------------------------XXXX------X--------------------X-X------------------------------------[]-----------<>-----<>----------[]----[]--------------------------[]--------------------------[]--[]-----------------[]--------------------------XX----------------------------SSSS----------------------XXXX--XXXX-------------[]--------[]----[]-----------------X---X---------------------------------------X--------------------------o--------------------------------------------------[]------------------XXXXXXXX---------------------<>--------[]---------------<>--------------------------------------------------------------------X-----------<>------------------------------------------------------------X---XXX----------------E----XXXXXX------------------XXXXXXXX-------------------[]--[]-----------------XXXXXXXX-----------oo------XXXXXX--XX----------------------<>-----<>------XXX------XXX--------------XXX-------XXXX[]------------XXXXX--------------------------------------------[]------[]-------------[]------------<>---------<>--------XXXXXX--SS-------------------------------------------------------------------X---X---------------------XXX---X------------
XXXXXX----EE----E--EE--XXXX--------------------------XXX--------------------------XX-[]-E---------------------------------XXXXXXXXXX---EE-XX-------------------------XX-E----------E--[]-----------X-[]----E---[]------------------------------------EE------E-E-------E---X-----EEXXXXX----------------------E---------------[]XXXXXXXX------------XXX-----XXX-----------------XXXX-XXXXXX-------------S------EE-------EE-----X------------------------------------[]-----------[]-----[]---EE-E---[]----[]--------------------------[]------------E-E-------EE--[]--[]--------E--------[]--------------E-----------XX--------E-EE---------------E----oo--------EE----E----XXXXXE-XXXX-------------[]E-------[]----[]------E-E------XXX-E-X-X----------------------E---------EE---X---------------------------?-----------------------------------EEE----EE-E---[]-----------------XXXXXXXXX----------E----EE----[]-E---E--[]-S---E---------[]-------E-E-E----------------------EE-E--X---E-----------------EE-E--X---------E-[]------------------------------------------------------------XE--XXX-----------------E---XXXXXX--------------------XXXXXX------X---------E--[]--[]-----------------------------------XXXE----XXXXXXXE-X---------------------E-[]-----[]-----XXXX-----XXXX-------------XXXX--E----XXXX[]-----------XXXXX--------EE-------E--E------------------E-EE--[]---E--[]-------------[]------------[]---------[]-E-EE--XXXXXXX--SS---E-E---------E---------------EE-E----EE--------EE------E-EE------EE--X---------E----------XXXX---X-E----------
XXXXX-XXXXXXXXXXXXXXXXXXXXXXX---XXXXXXXXXX-XXXXXXXX--XXXXXXXXXXXXXXX--XXXXXXXXXXXXXXXXXXXXXXX----X-XXXX---------XX-XXX-XXXXXXXXXXXXXXXXXXXXXXXXXXXX---XXXXX--------XXXX-XXXXXXXXXXXXXXXXXXXXXXXXX--XXXXXXXXXXXXXXXXXXXXXXXXXXXXXXXXXXXXXXXXXXXXXXXXXXXXXXXXXXXXXXXXXXXXXXXXXXXXXXXXXXXXXXXXXXXXXXXXXX---XXXXXXXXXX--XXXX----XXXXXXXXXXXXX----XXXXX-----------XXX----------------------------------------X--XXXXXXXXXXXXXXXXXXXXX---XXXXXXX----XX-X----XXXXXX----XXXXXXXXXXXXXXXXXXXXXXXXXX--XXXXXXXXXXXXXXXXXXXXXXXXXX-XXXXXXXXXXXXXXXXXXXXX----XX-XXXXXXXXXXXXXXXXXXXXXXXXXXXXXXXXXXXX--XXXXXXXXXXX-XXXXXXXXXXXXXXXXXXXXXXXXXXXXXXXXXXXXXXXX-XXXXXXXXXXX----XXXXXXXXXXXXXXXXXXXX--XXXXXXXXXXXX-XXXXXXXXXXXXXXXXXXXXXXXXX--XXXXXXXXXXXXXXXXXXXXXXXXXXXXX--XXXXXXXXXXXXXXXXXXXXXXXXXXXXXXXXXXXX------------------XXXXXXXXXXXXXXXXXXXXXXXXXXXXXXXXXXXXXXXXXXXXXXXXXXXXXXXX-XXX------XXXXXXXXXXXXXXXXXXXXXXXXXXXXXXXXXXXXXXXXXXXXXXXXXXXXXXXXXXXXXXXXXXXXXXXXXXXXXXXXXXXXX------XXXXXXXXXXXXXXXXXXXXXXX-----XXXXXXXXXXXXXXXXXXXXXXXXXXXXXXXXXXXXX--XXXXXXXXXXXX----XXXXXXXXXX--XXXXXXXXXXXXXXXXXXXXXXXXXXXXXX--XXXX-XX-XXXXXXXXXXXXXXXXXXXXXXXXXXX-XXXXXXXXXXXXXXXXXXXXXXXXXXXXXXXXXXXXXXXXXXXXXXXX------------------------XXXXXXXXXXXXXXXXXXXXXXXXXXXXXXXXXXXXXXXXXXXXXXXXXXXXXXXXXXXXXXXXX----XXXXXXXXXXXXXXXXXXXXXXX-XXX----XXXXXXXXXXXXX--XXXXXXXXXXXXXXXXXXXXXXXXXXXXXXXXXXXXXXXXXXXXXXXXXXXXXXXXXXXXXXXXXXXXXXXXXXXXXXXXXXXXXXXXXXXXXXXXXXXXXXXX--SSXXXXXXXXXXXXXXXXXXXXXXXXXXXXXXXXXXXXXXXXXXXXXXXXXXXXXXXXXXXXXXXXXXXXXXXXXXXXXXXXXXXXXXXXXXXXXXXXXXXXXXXXXXXXXXXXX