---------------------------------------------------------------------------------------------------------------------------------------------------------------------------------------------------------------E--------------------------------------------------------------------------------------------------------------------------------------------------------------------------------------------------------------------------------------------------------------------------------------------------------------------------------------------------------------------------------------------------------------------------------------------------------------------------------------------------------------------------------------------------------------------------------------------------------------------------------------------------------------------------------------------------------------------------------------------------------------------------------------------------------------------------------------------------------------------------------------------------------------------------------------------------------------------------------------------------------------------------------------------------------------------------------------------------------------------------------------------------------------------------------------------------------------------------------------------------------------------------------------------------------------------------------------------------------
------------------------------------------------------------------------------------------------------------------------------------------------------------------------------------------------------------------------------------------------------------------------------------------------------------------------------------------------------------------------------------------------------------------------------------------------------------------------------------------------------------------------------------------------------------------------------------------------------------------------------------------------------------------------------------------------------------------------------------------------------------------------------------------------------------------------------------------------------------------------------------------------------------------------------------------------------------------------------------------------------------------------------------------------------------------------------------------------------------------------------------------------------------------------------------------------------------------------------------------------------------------------------------------------------------------------------------------------------------------------------------------------------------------------------------------------------------------------------------------------------------------------------------------------------------------------
-------------------------------------------------------------------------------------------------------------------------------------------------------------oo-------------------------------------------------------------------------------------------------------------------------------------------------------------------------------------------------------------SSSSSSSSSS------------------------------------------------------------------------------------------------------------------------oo---------------------------------------------------------------------------------------------------------------------------------------------------------------------------------------------------------------------------------------------------------------------------------------------------------------------------------------------------------------------------------------------------------------------------------oo-------------------------------------SSSSSSSSSSSSSSSSSSSSSSSSSSSS----oo------------------------------------------------------------------------------SSSSSSSSSSSSSSSSSSSSSSSSSSSS------------------------------------------------------------------------------------------------------------------------------------------------------------------------------------------------------------------------------------------------------------------------------------------------------------------------------------------------------------------ooo---------------------------------------------------------------
--------------------------------------------------------------------------------------------------------------------------------------------------oo------------------------XXX----------------o-----------------------------------------------------------------------------------------------------------------------------------------------------------------------------------------------------------------------------------------o------------------------------------------------------Q---------?-----------------------------------------------------------------------------------------------------------------------------------------------------------------------------------------------------------------------------------------------------------------------------------------------------------------------------------------------------------------------------------------------------------------------------------------------------------------------------------------------------------------E--E----------------------------------------------------------------------------------------------------------------------------------SS----------------------------------------------------------------------------------------------------------------------------------------------------------------------------------------------------------------------------------------------------------------------------------------------------------------------------------XXXX--------------------------------------------------------------
XXX--------------------------------------X-----------------------------------------------------------------------------------------------------------o-------------------------------------------------------E--------------------------------------------------------------------------------------------------------------------------------------------------------------------------------------------------------------------------E------------------------------------------------------------oo----------------------------------------------------------------------------------------------------------------------------------------------------------------------------------oo-------------------------------------------------------------------------------------------------------------------------------------------------------------------------------------------------------------------------------------E----E-------------------------------------------------------------------------------------XXXXXXX--------------------------------------------------------------------------------------------------------------------------------SS----X-----------------------------------------------------------------------------------------------------------------------------------o-----------------------------------------------------------Eooo---------------------------------------------------------------------------------------------------------------------------------ooo--------------------------------------------------------
-----------------------------------------------------------------SSS-------------------------------------------------SS----SSSSSSSSS?S-------------XXXXX------E----------S-------------------SSS---S--SSS---XXX-------------------------SSSS------------------------------------------------------------SSS---SSS------------------------------------------SSS---XXX----------------------------------------------SSS------------------SSS----------------------------------------------------------XXXX--------------------------------SSSSSSS---------SQSSSS-----------------------------SSS----------------------------------SSS-----------------------------------------X-----------------------------------------------------------------o-----Q--------Q------------------SSS--------------------SSSS-------------SS------------------------------------------------------------------SSSSS------------------SSSSSSSSS---S----SQS---------XX----------------------------------------o---------QQ--------------------------------------------------------------------------------------------------S------ooooooo------------------------?SS-----------------SSQ--------------------------------------------------------------------SSS----------------------------------------------------------------X-----------------------------------------------------------XXXXX--------------------------------------------------------------------------------------------------------------------------------XXXSSSQSS--------------------------------------------------
-----------------------------------E--E--------XXXX-o--------------------------------------------------------------------------------------------------------<>-----------------------------------------------------------------------------------------------------------------o--------------------------------------------------------------------------------XXXX-------------------------------------------------------------------------------------------------------------------------XXX---------------------------------------------------------------------E-------------------------------------------------------------------------ooo-------------------------------------------XX------------------------------------E-------------------------------------------ESS-------------------------------------------------------------------------------------------------------------------------------------------------------------XXS-----------------------------------E----------------------------------------------ooo----------------------------------------------------------------SX--o--------------------------------------------------------------------------------o-----------------------------------------------------------------------------------------------------------------o---------------------o-----------------------------X----------------------------------------------------------------------------------------------------------------------------------------------------------------------------------------------------
----SS--o------------------------XXXXXXX-----------XXXX--------------------------------------------------------------------------------o---------------------[]----------------------------------------------------o--------------------------------------------------------------------------------------------------------------------------------------------EXXX---------------------------------------------------------------------------------------------------------------oo------------------------XX------------------------------------------------------<>----------------------------------------------------------------------------------------------------------------------XXX---o------------------------E------<>-------------------------------------------SSS-----------------------XSS----------------------------------------------------------------------------------------------------------------------------------XXXX----------------------------------<>[----------------------------------------------------------------------------------------XX------------------XX--S---------SSSS--------------------------------------------S----------------E--------------------------------------------------------------X-----------------------------------------------------------XXX----------oo-------------------------------------XX---------XX----------------------------------------------------------------------------------------------------------------------------------------------------------------------------------------X
----------------------------------------------------------------------E----------------------------------------------------E------------------SSSS-----------[]------------------------E----------E------------------------XX--------------------------------------------------------------------E--S----------------------------------------------------E-EEEEEXXXX------------------------------------S--------------------------------------E----------------SSSSSSS------------------o--Q---------------XXX------------------------------------------------------[]----------S-SQ----------E-----------X---------------E------------------------------------------------------------------------------------------------E------[]-------------------------------------------SSS--S-SQ----------------XXX--o------E--------E---------E------SSSSSSS-----------------------------------------S----------------------------------------------XXXXS----------------------------------[]X-----------------------------------------------------So-----E---------------------------X-------------------XX------------SSSS--------------SSSSSSS------------E-----E--------------------<>-------------S-------------E-------------------------------SX------------------------------------------------------------------XX------------o---------------------E---------XXX------------XXX-------o---------------------------------------------------------XXX----------------E----------XXQ---------------------------------------------------------------------------------XX
XXX---SS---------------<>---X----------ooo---------------------------<>-------------oooo-------X--X------------------QQ---------X---SSS----------------SS----XX----------S-------E----<>---------XXX----XXXX--XXXXX---------------------SS-S-------------E----------X---------------------------<>----<>SSS--------------------Q--------------------QQQ--------XXXXX-------------------------------QQ----------QQSQQS--------------------S----<>---------------------------------X--X------------------SS---XXX------------------------S-----------XQ---S?S----------XX-----------------------<>----------XX-Q------------<>--------------------------------------XX---XXX---------XXXXXXXX----------------------------------------[]---------------S---SS--S?S-----X-----------SSS---------------------XXXX--------<>---S---<>-----E-E-----------------S----X----------Q----------E-----------------------------------SSSS----X-S--S?S------XXXXXX-------------Q----Q-Q-------------[]XX---X------E?SQQ---------------E---------------------------<>--------------------------XX--------------S----XX-XSSS-------------------------------------S--E-E<>----<>----SSS--------E--SS[]-----------------------E--<>------------------------------XXX-XX---X-------------------------------XXX------------------------------------------------------------<>--------XXXX-----XXXX-----------------------Q--Q------------------------XXX----------------------QQQ----------<>----------XX------------------------------S?S-----------QQQ--QQQ----------------------------XXXX
XXX----S---------E-----[]----------------E---------------------------[]-----------------------XX--XX------------------------X---X----------X---------E----E--XX-SSS-------------<>----[]--------XXXX----------------------------------------------------<>--------------------------XXXX--------[]----[]-------------------------------------------------------XXXXX--------------------------------------------------------------------------[]----E-E-----------------------E--X--XX--------------------XXXXX-XXX-------------------------------XX-----------------XX--XX-------------------[]--E------XXX--------------[]----------XX---------------E----------------------------------------------------------------XX--E------[]-------E-----------------------X---X--------------------------E---XXXXX--------[]-------[]----<><>----------------------X--XX----------------<>------------------E-------X--------E------EX------------XXXXXXX-------E--------------------------[]XX---X-------------------------<>-----------E-----XX--------[]--------------------X----XXX-------------------XX--------E------------------X----------------<><>[]----[]--------------<>----[]----------------------<>--[]-----------------------------XXXX-XX---XX----------E------------------------------------o---------------------------------------------[]-------XXXXX--------------------------------------------------------------------------------------------------[]--------XXXX---------------------------X----------------------------------------------E----EXXXX
X-X----SSS------<>-----[]--------XXXXXXXXXX--------------------------[]------------X---------XXX--XXXX-------------X--------X---X---------XX-------------E---XX-----------------[]---->--------XXXX-----------------------------------------------------[]--------------------------------------[]----[]-------------------------------------------------------XXXXX--------------------------------------------------------------------------[]---<>----------------------------X--XXX------------------XXXXXX-XXX-X--------------------S-------XXX-----------------XX--XXXX-----------------[]-<>-----XXXX--------------[]---------XXX--------------<>-----X--------------------------------------------------------------E------[]------<>---------------------XEX---X-------------------------<>---XXXXX--------[]-------[]----[][]----------------------X--XXXX--------------[]---X---------------------XXX---------------X-----------XXXXXXXX--------X-------------------------[]SX---XX------------------------[]----------<>----XXX--------[]------------------XXX-----X--------------------XXX------XXXX---------------------------------[][][]----[]--------------[]----[]----------------------[]--[]----------------------------XXXXX-XX---XX----------------------------------XXXX--------XXXXXXXXXX-------------------------------------[]------XXXXXX--------------------------------------------------------------------------------------------------[]-------XXXXX--------------------------XX---------------------------------------------<>---?XXXXX
XXXX------------[]-----[]-----------------------------oo-------------[]-------EE-E-X--------XXXX--XXXX-------X---E-X--------X---X----EE--XXX-----------------XX-----E---E--EE-E-[]------------XXXXX--ooo-----------------------------E------------------[]-------------------------------E-EE---[]----[]-----------X--------------------------------------------XXXX-------X----EE-E-----------EE-E------------------------------------EE-E---[]---[]-E---E-EE-------------------X--XXXX------------------XXXXX?XXXX?------EE-E-EE-E------------XXXX----E------------XXE-XXXX------E----------[]-[]----XXXXX-----------E--[]--------XX----------------[]-----X-------------XXXXXXXX------------------------------------------------[]------[]---------------------X-X---X------E-E----------------[]--XXXXXX--------[]-------[]----[][]-------------E--------X--XXXX-------EE-E---[]-E-X-----------------E---XXXE--------------X----------XXXXXXXXX-------XX-----E--EE---------------[]SX---X-------E-------E--E-E----[]----------[]---XXXX--------[]------------------XXX-----X-------------E--EE--XXX-----------------------------------------E-[][][]----[]-E------------[]----[]----------------------[]--[]---------------------------XXXXXX-XXXE-XXX-----------------EE-E-----------------------------------------------------------------------[]-----XXXXXXX---------------------------o----EE-E--------------------------------------------------------------[]------XXXXXX-----------------X-------XXX-E-----------------E-E---------------E-------[]---XXXXXX
XXX-------XXXXXXXXXXXXXXXXXX--------------------------XX--XXXXXXXXXXXXX--XXXXXXXXXXXXXXXXXXXXXXXXXXXXXXXXXXXXXXXXXXXXXXXXXXXo---XXXXXXXXXXXXXXX---XXX-XX-XX-XXXXX---XXXXXXXXXXXXXXXXXXXXXXXXXXXXXXXXXXXX------------------------XXXXXXXXXXXXXXXXXXXXXXXXXXXX-XXXXXXXXXX-XX-X---XXX------XXXXXXXXXXXXXXXXXXXXXXXXXXXXXXXXXXXXXXXXXX--XXXXXXXXX---XX---XXXXXXXXXXXXXXXXXXXXXXXXXXXXXXXXXXX---XXXXXXXXXXXX-XXXXXXXXXXXXXXX-XXXXXXXXXXXXXXXXXXXXXXXXXXXXXXXXXXXXXXXXX-XXXXXXXXXXXXXXXX--XXXXXXXXXXXXXXX-XXXXXXXXXXXXXXXXXXXXXXXXXXXXXXXXXXXXXXXXXXXXXXXXXXXXXXXXXXXXXXXXXXXXXXXXXXXXXXXXXXXXXXXXXXXXXXXXXXXXXXXXXXXXXXXXXXXXXXXXXXXXXXXXXX-XXXX-------XXXXXXXXXX-X--X---XXX-------------------------XXXXXXXXXXXXXXXX---XXXX-----XXXXXXXXXXXXXXXXXXXXX-------XXXXXXXXXXXXX-XXXXXXXXXXXXXXXXX-XX-XXXXXXXXXXXXXXXX----XXXXXXXXXXXXXXXXXXXXXXXXXXXXXX-X-XXXXXXXXXXXXXXXXXXXXXXXXXXXXXXXXXXXXXXXXXXXXXXXXXX-XXXXXXXXXXXXXXXXXXXXXXXXXXXXXXXXXXXXXXXXXXXXXXXXX--XXXXXXXXXXXXXXXXXXXXXXXXXXXXXXXXXXXXXXX-XXXXXXXXXXXXXXXXXXXXXXXXXXXXXXXXXXXXXXXXXXXXXX----XXXXXXXXXXXXXXXXXXXXXXXXXXXXXXXXXXX-----XXXXXXXXXXXXXXXXXXXXXXXX----XXXX---XXXX---XXXXXXXXXXXXXXXXXXXXXXXXXXXXXX--XXXXXXXXXXXXXXXXXXXXXXXXXXXXXXXXXXXXXXXXXXXXXXXXXXXXXXXXXXXX-XXXXXXXXXXXXXXXXX--X-XXXXX-XXXXXXXXX--XXXXXXXXXXX--XXXX------------XXX-----------------------X-XX---XXXX-XXXXX----XXXXXXXXXXXXXXXXXX-XXXXX--------------------XXXXXXXXXXXXXXXXXXXXXXXXXX--XXX-X----XXXXXXX-X-------------XXXX--XXXXXXXXXXXXXXXXXXXXXXXXXXXX--XXXXXXX-----XXXXXXXXXXXXXXXXXXXXXXXXXXXXXXXXX---XXXXXXXXXXXXXXXXXXXXXXXXXXXX