------------------------------------------------------------------------------------------------------------------------------------------------------------------------------------------------------------------------------------------------------------------------------------------------------------------------------------------------------------------------------------------------------------------------------------------------------------------------------------------------------------------------------------------------------------------------------------------------------------------------------------------------------------------------------------------------------------------------------------------------------------------------------------------------------------------------------------------------------------------------------------------------------------------------------------------------------------------------------------------------------------------------------------------------------------------------------------E------------------------------------------------------S--X--E--E------------------------------------------------------------------------------------------------------------------------------------------------------------------------------------------------------------------------------------------------------------------------------------X------------------------------------------------------------------------------------------------------------------------------
---------------------------------------------------------------XXX------------X------------------------------------------------------------------------------------------------------------------------------------------------------------------------------------------------------------------------------------------------------------------------------------------------------------------------------------------------------------------------------------------------------------------------------------------------------------------------------------------------------------------------------------------------------------------------------------------------------------------------------------------------------------------------------------------------------------------------------------------------------------------------------------------------------------------------------------------------------------------------------------------------------------------------------------------------------------------------------------------------------------------------------------------------------o---------X---------------------------------------------------------------------------------------------------------------------------------------------------------------------------------------------------------------------------------------------------------------------------------------X-X------------------------------------------------------------------------------------------------------------------------------
--------------------------------------------------------SSSSSS-----SSSSSESS------SoS------------------------------------------------------------------------------------------------------------------------------------SSSSSSSS-------------------------------------------------------------------------------------------------------------------------------------------------------------------------------------------------------------------------------------------------------------------------------------------------------------------------------------------------------------------------------------------------------------------------------------------------------------------------------------------------------------------------------------------------------------------------------------------------------------------------------------------------------------------------------------------------------SS----------------------------------------------------------------------------------------------------------------------------------------------------------------------------------------------------XXX----------oo----SSSSSSSSSSSSSSSSSSS-SS?SSS-S----------------------------------------------------------------------------------------------------------------------------------------------------------------------------------------------------------------------ooo-----------------XX----------------------------------------------------------------------------------------------------o---------------------------
----------------------------------------------------------------------------------------------------------------------------------------------------------------------------o-----------------------------------------------------------------------------------------------------------------------------------------------------------------------------------------------------------------------------------------------------------------------------------------------------------------------------------------------o------------------------------------------------------------------------------------------------------------------------------------------------------------------------------------------------------------------------------------------------------------------------o---------------------------------------------------------------------------------------------------------------------------------------------------------------------------------------------------------------------------------------------------------------------------------------------------------------------------------X------XXoX--X---------E--SSSSS-----?oS--SS?-SS?--ooS----------------------------------------------------------------------------------------?--o------------------------------------------------o--------?----------------------------------------------------------------XXXX---------S----------XX-----S----------------------------------------------------------------------------------------------------------------------
------------------------------------------------------------------------------------------------------------------------------------------------------------------------------------------------------------------------------------------------------------------------------------------------------------------------------------------------X------------------------------------------------------------------------------------------------------------------------------------------------------------------------------------E-----------------------------------------------------E----------------------------o--ooo---o----------------------------------------------------------------------------------------------------------------------------------------------------------------------------------------------------------------------------------------------------------------------------------------------X-----?----------------------------------------------------------------------------------o----------------------------------------------------XX---------oo--oo--oo-----XXX--------------------------EXX--------?------------XXX-SSSSS--E---SS--SS--SS----SS------------------------------------------------------------------------------------oo-----------------------------------------E---------------------------------------------------E----------------------------------------------------------------------------------------------------------------------E---------E------------------------------XXX----------------------
---------SSSS-----------------QS-----------------------S--------------------------S--------------------------SSS-------------------------------------------SSSSSSS---------SS---?-?SSS--------------SQQ---------------------o-ooQ?SSS------S-------------------------------------------------------SS-----------------------------------SSSS------SQQS----------Q-----------S------------------XX------------------------------SSSSS-----SSS---Q--------------S---------------------------QQ-----------SS----S---------S-?--SSS---?SSS--SS---SSSSSSSSS---SS--------------------S---------------SSS---------S--------------------------------------------SSSSSS---SSSSSSS?S-----SS-------------------SSS--------------------SSSSSS-------E------SSSS------------------------------------------------SSS--------SS--------------E--oo---XX------------------SSQSSS--------SSSSS---------SSSSSSSSSSS----------------------------------SSS??-----------------------------------------------------------------S---------S---XXXX------------------XXX---SSSSS---SSSSS-----SSSS------XXXXX---------------------------------E--------------XXXXX---------X---------------S----SS-----------SS----SS-----------------------?SSSS--SQQ------------S---SSS-------?-----------------SSS----XX-------------------------S-----------Q--SQSSSSS---------Q---------ooo-------------SSSSS-----SSS--SSSS-------------------------o-----------XXX-----------------------------------------S------------S?Q-------------SQS-SSS---------------SSS---S------SSSS-----XXX--------------------
----------------------------------------------------------------------------------------------------------------------------------------------------------------------------------------------------S-----------------------------------------------------------------------------------------------------------------------------------------------------------------------------------------XXX---------------------------------------------------------------------------------------------------------------------------------------------------S-------------------------------------------------------oo---------------------------------------------------------------------------------------------------------------------------XXX---------------------------------------------------------------------------------<>----------------------------------------------------------------------------------------------------------------EE-?--------------------------------------------------------------------------------------------------------------------------------------------------------o---o----<>--o-----------------o---------XXX-X------o-------SS-----------SS----SS-------------------------------------------------------------------------------------------------------------E-------------------------------------------------------------------------------------------------X--XXX---------------------------XXXX-----E------------------------------SS-------------------SS------------------------------------------ooo----------------
-----------------------------------------------------------o----------------------------------------------------------------------------------------------------------------------------------------S---------------------------------------------------------------------------------------------------------------------------------------------S------------------------------------------XXXX-----------------------------------------------------------E--------------------------------------------------------------------------------------------------------------------------------------------------------------------------------------------------------------------------------------------------------------------------------------------------------------E-------------------------------------------------[]------------------------------------------------------E--------------------------------------XX---------------------------------------------------E------------------------------------------------------------------------------------------------------------------------XXX-XXX---[]-XX---------------------------------X------------SS-----------SS----SS--------------------------------E------------------------------------------E------------XXXX-------------XXXXXXX----------------------------------------SSSSS?S----------------------------------------------------------------------------------------XXXX-----------------------------SS-------------------SS-------------------------------------------------------------
---E--------------o------E---------------------------------------------SSS----------------------------------------------------------------------------------------------SS--------------------------SE-------S-------------o----S-------<>------------SSSSSS-------------------------E-----------------E--------------------------------------------------S---------------------------------XXXXX-------XX--------------------SSSSS---------------------E--<>--------------E--------------------------------------------E------------------------------------------------S------S--------E-----------------------------------------------------------------------------------------------------------------------------------------------------------------------------E--<>-------------------------------------------------[]--------------------------------------------------------------------------------------------XXX------------E-EE------o---------S--------------E--<>-------S----------------------------------------------------E-----------------------------Q---------------------------------------[]-------o----------------------X-----------X-oooooSS-------oo?-SS--QoSS----E------------------------------------------------------------E-----E--<>-----------------------------------------------------------------------------SSSSSS---------S-S------------------------------------------XX-------------------------------------S-------<>-------E-E-----E--SS-----------------?-SS-------------------------------------------------------------
--<>-----QQQ------------<>---SS-------------S----------X-EE-EE-E-------------------------------E--?--------------------------------------------------------SSS-S------------------SQS---------------SSSS--------ES---------SS------E----[]-----Q-Q-------------------------S--------<>--Q--QQQQ-------<>-----------------------XX--X-----QS-------S?S--------E-QQ------------S-------------XXX-XX-------S----------------------------X----S----SSS--E--<>--[]--------E----<>------E-----SSQ-----------<>---S-------S----QS--S?S----XXX-X-----------X----SSS-------------------XX---E----<>---E--S-------------------------------------------------------SS--------XX---S?S------Q-----Q-----Q--QQ---SSS-------------------S----------------XXXX-----------------------<>--[]----------------------E-----------S-XX------XX---XXX---XXXXXXXXX-------QQQ--Q--Q--Q-----------------------ESSSSSSSSSS-------------------------XXX---SSSSSSSSSSSSSSSS--o-------------------------<>--[]---------------------S----------XX------------------X------<>----SQS-----------Q-----------------XXXX---XXX---------------SS--------S-------------XXXX---XXXXX------------------SSSSSSSSS-----SS--SS--SSSS---<>-----E-----------S-------S?S-----------QQQ--QQQ------------<>----<>--[]--------XX------ooo--------------------XX-------QSQQ---S---------SSS----------------------EE-----E--QQ--Q--QQQQ--QQQ-----XXXXXXX-XXXX---------------XXX----XXX---------------------E----[]------<><>----<>----SS------EX--X------SS----X----SSS--------S-----------X---------------------XXXXXX-
--[]--------------------[]--------------------------E--XXXXXXXXXXXXX--------------------------<>----------E----------------------------------------------------E------------------------------------------------------------------<>----[]------------------------------------------[]----------------[]----------------------XXX--XX-----------------------<>----------------------------XXXX-XX------------E-E---------------------X------E------<>--[]--[]--X----<>----[]----E<>-E--E--------------[]--------------------------XXXX-XX--------EXX-----------X-------------XXX--<>----[]--<>---------------------------------o---XXXXX----------------------E--XXX----------------------------------------------E---E-----------------------------------------------[]--[]-----E---------------<>----------XX---------------------------------------------------------------------E------------------------------------XXXX---SSSSSSSSSSSSSSSS----------------------------[]--[]-------------------------------XXX----------------XXX------[]-----------------------------------------------------o---XX---------------E---------------------------------------------------------------------[]----<>---------E-------------------------------------------[]----[]--[]------------------E-----XXXXXX------X--XX-----------------------------------XX---------XXXXX--------------------------------------------------------------------o-----------------<>----[]------[][]----[]-----------XXX--XX---E----E--X---------------X----------XX----------------------------
--[]--------------------[]-----------------------------X--------------------------------------[]----------------------------------------------------------------------------------------------------------------------------------[]----[]------------------------------------------[]----------------[]---------------------XXXX--XXX---------X------------[]---------------------------XXXXX-XX-----------<><>---------------------X-------------[]--[]--[]--X----[]----[]---<>[]<>-----------------[]-------------------------XXXXX-XXX------XXXX-----------X---X--------XXXX--[]----[]--[]-------------------------XXXX---XXXXX--------------------------<>--XXX---------------------------------------------<>--<>-------------------------------oo--------------[]--[]----<>---------------[]------<>-XXX-XXXX-----------------------o--------------------------------X-------------------------------------------XXXXX---SSSSSSSSSSSSSSSS----------------------------[]--[]-------------------------------XXX--------------XXXXX------[]----------------------------------------------XXX---XXXXXXXXX------------<>---------------------------------------------------------------------[]----[]----------------X------------------------------------[]----[]--[]------------XXXXXXXX----------------X--XX----------------------------------------------------------------------------------------------------------------------XXXX---------------[]----[]------[][]----[]----------XXXX--XXX----------X---------------XXX-------XXX----------------------------
--[]----E------------E--[]---------------------------X-X---------------------------------E----[]-----------------------------------------------------EE-E--EE-E--------------------E----------------E-----------------------E-EE--[]----[]--------------------------E--E---E-----E--[]-----E----------[]-------------E-E----XXXXX--XXXXE-EE---XX-E----------[]-------E------E-----------XXXXXX-XX--------E--[][]-------------E-------X----------E--[]--[]--[]--X----[]E---[]---[][][]----------E-EE---[]----------E-E-E---------XXXXXX-XXXX----XXXXX-E-E----X--X-E-X-XX----XXXXX--[]----[]--[]-----E-EE------------------------------------E-----E-EE--E-----[]--XXX----------------------E---X--E-EE------E-----[]--[]---------------XXXXX--------------E-E-------E--[]--[]----[]----E-E--------[]-E----[]--XX--------------------------------------E------------E-E---EE--X-----------------------E-----E---------E--XXXXXX---SSSSSSSSSSSSSSSS---------EE-----------EE-E--[]--[]---------E----EE-E--EE-E-------XXX-------------XXXXXXE---E-[]-----------------------------X---ooo---------------------XX---------E----[]---------------------------------------EE----------------E-EE--------[]-E--[]--------X-EE-E--X-E-----------------E-EE------EE-E---[]-E--[]--[]----------------------------------EEX--XX----EE-E-----EE--------E----------------------------------------------E-EE---------------------------------------------------------------[]---E[]--E---[][]----[]-EE------XXXXX--XXXX---------X---E-------XX--X-XX------XXX------ooo-------------------
XXXXXXXXXXXXXXXXXXXXXXXXXXX-XXXXXXXXXXXXXXXXXXXXXXXXXXXX------------XXXX-XX-XXX-X--XXXXXXXXXXXXXXXXXXXXXXXXXXXXXXXXX----XXXXXXXXX-------XX-X--XXXXXXXXXXXXXXXXXXXXXXXXXXXXXXXXXXXXXXXX--XXXXXXXXXX-XXXXXXXXXXXXXXXXXXXXXXXXXXXXXXXXXXXXXXXXXXXXXXXXXXXXXXXXXXXXXXXXXXXXXXXXXXXXXXXXXXXXXXXXXXXXXXXXXXXXXXXXXXXXXXXXXXXXXXXXXXXXXX--XXXXXXXXXXXXXXXXXXXXXXXXXXXXXXXXXXXXXXXXXXXXXXXXXXXXXXXXXXXXXXXXXXXXXXXXXXXXXXXXXXXXXXXXXXXXXXXXXXXXXXXXXXXXXXXXXX--XX--XXX-XXXXXXXXXXXXXXXXXXXXXXXXXXXX-XXXXXXXXXXXXXXXXXXXXXXXXXXXXXXXXXXXXXXXXX--XXXXXXXXXXXXXXXXXXXXXXXXXXXXXXXXXXXXXXXXXXXXXXXXXXXX-XXXXXXXXXXXXXXXX--XXXX----------------------X---XXXXXXXXXXXXXXXXXXXXXXXXXXXXXXXXXXXXXXQ-XXXXXXXXXXXXXXXXXXXXXXXXXXXXXXXXXXXXXXXXXXXXXXXXXX------------------XXXXXXXXXXXXXXXXX-XXXXXXXXXXXXXXXXXXXXXXXXXXXXXXXXXXXXXX----------------------------XXXXXXXXXXXXXXXXXXXXXXXXXXXXXXXXXXXXXXXXXXXXXXXXXXXXXXXXXXXXXXXXXXXXXXXXXXXXXXXXX--XXXXXXXXXXXXXXXXXXXXXXXXXXXXX-----XXXXXXXXXX-XX--XXXXXXXXXXXXXXXXXXXXXXXXXXXXXXXXXXXX-X-XX---XXXXXXXXXX---XXXXXXXXXXXXXXXXXXXX-XXXXXXXXXXXX-X----XXX---------------------X---------XXXXXXXXXX---XXXXX----------------------------XXXXXXXXXXXXXXXXXXXXXXXXXXXXXXXXXXXXXXXXXXX--XXXXXXXXXXXXXXXXXXXXXXXXXXXXXXXXXXXX-XXXXXXXXXXXXXXXXXXX-XXXXXXXXXX-----------------------XXXXXXXXXXXXXXXXXXXXXXXXXXXXXXXXXXXXXXXXXXXX----XXXXXXXX----XXXXXXXXXXXXXXXXXXXXXXXXXX-----------------------------------------------------------XXXXXXXXXXXXXXXXXXXXXXXXXXXXXXXXXXXXXXXXXXXXXXXXXXXXXXXXXXXXXXXXXXXXXXXXXXXXXXXXXXXX------XXX--------XX---------