-----------------------------------------------------------------------------------------------------------------------------------------------------------------------------------------------------------------------------------------------------------------------------------------------------------------------------------------------------------E------------------------------------------------------------------------------------------------------------------------------------------------------------------------------------------------------------------------------------------------------------------------------------------------------------------------------------------------------------------------------------------------------------------------------------------------------------------------------------------------------------------------------------------------------------------------------------------------------------------------------------------------------------------------------------------------------------------------------------------------------------------------------------------------------------------------------------------------------------------------------------------------------------------------------------------------------------------------------------------------------------------------------------------------------------------------------------------------------------------------------------------------------------------------------------------------------------
------------------------------------------------------------------------------------------------------------------------------------------------------------------------------------------------------------------------------------------------------------------------------------------------------------------------------------------------------------------------------------------------------------------------------------------------------------------------------------------------------------------------------------------------------------------------------------------------------------------------------------------------------------------------------------------------------------------------------------------------------------------------------------------------------------------------------------------------------------------------------------------------------------------------------------------------------------------------------------------------------------------------------------------------------------------------------------------------------------------------------------------------------------------------------------------------------------------------------------------------------------------------------------------------------------------------------------------------------------------------------------------------------------------------------------------------------------------------------------------------------------------------------------------------------------------------
----------------------------------------------------------------------------------------------------------------------------------------------------------------------------------------------------------------------------------------------------------------------------------------------------------oooE----------------------------------------------------ooo----------------------------------------------------------------------------------------------------------------------------ooo--------------------SSSSSSSSSSSSSSSSSSSSSSSSSSSS------------------------------------------------------------------------------------SSSSSSSSSSSSSSSSSSSSSSSSSSSS--------------------------------------------------------SSSSSSSSSSSSSS-SSSSSSSSSSSSS------------------------------------------------------------------------------------------------------------------------------------------------------------------------------------------------------------------------------------------------------------------------------------------------------------------------------------------------SSSSSS-QSSSS?SSSSS-----SSSSSSSSSSSSSSSSSSSSSSSSSSSSSSSSSSSSSSSSSSSSSSSSSSSSSSSSSSSSS-------------------------------------------------------------------------------------------------------------------------------------------------oo-------------------------------------------------SSSSSSSSSSSSSSSSSSSSSSSSSSSS--------------------------------------------------------SSSSSSSSSSSSSSSSSSSSSSSSSSSS--------------------------------------------------------
----------------------------------------------------------------------------------------------------------------------------------------------------------------------------------------------------------------------------------------------------------------------------------------------------------XXXX--------------------------------------Q-oo----------XXXX-----------------------------------------------------------------------------------------------------------------------------X-E--E---------------------------SSSSSSSSSSSSSSSS---------------------------------------------------------------------------------------SSSS-------SSS-SSSSSS--SS------------------------------------------------------------------------SSSSSSSSSSSS------------------------------------------------------------------------------------------------------------------------------------------------------------------------------------------------------------------------------------------------------------------------------------------------------------------------------------------------SSSS-------------------oo-oSSSSS------------------------------------------------------------------------------------------------------------------------------------------------------------------------------------------------o--------E--E-------------------------------------------------------------------------------------------------------------------------------------------------------------------------------------------------------------------
-------------------------------------------------------------------------o----------------------------------------------------------------------------------------oooo--E---------------------------------------------------------------------------------------------------E------------------------------E---------------------------------------------E---------------------------------------------------------------------------------------------------------------------------------------------X----------------------------SSSSSSSSSSSSSSSS---------------------------------------------------------------------------------------SSSS------SSSSSSSSSSS--SS------------------------------------------------------------------------SSSSSSSSSSSS---------------------------------------------------------------------------------------------------------------------------------------------------------------------------------------------------o--------------------------------------------------------------------------------------------------------------------------------------------SSSS-----------------------S-SSSS-------------------------------------------------------------------------------------------------------------------------------------------------------------------------------------------------------XXXXXXX------------------------------------------------------------------------------------------------E----------------------------------------------------------------------------------------------------------------
--------------------------XX---------------SSS--------ES-------------------o-------o-------------------------XXX----------------------------------------E---------XXXX------SQS---?------X-------------------SSS----------------QQ----------SSSSSSSSSSSS------------------SSSSSSSS-SSSSSSSSS---------------E--E-----SS-----------------------------SSQ--XXXX-----------------------SSSS---------------------------------SSSSSS-------SSS----------------SSSS-------?----------------SSSS------Q------------------------S---------------SSSSSSSSSSSSS-------------SQSSSSSSS---------S-----------SSS----------SS??------------------------S---------S----------SSS--SS-----------------------------------------?SSS----------------------------SSSSSSSSSSSSSSSS-------XXoo----oo------------------------------QQQQ----------------------------S------------------------------------------------------S---S-------SSSS-------------SSS---------------oo--------------SQ-------------------S----E-----SSQS------------------SS--?S?SS-----E----------SQQ------------SSSSSSSS----------------------S----SSSSS-SS----S---oo--------SS--SSS--SS-------------------------S?-----------------------------------------S-----------------------------------------------------------S--SSSSS--------------------------------------------------------S-------------------------------------------------------------------------------------------------------------SQ------S---------------------S------o------------------------------------------Q-Q------------QQQQQ--------------
--------------------------XX-------------------------<>S--------------------------XX--------------------------------------------------------------------XXXX----------------------------XXSS-----------------------------------------------------------------------------------------------------------------XXXXXX-------------------------------XX---------------------------------------------------------------------------E-------------------SS---------------------------------------E-----------------o------------------------------------------------------------------------E--------------------ES------------------------------------SS---------------S--------------------------------------------------------------------S---------------XXX----------------------XXX-----------------------------------------------------------------XXX------------------------------------------------------------------------------------------------XXXX-------------------------------------------------------------------------<>------------------------------------------------------------------SSS---S-------------SS-------S---------------------------------------------------------------------------------------------------------------------------------S---------------------------------------------------------------------------------oooo----------------------------------------------------------------------------------------------------------------------S-----------------------------------------------------------------------------------
-------------------------XXX-------------------------[]S-------------------------------------------------------------------------------------------------------------------------------XXXX------------------------------------------------------------------------------E---------------------------------------------------------------------------------------------------------------o------------------------------------<>---------------------------------------------------------------o-----------------------------------------------------------------------------------S--------------------------------------------------------------------------S---SS--------------------------------XSS---------------------------------S----S----------------------------------ooo---------------------------o----------------------------------------------------------------------------------------------------------------------------------------------------S-S----S--------E---oXX-------------------------------------------[]---------------------------------------o--------------------------SSS---S----S--------SS----------------------------------o--------------------------------------------------X---------------------------------------------------S---------------------------------o-----------------------------------------------------------------------------------------------------------------------------E-------------------------------------------S------------------------------------o----------------------------------------------
------------------------XXXX--------------o----------[]------------------------------------------------------------------o-----------------S----------------------------S-------------XXXXX----------------------------------------------------------E-----------------------------------------------E--------------------------E---------------------------------------------------------------------------------------------[]---------------------S-----------------------------------------------------E--------------------------?oooooooooo----------------------------------SoS-----------------------S------------------------XX----------------ooooooooo?-S-----S-------------SSSSSSSS----XXX---------------------------------------So---EE?-------------------------------E-----S----------------------------------------S---------------------------------------------------------------------------------------S---------------------------------------SoS---o--------<>----S-------------------------------------------->------------------------------------------------------------------SoSS---So??-So??---?-SS--X-S----------------oo-S------So-----------oo---oo-S---------------E---------------XXS-S-----E----------------------------------------------Q---X-------------------------------------------------------------------------------------------------E--S--------------E-------oooo----S------------------<>-------E----------------------E-----------X----------S---------------------------o-----E------------------------------------E--
-------S--------S-----XXXXXX----------E---------E----[]----------------XXX------------EEE--E--------------------S-----------------------XX-XQQQ------------E----------------S?SS-----XXXXX--------------------X---------------------------------S--SSSSS---X-------------SSSSSSSSSSSSSSS------ooo-XXX--XXXX-------------E------<>----------XXX--------XXX-SSSS------------------XXXX-SSSS---------------------------SQQ-------<>---S-ooo-------XXXXX-------------Q------------<>-------------SS-----------<>--------------S----E-XX---??SSSSSSSSS-------X------ESS?SQ--SS-------X--SSS--S------QQQQ--QQQQ---SS---S-------------------XXXS------XXX------SSSSSSSSS---S-----------------------------XXXX-SS---SS?S---------E?S--------X---ES---SS---SSSS------------XXXX-XXXXX-SSSS---------------------------SSS------------------E----E--S-----------S---------------oX-QQQQ-----------E--S----------Q-QQ-QQQQ--Q---------XX--X-----------XXXXXXXXX-----------S----SSS--S----SS---[]--SSS---Q----SQQQ------------------QQQ--QQ-------------------S?S---------------SSSS----X-S--------E--------SSSSSSSS-SSSS---SSSS-SSS--SS-----SS-S--S?S---------------------SS-SSS------------------------S--E--<>--------S?----XXX-------<>--------------E-----------------E------------SSSS-X-------------------------------------------------------??S----------E---------------------------<>-----E--S--------------E---------------SS-----------[]------<>-------------S-------<>----------XXSSS----------E--------------------S-SS?S---<>-------Q-Q?-------QQ?SSQSQ---------<>--
---------------------XXXXXXX---------<>--------<>----[]-----------------------------XXXXXXXXXXX?---------------------------------------XXX-------XXX-?----<>------------------------XXXXXXX--------------------------------------------------------E-------X-----------------------------------------------------------<>------[]---------XXXX----------------------SS--------XXXX--------------------------X-----------------[]--------------XXXXXXX-------------------------[]--------------------------[]-------XXXX-------<>-XX---------------------X-----------------E-------------------------------------E-------------------XXXX--XXXXXXXXX--------------------E-----------E-------------XXXXX--------------------------XXX-XXX--------E--E---------------------------------X-------E-----------------------------------<>---<>-------E---------------------------------------<>--------------------------------XXXX--XX--------------------------------------------------[]--SS----------------------------------------------E------E---------------------E-------X---------<>--------------------------------------------------------------------------------------------------X----<>--[]-------------XXXX-------[]-------------<>------X---------<>-----------------X-----------------E-------------------------------------------E-----<>---------------------------[]----<>----------------<>----------------------------[]------[]------X--------------[]--E------XXX------------<>-----------------------------[]-------E---------------------------[]--
--------------------XXXXXXXX---------[]--------[]----[]------------------XXXX----o---------------------E------------------------------XXXX----------------[]-----------------------XXXXXXXX--------X---------------------------------------------------E---X-----------------------------------------------------------[]----<>[]--------XXXX------------------------S--------------------------------------X-----------------[]-------------XXXXXXXX-------o-oo--------------[]--------------------------[]------------------[]-XXX--------------------X------------------------------------------------------<>------------------XXXXX-XXXXXXX-XX-------------------<>----------<>------------XXXXXX--SSS--------------------XXXX-XXX-----------X----X----------------------------X------<>-----------------------------------[]---[]------<>------------<>-------------------------[]------<>-----------------------XXXXX--XX--------------------------------------------------[]--SSS--------------------------------------------<>-----<>-------------E-----------E---X---------[]--------------------------------------------------------------------------------------------------X----[]--[]------------XXXXX-------[]-------------[]------X---------[]-----------------X----------------<>------------X------------------------------------[]---------------------------[]----[]----------<>----[]----------------------------[]------[]------X--------------[]-<>--<>-XXXX------------[]--------------------SS-------[]------<>---------------------------[]--
E-E-----EE-----E---XXXXXXXXX----E-E--[]--------[]-E--[]-ooo---XXXXXXXX?--------------------------------------------------------------XXXXX----------------[]----------------------XXXXXXXX--------XX------------------------------------------------------XX--------------E--------------------------------------XXX---[]----[][]--EEEE--XXXX-----------------------SS--------X-------------------------EE--X-----E-----E-EE--[]----E-------XXXXXXXXXS-SSS----XX-----------E--[]-E------------------------[]------------E-----[]-XXXX------E--E-----E---X----EE-E----------------------------------E--E-----E--[]------EE---------XXXXXXXXXXXXXX-XX-------------------[]----------[]------------XXXXXX------------E--------E-XXXXXX-XX--E---------X----X-------ooo------------------X------[]-----E------------------E-EE-EE-E--[]---[]------[]-E----------[]----------------------E--[]-E----[]----------------------XXXXXX--XX------------------------------E------------E-E----[]--SSS--------------------------------------------[]---E-[]--E----------XE----------Q---XE--E--E--[]-------------------EE-----------------------------------------------------------------------------X----[]--[]--------E--XXXXXX------E[]-------------[]-----XX---EE-E--[]-----------------X----------------[]---------E--X------E----------E------------------[]-E----------------E----E---[]----[]-E--------[]-E--[]----------------------------[]-E----[]------X---EE---------[]-[]--[]XXXXX------------[]-----------EE----------------[]------[]--------E-EE------------E--[]--
XXXXXXXXXXXXXXXXXXXXXXXXXXXXXXXXXXXXXXXXXXXXXXXXXXXXXXXXXXX------------------------------------XXXXXXXXX-XXXXXXXXXXXX-------XXXX-XXXXXXXX--XXXXX-----XXXX-XXXXXXXXXXX--XXXXXXXXXXXXXXXXXXXXX---SXXXX--XXXXXXXX---XXXXXXXXXXXXX--XXXXXXXXXXXXXXXXXXXXXXXXX-XXXXXXXXXXXXXXXXXXXXXXXXXXXXXXXXXX---XXX------------XXXXXXXXXXXXXXXXXXXXXXXXXXXXXXXXXX--XXXX----XXX---XX--XX--XXXXXXX-------XXXXXXXXXX-XXXXXX-XXXXXXXXXXXXXXXXXXXXXXXXXXXXXXXXXXXXXXXXXXXXXXXX-XXXXXXXXXXXXXXXXXXXXXXXXXXXXXXX----XXXXXXXXXXXXXXXXXXXXXXXX----XXXXXXXXXXXXXXXXXXXXXXXXXXXXXXXXXXXXXXXXXXXXXXXXXXXXXXXX--XXXXXXXXXXXXXXXXXXXXXXXXXXXXXXXXXXXXXXXXXXXXXXXXXXXXXXXXXXXXXXXXXXXXXXXXXXXXXXXXXXXXXXXXXXXXXXXXXXXXXXXXXXXXXXXXXXX--XXXXXXXXXXXXXXXXXXXXXXXXXXXX-XXXXXXXXXXXXXXXXXXXX-------XXX-------------XXXXXXXXXXXXXXXXXXXXXXXXXXXXXXXXXXXXXXXXXXXXXXXXXXXXXXXXXXXXXXXXXXXXXX----XXXXXXX--XXXXX-XXXXXXXXXXXXXXXXXXXXXXXXXXXXXXXXXXXXXXXXXXXXXXXXXXX---XX-----XXXXXX-----------XXXXXXXXXXXXXXXXXXXXXXXXXXXXXXXXXXX--XXXXXXXXXX---XXXXXXXXXXXXXXXXXXXXXXXXXXXXXXXXXXXXXXXXXXXXXXXXXXXXXXXXXXXXXXXX---XXXXXXXXXXXXXXXXXXXXXXXXXXXXXXXXXXXXXXXXXXXXXXXXXXXXXXXXXXXXXXXXXXXXXX-XXXXXXXXXXXXXXXXXXXXXXXX----XXXXXXXXXXXXXXXXXXX-XXXXXXXXXXXXXXXXXX----XXXXXXXXXXXXXXX--XXXXXXXXXXXXXXXXXXXXXXXXXXXXXXXXXXXXXXXXXXXXXXXXXXXXXXXXXX--XXXX---XX-XXXXX--XXXXXXXXXXXXXXXXXXXXXXXXXXXXXXXXXXXXXXXXXX-XXXXXXXXXXXXXXXXXXXXXXXXXXXXXXXXXXXXXXXXXXXXXXXXXXXXXXXXXXXXXXXXXXXXXXXXXXXXXXXXX-XXXXXXXXXXXXXXXXXXXXXXXXX-XXXXXXXXXX--XXXXXXXXXXXXXX-X-XXXXXXXXXXXXXXXXXXXXXXXXXXXXXXXXXXXXXXXXXXXXXXXXXXXXXXXXXXXXXX