------------------------------------------------------------------------------------------------------------------------------------------------------------------------------------------------------------------------------------------------------------------------------------------------------------------------------------------------------------------------------------------------------------------------------------------------------------------------------------------------------------------------------------------------------------------------------------------------------------------------------------------------------------------------------------------------------------------------------------------------------------------------------------------------------------------------------------------------------------------------------------------------------------------------------------------------------------------------------------------------------------------------------------------------------------------------------------------------------------------------------------------------------------------------------------------------------------------------------------------------------------------------------------------------------------------------------------------------------------------------------------------------------------------------------------------------------------------------------------------------------------------------------------------------------------------------
------------------------------------------------------------------------------------------------------------------------------------------------------------------------------------------------------------------------------------------------------------------------------------------------------------------------------------------------------------------------------------------------------------------------------------------------------------------------------------------------------------------------------------------------------------------------------------------------------------------------------------------------------------------------------------------------------------------------------------------------------------------------------------------------------------------------------------------------------------------------------------------------------------------------------------------------------------------------------------------------------------------------------------------------------------------------------------------------------------------------------------------------------------------------------------------------------------------------------------------------------------------------------------------------------------------------------------------------------------------------------------------------------------------------------------------------------------------------------------------------------------------------------------------------------------------------
----------------------------------------------------------------------------------------------------------------------------------ooo---------------------------------------------------------------------------------------------------------------------------------------------------------------------------------------------------------------------------------------------------------------------------------------------------------------------------------------------------------------------------------------------------------------------------------------------------------------------------------------------------------------------------------------------------------------------------------------------------------------------------------------------------------------------------SSSSSSSSS-------SSSSSSSSSSSS-------------------------------------------------------------------------------------------SSSSSSSSSSSSS--------------------------------------------------------------------------------------------------------------------------------------------------------------------------------------------------------------------------------------------oo---------------------------o----------------------SSSSSSSSSSSSSSSSSSSSSSSSSSSS---------------------------------------------------------------S------------------------------------------------------------------------------------------------------------------------------------SSSSSS----------------------SSSSSSSSSSSSSSSSSSSSSSSSSSSS----------------------------
----------------------------------------------------------------------------------------------------------------------------------XXXX-------------------------------------------------------------------------------------------------------------------------------------------------------------------------------------------------------------------------------------------------------------------------------------------------------------------------------------------------------------------------------------------------------------------------------------------------------------------------------------------------------------------------------------------------------------------------------------------------------------------------------------------------------------------------------------------SSSSSSSSSS---------------------------------------------------------------------------------------------------------------------------------------------------------------------------------------------------------------------------------------------------------------------------------------------------------------------------------------------------------E--E------------------------E--------------o----SSSSSSSSSSSSSSSSSSS------------------------------------------------------------------------------------------------------------------------------------------------------------------------------------------------------------o------------------------------------------------------------------------------------
-----------------------------------------------------------------------------------------------------------------------------------------ooo-----------------------------------------------------------------------------------------ooo-------------ooo---------------ooXXXo------------------------------------o----------------------------------------------------------------------E---------------------------------------------------------------------------------------------------E--------------------------o-----------------------------------------------------------------------------------------------------------------------------------E-------------------------------------------------------ooo----------------------------------E----------------------------------------------------------------------E-SSSSSSSSSS---------------------------------------------------------------------------Eooo-----------------------------XX---------------------------------------------------------------------------------------oo------------XXX--X-------------------------------------------------------------------------------------------------------------------------------XXXXXXX-------------------------XXX--------------SSSSSSSSSSSSSSSSSSS-----------------------------------------------------------------X---E--?------------E-----------------------------------------------------------------------------------------------------------------------------------------------------------------------------------------------------------
-----------SSS--SSS-------------------QQ------------------------------------------------------------------------SS-------SS-----oo----XX---------------------------------S-------------------------------------SSS-SSSSSSS----------XXXX-------------XXXX---SS-----------------------------SSQS-?---E---------------------------------------------------------------------------SS----?SSS-SSSSS--------S?SSS-----SSSS-SSSSS------------------QQQQ--------------o---------------------------SS--SQ-------------------XXX-----------------------------------------------------------------------SQSS-------SSS?SSS-------XXoo--SSSS------------------------EE--E-----E---------------------------o------------------XXXX------------E------------------------SQS---?SSS------------------------------------------------------SSSSSSSSSSSSSSSS-------------------------------------------------------SQQ----------------XXXXX------------------------------------------?SSSS------------------------------------------------------------SSSSS-----XXX-------------------------------------------------------------SQQQQ-------------------------?SSS---------------SS---S--------------SSS---------------------------------SS---S--------------SSS----SSSSSSSSSSSSSSSSSSS--QQ----------------SSSSSSSSSSS-----------------SSS----SSSSS-------SSQSS??-----------QQQQQ-------------SSSS--SQS-------------------------------------?SSSS------SSSS---XXX----------SS----------SQSSS---?SSSS---S--------------------------------------------------------SSS---?SSS--------------
----------------------------------------------------------------------------------------------------------------------------------------------------------------------------------------------------------------------------------------------------------------------------XX-oooo-----------------XXXX----------------------------------------------------------------------------------------------------------------------------------------------------------------------------------------------------------------------oooo--------------------------------------------------------------------------XXX----------------------XXX---------------------XXXXX----------------------------------------------------------------<>----------------------------------------------------------------------------------------------------------------X-----------------------------------------------------------------------------------------------------------------------------------------Qooo---------S------------------------------------XXX---------------------oo----------ooo----------------------------------------------------------------------------------------------------------------------oooo------------------------oo--------------------------------------------------------------------------------------------------------------------------------------------------------------------------------------------------XXXX-----------------------------------------------------------------------------------------------------------------------
--------------------------------------------------------------------------------------------------------------S-------------------------------------------------------------------------------------XX-------------------------------------------------------------------------------------------------------------------------------------------------------------------------------------------------------------------------------X----------------------------------------------------------------------------------------------------------------------------------------------------------------------------------------------ooo----------------------------------------------------o--------------------------------------[]-------------------------------------X----------X------------oo-------------------------------------------------------------------------------------------------------------------------------------------E----------------------------------------------------------XX-----------------------------------------------------------------------------------------------------------------------------------------------------------------------o------------------------------------X----------------------------------------------------------------------------------------------------------------------------o---------------------------------------------------------------------------------------X-XX---------------------------------------S--------------------------------------------------------------------------------
-----------E-EE---------------------------------o---------------------------------------------o--------------XSS----------------XXX--------------------------------------S--------------------------S-----------------------------------------------------------------------------------------------------XXX----------------------E----SS---------------------------------------------------------oo-------------------------------------------------------E--oX-------------E-------------E-------------------------------E-------------E-------------------------------------------------------------------------------------------------------------------------XX--------------------------XX-----------------------------E--XXX------------------------------------------oo---S----------------------------------------E---------EE-----------------------------------------------------------------------------------------------------E--o---E------S---------------------E---------E-----------XXX----------------E---------------------------XXXXX-----------------------------------------E---------------------S----------------------------------------------------------------S-----------S-------------XX---------------E-------------------------E-EEE--------S-----------------------------------------------------------?-------E-EE-----------------E-------------------------------------------------------------E-EXEE---XX--------------------------------------------------o---------------------------------------------------------------------
----QQQ-----X--XX----S-------------QQ--Q--------------------------X-----------------------------------------XXX----------XXXXX-----XX--XXX--------------E------S----XX---S------------E-------------S---Q-Q----------S----X---------------------XXX---------------ooo--XXX-------------------S------------------------------------<>---------------------------S---------------QQQQ-------------ooo---------Q-Q--Q--Q--Q-Q---------X-X------Q--SSSS--------<>----------------<>-------------XS--S?S------------------------<>------------<>---------------------------<>----------------<>----E-SQ--------SS----------XXX--XXXX--SSS--------------Q--------------------------------------SSS----S--------------------------X--<>------SX----------------o---S?S-----XX-XXX----------X-----------SS--------E----------S-----XX--XX-X--SSSSS------X--------------S-----------------------S-----------SQQQQ--------------X--SQS----------E------<>-----<>------S--QQQQ----QS--S-----<>--------<>----------XXXX------------E--<>--------XXX--S?S----XXX--------------XXXX-XXXX--------------------------<>--------QQ?SSQQQ--------E--------QQQQ--------S------------------SSS------XX--------------E----------<>---------XXX------SS------<>------------SSSSSSSSSSSSSSSSSSS---Q---SS-----------------S----X-----oo-o-------XXX-XX----------XSS??SSSSSSSSSSSS--Q---QQQ--Q--<>---QQ?SQQQ------------------------SQQQQ--E-------------SQS-----XX-XXX-XX----------------------S-----------------------<>----Q-----Q-----SSS-----------------------------S?S--------S------------
------------X--XX-------------------------------------------------------------------------------E----------XXXX----------------------------------------<>-----------XX---------------<>-------------S------------------E--X-------------------------------------------------------------------------------------------------------[]--E---------------------------E---------------------------------------------------------------XXXX---------------------[]--------E-------[]---------------------------E----------------[]------E-----[]------------------E--------[]----------------[]-------------------------------------------------------------------------------E--------------E------o---E---E------------------XX--[]-----------E-----------------------XXX-XXX----------X--------------------<>---------------XXX--XX-X--E---------XX-------------------X--------------E------E------------------------------------------<>------[]-----[]---------------------------[]--E--E--[]------E--XXXXX------EE---<>--[]---------------------------------------------------------------E--E-----[]-----------------------<>-------------------------------XX--------------XXX----------X--<>----------[]--------XXXX--------------[]-----------SSSSSSSSSSSSSSSSSSSSS------------------X---X----E--E---XX----------XXXX-XX---------XXS---SSSSSSSSSSSS--S-----------[]----------------------------------------<>-------------------XXXX-XXX-XX----------------------------------------------[]------------------------------------------------------------------------
------------X--XX-X-------XX----------------<>-------------------------------------------------<>---------XXXXX----------------------------------------[]-----------XX---------------[]-------------S---------------------X-------------------------------o-----------------------------------------------------------------------[]-<>--------------------------<>------------------------X-------------------------------------XXXXX---------------------[]-------<>-------[]-----------XX---?---------<>----------------[]-----<>-----[]-----------------<>--------[]----------------[]-------------------------------------------------------------------------X----<>-------------<>------X--<>--<>-----------------XXX--[]----------<>----------------------XXX--XXX----------X--------------------[]--------------XXXX--XX-X---------X---XX------------------X-X-----------<>-------------------------------------------------[]------[]-----[]------S--------------------[]-<>--X--[]-----<>-XXXXXX-----------[]--[]------------------------XXXX------------------------<>-----------<>-----[]------------------<>---[]-------------------------------XX-------------XXXX----------X--[]----------[]-------XXXXX--------------[]-----------SSSSSSSSSSSSSSSSSSSSS-----------------XE---X-------X---XX---------XXXXX-XXX-------XXXS--SSSSSSSSSSSSS--o-----------[]----------------------------------------[]------------------XXXXX--XX-XXX------X--------------------------------------[]------------------------------------------------------------------------
------------X--XX-X--EE-EXXX----------E-----[]------EE-E-----------------EE--------------------[]---E----XXXXXX------------------------------------EE--[]--E-E-E----XX--E-------EE-E-[]-------------S-----------EE--------X---------------XXXXXX----------XX-------ooo----------------------------------------------------E----E--[]-[]------------EE-E----------[]--EE-E------E-------E-E-X----------XX----------------------E-XXXXXX-----EE--E-----E-E---[]-------[]-------[]------EE---XX-------------[]-------------E--[]-E-E-[]--E--[]----------E------[]--------[]---------E-EE---[]---E-------EE------------ooo------------------EE-------E--E-EE-----E-EE--X----[]-------------[]------X--[]--[]----------------XX----[]----------[]---------------------XXXX--XXXX--------XS------EE------E-E---[]-------------XXXXX--XX-X---------X--XXX------------E-EE--X-E----E----E-[]---E-----------X------E------------------XX?--E--[]---E--[]--E--[]----E-S-------E--E---E--E--[]-[]-EX--[]-----[]XXXXXXX-------XX--[]--[]----------------------------------------------------[]-----------[]-----[]------------------[]---[]--------E-----------------EE-E-XX--E---------XXXXX----------X--[]-------E--[]------XXXXXX-E-E-------E--[]-E---------S-oSSSSSSSSSSSSSSSSSS-----EE---------XXXX--X-------X---XX--------XXXXXX-XXXX-----XXXX-SSSSSSSSSSSSSSS--------------[]----------------------------------EE----[]--------E---E----XXXXXX--XX-XXX--E--XX---E-EE----E-E--------E--------EE-E---[]-E-----E-EE----------------------X-------E-----E-------E----------------
XXXXXXXXXXXXX--XXXXXXXXXXXXXXXXXXXXXXXXXXXXXXXX-XXXXXXXX------XXXXXXXXXXXXXXXXXXX---XXXXXXXXXXXXXXXXXXXXXXXXXX------------------------------XXXXXXXXXXXXXXXXXXXXXXXXX--XXXXXXXXXXXXXXXXXXXXXXXXXXXXXX---XXXXXXXXXXXXXXXXXXXXXXXXXXXXXXXX-------------X-------------XXX--XXXXXXXXXX------XXXXXXXXXXXX-XXX------------XXXXXXXXXXXXXXXXXXXXXXXXXX-XXXXXXXXXXXXXXXXXXXXXXXXXXXXXXXXXXXXXXXXXX-XXXXXXXXXXXXXXXXXXXXXXXXXXX--XXXXXXXXXXXXXXXXXXXXXXXXXXXXXXXXXXXXXXXXXXXXXXXXXXXXXXXXXXXXXXXXXXXXXXXXXXXXXXXXXXXXXXXXXXXXXXXXXXXXXXXXXXXXXXXXXXXXXXXXXXXXXXXXXXXXXXXXXXXXXXXXXXXXXXXXXXXXXXXXXXXXXXXXXXXXXXXXXXXXXXX-X-XXXXX------------XXXXXXXXXXXXXXXXXXXXXXXXXXXXXXXXXXXXXXXXXXXXXXXXXXXXXXXXXXXXXXXXXXXXXXXX-XXX---------XX-----XXXXXXXXXXXXXXXXXXXXXXX---XXXXXXXXXXXXX--XXXXXXXXXXXXX---XXXXXXXXXXXXXXXXXXXXXXXXXXXXXXXXXXXXXo-EXXXXXXXXXXX--XXXXXXXXX---XXXXXXXXXXXXXXXXXXXXXXXXXXXXXXXXXXXXXXXXXXXXXXXX--XXXXXX---XXXXXXXXX----XXXXXXXXXXXXXXXXXXXXXXXXXXXXX---XXXXXXXXXXXXXXXXXXXXXXXXXX-XXXXXXXXXXXXXXXXXXXXXXXXXXXXXXXXXXXXXXXXXXXXXXXXX--------------------------------XXXXXXXXXXXXXXXXXXXXXXXXXXXXXXXXXXXXXXXXXXXXXXXXXXXXXXXXXXXXXXXXXXXXXXXXXXXXXXXXXXXXXXXXXXXXXXXXXXXXX---XXXXXX-XXXXXXXXXXXXXXXXXXXXXXXXXXXX-XXXXXXXXXXXXXXXXXXXXXXXXX--XXXXXXXXXXXXXXXXXXXXX-XXXXXXX---XXXXXXXXX--XXXXXXXXXXXXXXXXXXXXXXXXXXX--XXXXXXXXXXXXXXXXXXXXXXXXXXXXXXXXXXXXXXXXXXXXXXXXXXXXXXXXXXXXXXXXXXXXXXXXXXXXXXXXXXXXXXXXXXXXXXXXXXXXXXXXXXXXX--SXX-XXXXXXXXXXXXXXXXXXXXXXXXXXXXXXXXXXXXXXXXXXXXXXXXXXXXXXXXXXXXXXXXXXXXXXXXXXXXXXXXXXXXXXXXX-XXXXXXXXXXXXXXXXXXXX-XXXXXXXXXXX