-------------------------------------------------------------------------------------------------------------------------------------------------------------------------------------------------------------------------------------------------------------------------------------------------------------------------------------------------------------------------------------------------------------------------------------------------------------------------------------------------------------------------------------------------------------------------------------------------------------------------------------------------------------------------------------------------------------------------------------------------------------------------------------------------------------------------------------------------------------------------------------------------------------------------------------------------------------------X--X-------------------------------------------------------------------------------------------------------------------------------------------------------------------------------------------------------------------------------------------------------------------------------------------------------------------------------------------------------------------------------------------------------------------------------------------------------------------------------------------------------------------------------------------------------------------------------------------------
-------------------------------------------------------------------------------------------------------------------------------------------------------------------------------------------------------------------------------------------------------------------------------------------------------------------------------------------------------------------------------------------------------------------------------------------------------------------------------------------------------------------------------------------------------------------------------------------------------------------------------------------------------------------------------------------------------------------------------------------------------------------------------------------------------------------------------------------------------------------------------------------------------------------------------------------------------------o----------------------------------------------------------------------------------------------------------------------------------------------------------------------------------------------------------------------------------------------------------------------------------------------------------------------------------------------------------------------------------------------------------------------------------------------------------------------------------------------------------------------------------------------------------------------------------------------------------
--------------------------------------------------------SSS-SSSSSSSSSSSSS----------------------------------------------------------------------------------------------------------------------------------------------------------------------------------------------------------------------------------------------------------------------------------------------------------------------------------------------------------------------------------------------------------------------------------------------------SSSS-S---------------------------------------------SSSSSSSSSSSSSS?SSSSSSSSSSSSSo--------------------------------------------------------------------------------------------------------------------------------------------------------------------------------------------------------------------------------------------------------------------------------------------------------------------------------------------------o----------ooo--------------------------------------------------------------------------------------------------------------------------------------------------------------------------------------------------------------------------------------------------------------------------------------------------------------------o-------------------------------------------------------oo--------------------------------------------------------------------ooo--------------------------------------------------------------------------------------------------------------------------------------
--------------------------------------------------------SSSSSSSSSSSSSSSSS-------------------------------------------SS---------------------S----------------------------------------------------------------------------------------------------------------------------------------------------------------------------------------------------------------------------------oS-----------------------------------------------------------------------------------------------------------------------------------------------SSSSS--------------------------------------------------------------------------------------------------------------------------------------------------------------------------------------------------------------------------------------------------------------------------------------------------------------------------------------------------------------------------------------------------------------------------------------------------E--------------------------------------------------------------------------------------------------------------------------------------------------------------------------------------------------------E--------------------------------------------------------------------------------------------------------------------------------------------------------XXXX-------------------------------------------------------------------XXXX-------------------------------------------------------------------------------------------------------------------------------------
----------------------------------------------oooo------SSSS-SSSSSSSSSSSSS------------------------------------------S----------------------S------------------Eoo---------------------------------------------------------------------------------------------------oo--ooo--oo--oo---------------------------------E---------------------------------------------------------SS----------------------------------------------------------------------------------------------------------------------------------------X-----SSSSSS-------------------------------------------------------------------------------X-----X---------------------------------------------------------------------------------------------------------------------------------------------------------------------------------------------------------------------------------------------------------------------------------------oo--oo--oo-----------------------------------------------------------------------------------------------------------E-----------------------------------------------------E----------------------------------------------------------------------------------------------------------------------------------------------------------------------------------------E----------------------------------------------------------------------------------------------------------------------------------------------------------------------------------------------------------------------------------------------------------------------------------
----------------------------------------------XXXX------SSSSSSSSSSSSSSSSSS--QQ--------------------E-----oo---------S----S-------SS--SS---XXS------------------XXXXX----------------------------------SSS------------SSQSSSSS----------------------------------------------------------------------------------------SS--SSS------------------S-----SQ-----?SSS----------------S---SS--------------------SSSSS-----------SSSSSS------------------------SSSSS----------oo---XX--E--ooo--------QQ----------S----SSSSSSSS------SSSSSSSSS------Q---Q-----------------QQQQ-----------------------oooo--------------------------------------------S--------------------------SS------------------------------------------------S-S-----------------------------------------------------------------------E-----oo-----------XXX-------XXX-------------------------------------------------Q--------------------------------------------S----------E----SSSS---------XXXX---------XXXX------------------------------------------------------SSQSSSSS----SSQQS----------------SSS-------------------SSSSSSS---SS-------------------SSSSS----------------S----------------------------------------SS--?S?S------------SSSS--------------SS-?-----------------------------SSS-------XX---------SQS---?------XX-------------------QQQ----------------------SSQS--------------------------------------------------------------------------------------------------S-S---------QQQQS---------------------------------SS----S------------------------------------S-------------------SS
------------------------------------------------------------------------SS-----------------------------------------S----S-----------SS------ooo----ooo--------------------------------------------------------------------------------------------------------------------SS----------------------------------------SS----------------------<S-------------------------------------S-----------------------------------------------------------------------------------------<>----------XXX--------------------------------------------EE?-------------------------------------------------------------------------------------------------------------XSSS------------------------------------------------------------------------------------------------------------------------------o-------------------------------------------------------------------------------------------------------E---------------SSSS--------------------<>-------------------------------------------o-------------------------------------------------------------E----------------------------------------------------------------------------------------------------------------------------------ES--E--------------------------------------------oooo----------------------------XXX--------------------XXX-------------------------------------------------------------------------------------------------------------------------------------------------ES-------------------------------------------------SS-------------------------------------------------------------SS
-----------------------------------------------------------------------------------------XX--XXX-------------Eo----S----------------SS------------------------------------------------------------------------------------------------------------------------------------------------------------------------------------------------------[]-------------------------------------S------S----------------------------------------------------------------------------------[]------------------------------------------------------------------------------------------------------------SSS-S-------------------------------E-----------------------XXX-----------------------------E-----------------------------------------------------------E----------XXXXXX--------------------XXXX-XXX-------------Eo----------------------------------------------------------------------------------<>---------------------------------------[]------------------------------------------------------------------------------------------------------------------------------------------------------------------------------E-------XX-----------------------------------------------------S----------------------------XX-----------------------------------------------XXXXS-------------------XXXX-------------------------------------X------------o------------------------------------------------------------o---------------------------------SS-------------------------------------------------SS------------------------------------------------------------E--
--------------------------------E---------------------------------E--E---------------------------------------------So??-----------?-SS---E-------E------------------------------------------------------------------------------SSSSSSS--------E-----S-------------------------------------E------------------------S----o------------------[]------------------------------oo-----SoS--SoS---SSSS--------------------------------------oo--------------------XX-------------[]--------------------------------------------??-----E-EE--------------------------------------------------SoSS-S-S------------S-----------------<>--------XSSSQSS-------XXXX----------------------------<>-------------------------------------------------------E--<>-------------------------------------------------------------------------------------------E----------------------?--------------------------[]oo---------------------------------------E-------------E---------------XXXXXX-----------------------------------X----------------------------?---------------oo----E------------E---------------------------------------------XXX-SSSS-----------------------------------------------SS--S-------------------------XX---------------------S--------------------------XXXX------------------XXXXX-------------------------------------S----------E---------------------E------------------------------o---E---------------------------------------SS---------------------------E-------------E-------SS-----------------------------------------------------------<>--
-----------------------X-X-----<>---------XXXX----------SSSSSSSSSSSSSSSS--Q--Q----Q-XXX-------------XXXXXXXXXX--X--SSS--SS------SS--SS--SSSS----<>----------------QQQQ-----------------------------------------------S----X----S--------------<>---------E-----------XXX------------------<>-------Q-----S----------SS--S?S--------S--------[]--E-QQ--QQSS------------------SSS----SSS--SSS---------------SSS-ooo-------XXX--SSS-----------------------------XXX-------XX----XXX----XXX-----QQQQQ-----------QQ?--QQQQ---SSS??SSSSSSSSSS-E-----Q-Q-QQ----X------ESQQQ-------------------------------------------------XX-------[]--------------o------XXXXX---------X-----EE-------<>--[]-----E-----------------S----------------Q--------E-----E--[]--------------------------XX-E---XXXX-----------XXXX--XXXX---------------------XXXXXX-----<>--------------------E--------------QQQ--------E--[]--------------------------------------Q-<>---S---E----<>------XXXXXXX----------------------------X--X----------XX-----------X----------------SSSSS-----------------------------<>-------ESQS--S?S--------------------S-------XXXX-----E------------------------------------------X---SS--SSS----S----------------X-XX-----SSSS-----------------------Q-Q---SQS-----XXXXXX-SS-----S?S------XXXXXX------------QQQ---SSSQS---------------X---XXX-SSSSS----X--X----------<>--------S------------------------<>---S--------------------------S--------SSSSS------QQSSQS-----------<>------------<>------E------S------XXXXXX-----------------------------------SS-----[]SS
---------------E-----XX--XXX---[]-----------------------SSSSSSSSSSSSSSSS-SS-----------------------------------------------------E---------------[]------------------------------------------E--------------------------E--E----X--------------[]--------<>--------------------------------[]---------------------E-------------E------E-----[]--------------------------------------------------------------------------------------------------------------XXXX--------------------------------------------------------SSS--SSSSSSSSSSS>---------------X------------------------------------------------------------------E-E[]--------------------XXXXXX--------XX--------------[]--[]----<>-------------E------E-E-------------------<>----<>--[]----------o-----------------XXXX----------------------------------------------------------[]------------------X<>---X--------------------<>--[]-------------------E-------o------------[]------<>----[]---------------------------------------XXX--XX--------XXX----------XXX--XX---------------------------------------------[]------------------------------------------EXXXXX------------------------------------------------XX----------------------------EXX-XX----------------------------------------------XXXXXX----------------XXXXXXX-SSS----------------------------------XXX--------------X--X----------[]-------------------X-------------[]--------------------------E------E---E---SS----------------------X-[]------------[]----E<>---E-------------------XXXXXX--------------------------------<>SS
--------------<>----XXXX-XXX---[]---------------------XXSSSSSSSSSSSSSSSS-So-------------XXXX----------------------------------------------------[]-----------------------------------------<>-----------------------------X-------------------[]--------[]-------------XXXX----XXX--------[]--------------------<>------------<>-----<>-----[]---------------------------------------------------------------------------------E---------------------------XXXXX-----------------X--------------------------------------SSS--SSSSSSSSSS[]---------------X---------------------------------------------------------------<><>[][]-------------------XXXXXXX-------XXX--------------[]--[]----[]------------<>-----<><>------X------------[]----[]--[]---------XXXX-----------------------------------------------------------------------------[]------------------X[]---X--------------------[]--[]--------------XXX---XXX-----------------[]------[]----[]---------------o----------------------XXXX--XXXX-----XXXX---------XXXX--XXXX-------------------------------------------[]----------------------------------------XXXXXXXX---------------------------X---------X-------X--XXX---------------------------XXX-XX---------------------------------------------XXXXXXX---------------XXXXXXXX---------S----------------------------XXX----------E---XX------------[]-------------------X-------------[]-------------------------<>-----<>------SSSS-----------------------[]------------[]---<>[]--------------------XXX--------------------------------------[]SS
--------------[]---XXXX--XXX---[]-----------------------SSSSSSSSSSSSSSSS-o-----E-EE--------------------------XXX---E---------------E-EE---------[]-----------------------------------------[]-----------EE-E----EE-E------X----X-----------E--[]--------[]------XXXX----------------------[]-EE-E------EE-------[]-----E------[]---E-[]-----[]--------------------------------EE---------------------------------------------------------------E----------XXXXXX----------------------------------------------------------oooSSSSSSSSSS[]-----------E---X-------------EE-------E---X--------------E-EE-----E------------[][][][]------------------XXXXXXXX------XXXX-E-E--------E-[]--[]----[]-----EE-E---[]-----[][]-----XX------------[]--E-[]--[]---------------------------------------------ooo------------------------------------------[]---EE-E-----EE-E--X[]-E-X------EE-------EE---[]--[]------o----XXXXX--------E-------------E-[]------[]----[]XXXXX---------------------------EE---XXXXX--XXXX----XXXXX-E-E----XXXXX--XXXX----------E----------------------------E---[]-----------------------E-----E-E-------XXXXXXXXX---------------------EE-E-XX---E----XXXE-E---X--XXXX-E--E--E------------E--X-XXXX-XX-----------E----------EE---------------------XXXXXXX--------------XXXXXXXXX--------XS----------------------------XXX--------------XX----E-EE-E--[]-------------E-EE--X-------------[]--------E---------EE-E-E-[]---E-[]------E-SS-------E---------------[]-E------E---[]---[][]-------------o---------------------------E------E--EE-E------[]SS
XXXXXX--XXXXXXXXXXXXXX---XXXXXXXXXXXXXXXXXX-----X--XX-S-XXXXXXXXXXXXXXXXXXXXXXXXXXXX------------------------------XXXXXXXXXXXXXXXXXXXXXXXXXXXXXXXXXXXXXXXXXXXXXXXXXXXX--XXXXXXXXXXXXXX---XXXXXXXXXXXXXXXXXXXXXXXXXXXXXXXXXXXXXXXXXXXXXXXXXXXXXXXXXXXXXXXXXXXXX-------------S------------XXXXXXXXXXXXXXXXXXXXXXXXXXXXXXXXXXXXXXXXXXXXXXXXXXXXXXXXXXXXXXXXXXXXX----XX--XXXX---XXXXXXXXXXXX---XXXXXXXXXXXXXXXXXXXXXXXXXXXXX-----XXXX-XXXXXXXXXXXXXXXXX--XXXXXXXXXXX----XX----------------------XXXXXXXXXXXXXXXXXXXXXXXXX---XXXXXXXXXXXXXXXXXXXXXXXXXXXXXXXXX--XXXXXXXXXXXXXXXXXXXXXXXXX---XXXXXXXXXXXXXXXXXXXXXXXXXXXXXXXXXXXXXXXXXXXXXXXXXXXXXXXXXXXXXXXXXXXXXXXXXXXXXXXXXXXXXXXXXXXXXXXXXXXXXXXXXXXXXXXXXXXXXXXXXXXXXXXXXXXXX--XXXXXXXXXXXXXXXXXXX-XXXXXX-----------------------------------------XXX----------------XXX---------------------XXXXXXXXXXXXXXXXXXXXXXXXXXXXXXXXXXXXXXXXXXXXXXXXXXXXXXXXXX--------X-XXXXX-------------XXXXXXXXXXXXXXXXXXXXXXXXXX----------------------------XXXXXXXXXXXXXX-XXXXXXXXXXXXXXXXXXXXXXXXXXXXXXXXXXXXXXX-XXXXXXXXXXXXXXXXXXXXXXXXXXXXXXXXXXXXXXXXXXXXXX---XXXXXXXXXXXXXXXXXXXXXXXXXXXXXXXXXXXXXXXXXXXXXXXXXXX--XXXXXXXXXXXXXXXXXXXXXX-XXXX-XXXXXXXXXXXXXXXXXXXXXXXXXXXXXXXXXXXX-XX-XXXXXXXXXXXXXXXXXXXXXXXXXXXX---XXXX-XXXX--XXXXXXXXXXXXXXXXXXXXXXXXXXXXXXXXXX---XXXXX--XXXXXXXXXXXXXXXXXXXXXXXXX-XX------XXXXXXXXXXXXXXXXXXXXXXXXXXXXXXXXXXXXXXXXXXXXXX-XXXXXXX----XXXXXXXXXXXXXXXXXXXXXXXXXXXXXXXXXXXXXXXXXXXXXX-XXXXXXXXXXXX--XXXXXXXXXXXXXXXXXXXXXXXXXXXXXXXXXXXXXXXX-XXXX-----------------------XXXXXXXXXXXXXXXXXXXXXXXXXXXX