------------------------------------------------------------------------------------------------------------------------------------------------------------------------------------------------------------------------------------------------------------------------------------------------------------------------------------------------------------------------------SSS-SSSXo-XXXo-S----X--X------------------------------------------------------------------------------------------------------------------------------------------------------------------------------------------------------------------------------------------------------------------------------------------------------------------------------------------------------------------------------------------------------------------------------------------------------------------------------------------------------------------------------------------------------------------------------------------------------------------------------------------------------------------------------------------------------------------------------------------------------------------------------------------------------------------------------------------------------------------------------------------------------------------------------------------------------------------------------------------------------------------------------------------------------------------------------------------------------------------------------------------------------------------
-----------------------------------------------------------------------------------------------------------------------------------------------------------------------------------------------------------------------------------------------------------------------------------------------------------------------------------------------------------------------------oS--XXQSXoX?XSXXX-S-EX-----------------------------------------------------------------------------------------------------------------------------------------------------------------------------------------------------------------------------------------------------------------------------------------------------------------------------------------------------------------------------------------------------------------------------------------------------------------------------------------------------------------------------------------------------------------------------------------------------------------------------------------------------------------------------------------------X---------------------------------------------------------------------------------------------------------------------------------------------------------------------------------------------------------------------------------------------------------------------------------------------------------------------------------------------------------------------------------------------------------------------------------------------------------------------
------------------------------------------------------------------------------------SSSSSSSSSSSSSSSSSSSSSSSSSSSSSSSSSSSSSSSSSSSSSSSSSSSSSSSS-----------------------------------------------------------------------------------------------------------------------------------------------------------------------------------------------------------------------oo---------ooS--XXXX----S-S---------------------------------------------------------------------------------------------------------------------------------------------------------------------------------------------------------------------------------------------------------------------------------------oo----------------------S---SSSSSSSSS------------------------------------------------------------------------------------------------------------------------------------------------------------------------------------------------------------------------------------------------------------------oo------------------------------------------------------------------------------SSSSSSSSSSSSSSSSSSS-----------------------------------------------------------------------------------------------------------------------------------------------------SSSSS--SSSSSSSSSSSS-ES-SSSSS--E----SS-S----------------------------------------------S-------SS-ESS-S-----------------------------------------------------------------------E-SSSS-SSS----------------------------------------------------------------------SSSSSSSSSS----------------------------------------------
-----------------------------------------------------o---------------------------------SSSSSSSSSSSSSSSSSSSSSS-----------------------------------------------------------------------------------------------------------------------------------------------------------------------------------------------------------------------------------------------------XXXX-------------XXXXX--XXXS-X-X--X-X-------------------------------------------------------------------------------------------------------------------------------------------------------o--------------------------------------------------------------------------------------------------------------------------E--E-------------------------------------------------------------------------------------------?------o-X----------------------------------------------------------------------------------------------------------------------------------------------------------------------------------------------E--E-------------------------------------------------------------------------------------------------------------------------------------------------------------------------------------------------------------------------------------------------SSSS----Q-SSS--SS?-SS----oS----------S-----------------------------------------------oS-----Q-?----SS?---?--ooS-------------------------------------------------------------------SS-------------------------------------------------------------------------------------------------------------------------------
---------------------------------------------------------------------------------------SSSSSSSSSSSSSSSSSSSSSSS-----------------------------------------------------------------------------------------------------------------------------------------------------------------------------------------------------------------------------------------------------------oo-----------XX-XXX----------XX------------------------------------------------------oo-------------------------------------------------------------------------------------------------------------------------------------------------------------------------------------------------------------o------------------------------------------------------------------------------------------------------o-----------?--------Eooo--o------------------------------------------------------------------------------------------------------------------------oo--oo-------------------ooo----------Eooo-------------XXXXXXX------------------------------------------------------------E-----------------------------------------------------------------------------------------------------------------------------------------------------------------E---------------ESSSS-E----SSS--SS--SS----ES---------SS-----S-----------------------------Eooo--------S---E---------SS--------SS--------------------------------------------------------X----------SS-------------------------------o-----o-----------------------------------------------------------------------------------------
---S?SSS--------------------SSS-------------------SSSS------------------------------S-SSSSSSSSSSSSSSSSSSSSSSSS--S--------------------------------------SSS--SSSSSS---SS-SSSSS-----------------------------------------------QQQQ----------------------------SSSSS---------oo----ooQQQ--------------SSS----------------------------------XXX-----SSS---------XXoo---------------XXX-------------------SS----------------SSS--------------o----XXX-----ooo--------------SS-------------------S---------------------------------------------------------------------------o----------------------------S------SQ-------E-------------------SSS---------XXoo----oo----------S---XXX-------E----------------------------------------------------------------------------SS---------------XX-----E-----XXSo----XXXXX--------SS-------------------S----------------------SSSSS---Q-S-----------SSSSS?-------------------------?SSS-----oo-------------XX----------------XXXX---------XXXXXX-------------------------------S---------------------X---------?-------------S?SSSSS-------------------------------------------------------SSSSSSSSS----------SSS--?--------------------------------SSSS--------------------------------------SSSS--------------------SS------------SSS---SS---SSSSSSSSS---------Q------------------------XXXXX-----------SS-----------SS---SSS---SSQS---------SSSS--SSS--------------?SSS----------------SQQS---S-------------------------------XX-----oo------------S-----------------------------------SSS---------------------------------------
----------------------------------------oo---------------------oooo--------------------------------------------------------------------------------------------------------------------------------------------------------------------------------------------------------------------------------------------------------------------XXXX---------------------------------------------E---XXXX--------------------------------------------------------------------------------------------------oooo-------------------------------------------------------------------XXX------------------------S--------------<>----------------------------------------------------------------<>---------------------------------------------------------------------------------------------------XXXXXX----------------------SS--------------------------------oo-----------------------------------------------------------------------------------------------------------------------------------------------oo------------------------------XX---------------------------------------------------------------------------------------------------------------XXX---------------------------------------------------------------------------------------------SS------------SSS--------------------E----------------------------------------------SS-----------SS---SS-------------------------------------------------------------------SS---------------------------------------------------------------------------------------------------------------------------------
-----------oo-------------------------------------X--o----------------------------------------S-----------------S------------------------------------------------------------------------------XXXXX-----------------------------------------------------------------------------------------------------------o-----------------------XXXX-------------------------------------------XXXX------------S----------------------------------------------------------------------------------------------------------------S--E-------------------------------------------------------------------E-----S--------------[]---------------E------------------------------------------------[]------------------------------------------------------------------------------------------------------XXX----------------------SS----------------------------------------------------------------------------------------------------------------------------------------------------------------------------------------------------------------XXX---------------------------------------------------------------------------------------------------------------------------------------------------------------------------------------------------------------SS-------------SS----S--------------------------------------------------------------SS-----------SSS--S-------------------------------------------------------------S-E----SS--------------------------XX--------------Eo-----------------------------------------------------------------XXX-----------------
----------E-E---------------SS--------E----------XX------------------------oo---------?-------S------------------E-------S---------------------------------------------------------------------------oo-----E--o----------------------------------------------------------------------------------------------------ooo--oo-----------XXXXX----------------------------------------------------------XXX---E-------------------------------------------XXXXX-------------------E----------XX----E----------------------X-<>---------------------------------------------------------------E--<>-----S--------------[]--------------<>-------------------------------S---------------X[]--------------------o----o-------------E--S-------------------------------E---------E-----------------------XXX----------------SS-------E----------------------E----------------X---------SS---------------------------------------------XXX------------XXXXXX-----------------------------------SS----------S------------------------------------XX------S-SQ------------------------------------------------------------------------------------------------------------------------------------------------------E---------E------------------------------?oooo-SS----SoS--o?-SSS--EEX----------E--E-E------------------------XXX----------------ooooS-----o---?-SS---S--------------------------------------------------------------------SS------?---------------------------------------S-SQS------------------------------------------------------------------------------
--SSSS--SS-SSSS---Q---Q-Q----S---S---<>----------XX----------E------------------Q---S?SSSS---SSSS--S??SS-QQQQ---SSSS------E-ES------S---S--------------XX--X---SSS-----------------------------------------<>------------ESSSSSS--------------------------------------------XXXX--QQQ------QQQQ-----XXX-XX--SSS----------------------XXXXXX--------------XXXXX--XXXXX--XXXX-X----XXXXX--------------------<>-----E-------E---<>-----------XXXXXXXXXX-----------------SSS------<>---------XXX---<>---------------------XX-[]---------------E---------XXX------o---XXX-XXXX-----------S----<>--[]--------SSSSS-------XXX----------E--[]-------------XXXX--XXXX--SSS---------S--------XXXX---------QQ----------------------XX---<>--------E----E-------------------<>---E--SS<>--------XXXX----------------XXXXXX-------SSS--S---<>---------------------<>---------------XXSSSSS----------SSQ--SQQS----S------E---------?------------------XXXX---------------------XXXXEEE------XXXXXXX------E-----E-----E--S------XX----------------------XX---------------------------------------------XX--------SSSS-------------XXX-S---------------------------XXXX-------------------<>----------Q-------------------<>--------<>--------Q--Q-QQ----------------SSSSSSSS---SSS--SS--S--SSSSSSSSSSSSSSSSSSSSSSS--Q----QQ-------------------XXXXXX------SSSSS---E-------SS---SSS---SSS-E---------QQ?------------QQQQ--Q--S-----------<>----S?S----SS-----------------S---------------XXX---XXX---------------S-------X------------------E--S-----------E------------ooo-----X--------
-SSSSS-----SSSS----------------------[]----X--X-XXX----X----<>-------------------------SSS----SSSS--------------E--------XX-E--E-E--E-----E-----------XXX--XX---------------------------------------E------[]------------------------E----E-E------------X-----------------------------------------XXXX-XX--------------------------XXXXXXX-----------------------------------XXXXX-----------------------[]----<>------<>---[]--E--------------------------------------------[]--------XXXX---[]------E------------EXXX-[]--------------------------------------------------------------[]--[]--------E-----------------------<>--[]---------------------------------------------XXXXX-XXX----------------------------XXX---[]-------<>----E-------------------[]--<>----[]--------------------------------------------------[]---------------------[]-------------EXXXE---------------------------------<>---------------------------------------------------------XXXXXXX----E---------<>----<>----<>---------XXX-------------------XXXX--------------------------------X-----------XXX--XX---E----------------XX-X----------------------------------------------------[]------------------------------[]--------[]-----------------------------------------------------EE---SSSSSSSSSSSSSSSSSSS-----------------------------------------------<>----------EE--------------------------------------------------------[]--E----------SS----------------------------------------------------------ES?--XX---------------X<>-------------<>--------X----EE-----X--------
--SSSS-----SSSS--------------------X-[]---X----XXXX----X----[]-------------------------SSSS----SSS----------------------X-X-------------E------------XXXX--XXX---------X------------E---X-----------E------[]---XX------------------<>---<><>------------X----------------------------------------XXXXX-XXX-------XX---------------XXXXXXXX---------------------------------XXXXX------XXXX---------------[]----[]------[]---[]-<>--XXX--------------o------------------------[]-------XXXXX---[]-----<>----------E-XXXX-[]-----------------------------XXXX-----------------------------[]---------------------<>-------<>----[]--[]--X--------------------------------------<>-XXXXXX-XXXXX-------------------------XXXX---[]-------[]---<>-------------------[]--[]----[]--------------------------------------------------[]---------------------[]-----------E-XXXX----------------------------------[]---------------------------------o----------------------------------------oo--[]----[]----[]---------XXX---------------E---XXXX--------------------X-----------X----------XXXX--X-X------------------XXX-X----------------------------------------------------[]------------------------------[]--------[]----------------------------------------------------------SSSSSSSSSSSSSSSSSS----------SS------------------------------------[]--------------------------------------------------------------------[]-------------SSS----------------------------------------o---------------<>----XXX--------------X[]-------------[]------XXXXXXXXXX----X--------
---------SES----------------E-EE-XXX-[]---X-XX-XXXX----X----[]----------------------ooSSSSSSSSE----oo------------------XXX---------------------E----XXXXXE-XXXX-------XX----------------X-----EE-E---------[]---XX------------------[]---[][]------------X---------------------------------------XXXXX--XXX-----------------------XXXXXXXXX-------XXX---oo-----X------------------------------------------[]--E-[]----E-[]---[]-[]--XX--------------XXX------------E-------E--[]------XXXXXXE--[]-----[]-----------XXXXX-[]----E----E-E--------------------------------------------E-EE--[]-----------E---------[]-------[]----[]--[]--X-------ooo-----------------?----------[]XXXXXXX?XXXX?-------------------------XXXXX--[]----E--[]---[]-------------------[]--[]----[]-------------------------------------E-EE---------[]---------------------[]-----------XXXXXX-----------------------------E----[]-------------------Eooo-XXXXX----XX-------------------------------------------[]----[]----[]-E-------XXX-------------------XXXX----------------E---X-E---------S---------XXXXX--XSX----------E-E----XXXX-X-------EE-E--------------------------------E-EE-E---[]---------EE-E-----------------[]-----E--[]-----E-------E------------------E--------------E----------SSSSSSSSSSSSSSSSSS-----E-E---------------------------------E-E----[]-E---------------E---------E-E-----E-E-----------------------X------[]---E--------E----------------E-------------ooo---------XXX--------------[]--E-XXXX--------EE-E-XXXX------------[]------XXX-----------X--------
XXXXXXXXXXXXXXXXXXXXXXXXXXXXXXXXXXX--XXX--XXXXXXXXX--XXXXXXXXXXXXXXXXXXXXXXXXXXXX---XXXXXXXXXXXXXXXXXXX--XXXXX-XXXXXXXXXXXXXXXXXXXXXXXXXXXXX----XXXXXXXXX--XXXXXXXXXXXXX-X-XXXXXXXXXXX---X-XXXXXXXXXXXXXXXXXXXXXXXXXX----XXXXXXXXXXXXXXXXXXXXXXXXXXXXXXXXXXXXXXXXXXXXX------------XXX---X---XXXXXXXXXX--XXXXXXXXXXXXXXXXX---XXXXXXXXXXXXXXXXXXXX-------XXX----------------------------------------------XXXXXXXXXXXXXXXXXXXXXXXXXXXX----------------------------XXXXXXXXXXXXXXXXXXXXXXXXXXXXXXXXXXXXXXXXXXXXXXXXXXXXXXXXXXXXXXXXXXXXXXXXXXXXXXXXXXX-----------------------------XXXXXXXXXXXXXXXXXXXXXXXXXXXXXXXXXXXXXXXXXXXXXX-XX--XX--XXX-XXX-XXX-------------XX---XXXXXXXXXXXXXXXXXXXXXXXXXXXXXXXXXXXXXXXX-XXXXXXXXXXXXXXXXXXXXXXXXXXXXXXXXXXXXXXXXXXXXXXXXXXXXXXXXXXXXXXXXXXXXXXX-----XXXX-------------------XXXXXXXXXXXXXXXXXXXXXXXXXXXXXXXXXXXXXXXXXX-X-XXXXXXXXXXXXXXXXXXXXXXXXXXXXXXXXXXX----XXXXXXXXXXXXXXXXX---XXXXXXXXXXX-------------------------XXXXX-----------------------XXXXXXXXXXXXXXXXXXXXXXXX-XXXXXXXX----XXXXX-XXXXXXXXXXXXXXXXXXXXXXXXXXXXXXXXXXXXX----XXXXXXXXXXXXXX--XXXXXXXXXX--XXXXXXXXXXXXXXXXXXXXXXXXXXXXXXXXXXXXXXXXXXX-----XXXXXXXXXXXXXXXXXXXXXXXXXXXXXXXXXXXXXXXXXXXXXXXXXXXXXXXXXXXXXXXXXXXXXXXXXXXXXX--XXXXXXXXXXXXXXXXXXXXXXXXXXXXXXXXXXXXXXXXXXXXXXXXXXXXXXXXXXXXXXXXXXXXXXXXXXX---XXX---XX-------XXXXXXXXXXXXXXXXXXXXXXXXXXXXXXXXXXXXXXXXXXXXXXXXXXXXXXXXXXXXXXXXXXXXXXXXXXXXXXXXXXXXXXXXXXXXXXXXXXXXXXXXXXXXXXXXXXX-----XX------XXX------------XXXXXXXXXXXXXXXXXXXXXXXXXXXXXXXXXXXXXXXXXXXXXXXXXXXXXXXXXXXX---------------X----X-XX