------------------------------------------------------------------------------------------------------------------------------------------------------------------------------------------------------------------------------------------------------------------------------------------------------------------------------------------------------------------------------------------------------------------------------------------------------------------------------------------------------------------------------------------------------------------------------------------------------------------------------------------------------------------------------------------------------------------------------------------------------------------------------------------------------------------------------------------------------------------------------------------------------------------------------------------------------------------------------------------------------------------------------------------------------------------------------------------------------------------------------------------------------------------------------------------------------------------------------------------------------------------------------------------------------------------------------------------------------------------------------------------------------------------------------------------------------------------------------------------------------------------------------------------------------------------------
------------------------------------------------------------------------------------------------------------------------------------------------------------------------------------------------------------------------------------------------------------------------------------------------------------------------------------------------------------------------------------------------------------------------------------------------------------------------------------------------------------------------------------------------------------------------------------------------------------------------------------------------------------------------------------------------------------------------------------------------------------------------------------------------------------------------------------------------------------------------------------------------------------------------------------------------------------------------------------------------------------------------------------------------------------------------------------------------------------------------------------------------------------------------------------------------------------------------------------------------------------------------------------------------------------------------------------------------------------------------------------------------------------------------------------------------------------------------------------------------------------------------------------------------------------------------
--------------------------------------------------------oo----------------------------------------------------------------------------------SSSSSSSSSSSSSSS---------------------------------------------------------------------------------------------------------------------------------------------o---------------------------------------------------------------------------------------------------------------------------------------------------------------------------------------------------------------------------------------------------------------------------------------------------------------------------------------------------------------------------------------------------------------------------------------------------------------------------------------------------------------------------------------------------------------------------------------------------------------------------------------------------------------------------------------------------------------------------------------------------------------------------------------------------------------------------------------------------------------------------------------------------------------------------------------------------------------------------------------------------------------------------------------------------------------------------------------------------------------------------------------------------------------------------SS-S-----SS-------------------------------------------------------------------------
------------------------------------------------------------------------------------------------------------------------------------------------------------------------------------------------------------------------------------------------------------------------------------------------------------------------------------------------------------------------------------------------------------o-------------------------------------------------------------------------------------------------------------------------------------------------------------------------------------------------------------------------------------------------------------------------------------------------------------------------------------------------------------------------------------------------------------------------------------------------------------------------------------------------------------------------------------------------------------------------------------------------------------------------------------------------------------------------------------------------------------------------------------------------------------------------------------------------------------------------------------------------------------------------------------------------------------------------------------------------------------------------------------------------------------------------------------------------------------------------SSS-------------------------------------------------------------------------------
-----------------------------------------------------------XX--------------------------------------------------------------X-X---------------------------------------------------------------------------------------------------------------------------------------------E---------------Eooo----------------------------------------------------------------------------------------------------------------------------------------------------------------------------------------------------------------------------------------------------------------E--------------------------------------------X---------------------------------------------------------------oo--oo-----------Eoo--------------------------------------------------------------------------------------------------------------------------------------------------------------------------------------------------------------------------------------------------------------------------------------------------------------------------------------------------------------------------------E-------------------------------oo-----------------------------------------------------------------------------------------------------------------------------------------------------------------------------------------E----------------------------------------------------------------------------------------------------------------------------------------------------------o---------------SSS-------------------------------------------------------------------------------
------------------------------S--QSS??-------------------------------------XXX--------------------------------------------------------------------SS------------SS-----S----------SQS--SSSSSSS------------S--E--E------------------------?SSSS---------------------------SQSSSS------------XXXXX-------XXX--------------------------XX------XXXX-----E--S-------------------SSSSSS---SSS-----E------------SSS------SSS--SSS---------------------------------------------------------------------------------------------------------------XXX-----------------SQS----S-------------------------S-----------S----SS----------QSQ-----------------------------------Q-o------------------------XXX------------------------QQQQ-----------SSSSSSSSSSSS------SSSQQS----SSSS----------SSS--QQQ----------------SSSS---SS-------------------------------------------SSSSS---------------------------XX-----------------------S------SSSSS--SQS----------------SSS---SSSQQS----------S---?--------SS-QSS?---------------------SSS------------------------------------------------SSSQ?SSSS---?SSS---------------oo----------XXX-----------------------------XX-----------------------------XXXX-----------------------------------------------SSSSS--------S--------------------------SQ----------------------Q---SQ-------------------------------SSQS----------------------SSS--------SSS-SSSS-?---------?---------------------------------------------------------oo----------------------------SS------------S----------SQS---?SSS--------------------------------SSS-------
------XXX--------------------------S---------------------------------------------------------------------------------------------oo----------------S-------------S------------------------------------------------XX------------------------------------------------------------------------------------------------------------------------------------------------------------------------<>--------------------------------------------ooo-------------------------------------------E------------------------------------------------XXXX------------------------------------------------------------------------------------------------------------------------------------------------------------------------------------------------------------------------------------------------------------------------------------------------------------------------------------------------XX-------------------------------------------------------------------Q----------------------------S---------------------------------------------XXX-------------------------------------------------------------------------S--------------------------XS--------------------o-----------------------------------------------------------------------------------------------------------------------------------------------------o----------------------------------------------------------------------------------XX-----------------------------------XX-----------------XX--------------SS---------------------------------------------------------------------------
-------o---------------------------SS---------------------------------------------------------------------------XXXXXXX---------------------------S-------------SS------------------------------------------E-----------------------------------------------------------------------------------------------------------------------------------XX--oo--------------------------------------[]---------------------------------------------------------------XX-----XXXXX-------------XXXXXX--------------------------------------------XXXXX---------------------------------------------------------------------------------------------E---------E---------------------------------------------------------------------------------------------------------------------------------------------------------------------------------------------------------Q---------------------------X-XXX----------------------------E------------------------------------S--------------------------------------------------------------------------oooo---------------E-------------------------------------------------------------------o---------------XXX------------------------------------------------------------------------------------------------------------------------------------------------------------------------------------------------------------------------------------------------------------X-oX---------E---------E--------------------------------------------------SS---------------------------------------------------------------------------
-------------------------------ooooS------------------------------o--------------------------o--------------------------------------------o-------SS----ooooooooSS---EE-------------------------------------------------S-------------------------------------------oo------------------E------------XX------------------E----------------------XX------------------------E-------------------------------------------------------------E--o----E-----------XXX------------------------------------------------------------------------XXXXXX----------E---------------------E-------------E--oo---------------------E-------------------<>-E------<>-------E-------XX-------------E----SS--------------E-----------E-------------------X--------E---------------------------------------------------------------------------------------------E--S---------------------------------------XXXXX---------------------------------E--------------E-----SSS------ooS-----------------------?-ooooS--------E---SSS------SSSSSS-----------------------------------<>-------E---------------------------------XX--oo-----------------------------------XXXXS-----------------------------------------------------------------------------E--------------------E-------E-------------------------ooo----------------------E--S----o-E-------------------------------E-----------------------------------S--------------XX--X--------<>--------<>-----------E--?-----XXXX------------------X--oooooSS---------SSSSS??-----------------------------------------------------------
------------------------------ESSSSS--------------------S---------------------------------------------------------------------------------------SSSS--S------S--S-----S----------------SQQ?-----------Q---S?S----------------------QQQ---QQQ-------------<>-----XX------SSQS---S--------E----XXXX-----------------------<>----------------------XX-----------Q-----------<>---------SS?S---S--Q--Q-------------------------------------<>------<>----------XXXX-XX---------------------------------------------------------------------XXXXXX---------<>---QQQQQQ-----------<>------------<>--------------S?--------<>---E-QQQQ--QQQQ----[]--------[]------<>---QE?-S-------------<>-------------------<>----------<>---QQQ?--SSQ------XX--X---SSSS----X--ESSS------------------------QSS------------o----------oS----------------------------<>------------S?S-----------XXX-------------XXX----------------------------S?S----XS--S?S-------<>-----------X--SSS------------QQ--Q--------SSSSSS------<>--------------------QQQQ---XXXX--SS------------------[]-----E<>---ESS--QQQ---QQQQ---------------------o---------XXX---------oo--o-------XXXXXX---------------E--------------------------------------E----------Q----------<>------------------E<>------<>------------------------------------S?SQ---------<>-----E--<>------------------------------<>------QQ-----S-----------SS----------------------XXX--X--------[]--------[]-------E--<>-----------XX---------------------SSSSSS-S--E------------------SQS-----S----X---<>---------------------------------
---------------------------------------------------------------------------------------------------------------------------------------X-------------------------------------------E-------------------------------E--------------------------------E----[]----XXX------------------------------------------------------[]--------E---E---------XX-----------------------[]----------------------------X-------------------------------[]------[]---------XXXXX-----------------XXXXX-------------------E-----E----------------------XXXXXXXX---------[]--------------------[]------------[]------------------------[]--<>---------------[]--------[]------[]----------E-E--------[]-------------------[]-----E----[]----------------EXXX--XX--E-------X-----------------------------------------------------------------------------EE--E----[]--------------------------XXX-----E-------XXX-------------------------------------------------[]--E------XXX------------------------------------------[]---------------------------------------X-------------[]----<>[]----------------------------------------------XX-----------------E------XXXXXXX--------------<>------E---------------------E--------<>---------------------[]---XX------------<>[]------[]-------------E-E---------------------------------[]----<>--[]------XX----------------------[]---------------------------------X--------------EXXX--XX-------[]--------[]------<>--[]-------------------------------------------<>----------------------------E------[]---------------------------------
----X-----------------------------------<>-------------------------------------------------------------E---------------------------XX--X------------------------------------------<>------------------------------<>-------------------------------<>----[]---XXXX----------------------X-------------------------------[]-------<>--<>---------XX-----------------------[]----------------------------X-----------X---X-----------X---[]------[]--------XXXXXX------XXXXXXXX--------------------------<>----<><>-------------------XXXXXXXXX---------[]--------------------[]------------[]------------------------[]--[]---------------[]--------[]------[]---------<><>--------[]-------------------[]----<>----[]---------------XXXXX--XXX-----E--XX-----------X---------------------------X-----------------------------------------E----[]-------------------------XXXXX--------E---XXX----------------------------------X--------------[]-<>------XXX------------------------------------------[]--------------------------------------XX-------------[]----[][]---------------------------------------------XXX-------------E--<>-----XXXXXXXX---------X----[]-----<>--------------------<>--------[]--------------------X[]---XXX---------X-[][]------[]------------<><>---------------------------------[]----[]--[]-------X----------------------[]---------------------------------X----------<>-XXXXX--X--------[]--------[]------[]--[]--X----------------------------------------[]-------------------------------X---[]---------------------------------
EE--X------------------------EE---------[]------------------------------------------------------------------EE-E---------------E--XX---X------E-E----------------------X---E------[]-E-------EE-E-XX--------------[]-------------------------------[]-E--[]-XXXXXX---EE-E--E--EE--------X--------------------------o--E-[]-----E-[]--[]---------XX-----E--------------EE-[]----------------------------X---E-------XXE-X-----EE-E--XE--[]------[]-------XXXXXXX----------------------------------------[]----[][]-------------------XXXXXXXXX------X--[]-E-EE-------E-------[]-E---EE-E---[]-----------------E------[]--[]-----E-EE------[]--------[]------[]---------[][]--------[]-------------------[]--E-[]----[]--------------XXXXXX--XXXX-------XX-----------X-E--------E----------------X---------------XE-----------------------------[]------E-----------------XXXXXX----E-------XXX---EE-E---EE---------------------XXE----------E--[]-[]-----XXXX-E-----------------E-EE------EE--------E--[]---E-EE-----------------------------XXXX---EE-E--X---[]----[][]----------------------------EE-E------------XXXX----------------[]----XXXXXXXXX-------XXX----[]-----[]--------------------[]---E----[]--------------EE-E-XX[]-E-XXXX--EE---XX-[][]------[]------------[][]-----------------------------E---[]-E--[]--[]------XX------EE-E---------E--[]----------EE------EE-----------XXX----------[]XXXX-X--X------X-[]------E-[]------[]--[]--X-----------------------------EE---------[]-----------------E-------------XE--[]--------------EE-E--E--------E-EE
XXXXXXXXX---XXXXXXXXX---XXXXXXXXXXXXXXXXXXXXXXXXXXXXXXXXXXXXXXXXXXXXXXXXXXX-----XXXXXX-XX-XX-X-X--XXXX--XXXXXXXX---XXXXXXXXXXXXXXXXXX-XX--XXXXXXXXXXXXXXXXXXXXXXXXXXXXXXX-XXXXXXXXXXXXXXXXXXXXXXXXXXXXXXXXXXXXXXXXXXXXXX----S---XXXXXXXXXXXX----XXXXXXXXXXXXXXXXXXXXXXXXXXXXXXXXXXXXXXXXXXXXX--------------------XXXXXXXXXXXXXXXXXXXXXXXXXXXXX--X--XXXXXXXXXXXXXXXXXXXXXXXXXX-XXXXXXXXXXXXXXXXXXXXXXXXXXXXXXXXXXXXXXXXXXXXXXXXXXXXXXXXXXXXXXXXXXXXXXXXXXXXXXXX-X----------------------------XXXXXXXXXXXXXXXXXXXXXXXXXX--XXXXXXXXXXXXXXXXXXXXXXXXXXXXXXXXXXXXXXXXXXXXXXXXXXXXXXXXXXXXXXXXXXXXXXXXXXXXXXXXXXXXXXXXXXXXXXXXXXXXXXXXXXXXXXXXXXXXXXXXXXXXXXXXXXXXXXXXXXXXXXXXXXXXXXXXXXXXXXXXXXXXXXXXXXXXXXXXXXXXXXXXXXXXXXXXXXXX--XXXXXXXXXXo--XXXXXXXXXXXXXXXXXXXXXXXXXXXXXXXXXXXXXXXXXXXXXXXXXXXXXXXXXXXXXXXXXX--XXXXXXXXXXXXX---XXXXXXXXXXXXXXXXXXXXXXXXXXX-XXXXXXXXXXXXXXXXXX-XXXX-XXXXXX-XXXXXXXXXXXXXXXXXXXXXXXXXXXXXXXXXXXXXXXXXXXXXXXXXXXXXXXXXXXXXXXXXXXXXXXXXXXXXXXXXXXXXXXXXXXXXXXXXXXXXXXXXXXXXXXXXXXXXXXX-XXXXXXXXXXX-----------XXXXXXXXXXXXXXXXXXXXXXXXXXXXXXXXXXXXXXXXXXXXXXXX----XXXXXXXXXXXXXXXXXXXXX-X----------E-----XXXXXXXXXXXXXXXXXSX--XXXXXXXXXXXXXXXXXXXXXXXXXXXXXXXX---XXXXXXXXXXXXXXXXXXXXX-XXXXXXXXXXXXXXXXXXX-XXXXXXXXXXXXXXXXXXXXXXXXXXXXXXXXXXXXXXXXXXXXXXXXXXXX---XXXXXXXXXXXXXXXXXXXXXXXXXXXXXXXXXXXXXXXXXXXXXXXXXXXXXXXXXXXXXXXXXXXXXXXXXXXXXXXXXXXXXXXXXXXXXXXXXXX----XXXXXXXXXXXXXXXXXXXXXXXXXXXXXXXXXXXXXXXXXX-XX--XX--X----------------------------XXXXXXXXXXXXXXXXXXXXXXXXXXXXXXXXXXXXXXXXXXXXXXXX-XXXXXXXXXXXXXXXXXXXXXXXXXXXXXXXXXXX