-------------------------------------------------------------------------------------------------------------------------------------------------------------------------------------------------------------------------------------------------------------------------------------------------------------------------------------------------------------------------------------------------------------------------------------------------------------------------------------------------------------------------------------------------------------------------------------------------------------------------------------------------------------------------------------------------------------------------------------------------------------------------------------------------------------------------------------------------------------------------------------------------------------------------------------------------------------------------------------------------------------------------------------------------------------------------------------------------------------------------------------------------------------------------------------------------------------------------XXSS-------------------------------------------------------------------------------------------------------------------------------------------------------------------------------------------------------------------------------------------------------------------------------------------------------------------------------------------
-----------------------------------------------------------------------------------------------------------------------------------------------------------------------------------------------------------------------------------------------------------------------------------------------------------------------------------------------------------------------------------------------------------------------------------------------------------------------------------------------------------------------------------------------------------------------------------------------------------------------------------------------X-------------------------------------------------------------------------------------------------------------------------------------------------------------------------------------------------------------------------------------------------------------------------------------------------------------------------------------------------------------------------------------------------------------------------------------------------------------------------------------------------------------------------------------------------------------------------?SSS---------------------------------------------X----------------------------------------------------------------------------------------------------------------------------------------S----------------------------------------------------------------------------------------------------------------------------------------------------
----------------------------SSSSSSSSSSS--SSSSSSSSSSSSSSSSSSSSSSSSSSSSSSSSSSSSSSSSSSS------------------------------------------------------------------------------------------------------------------------------------------------------------------------SSSSSSSSSSSSSSSSS------SSSSS------------------------------------------------------------------------------------------------------------------------------------------------------------------------------------------------------------------------------------oo----------------------------------------------------------------------------------------------------------SSSSSS--------------------------------------------------------------------------------------------------------------oo--------------------------------------------------SSSSSSSSSSSSSSSSSSSSSS---Soo-----------------------------S---S-----------------SSSSS----------------------------SSSSSSSSSSSSSSSSSSSSSSSSSSSS------------------------------------------------------------------------------------------------------------------------------------------------------------------------------------------------------------------------------------------------------------SSSSSS-----------SS------SSS-------------------------o------------------------------------------------------------------------------------------------------------------------------------------------------------------------------------------------------------------------------------------------------------------------------------------
-----------------------------------------SSSSSSSSSSS----S-----------------------------------------------------------------------------------------------------------------------------------------------------------------------------------------------------SS--------------?-----------------------------------------------------------------------------------------------------------------------------------------------------------------------------------------o--------------------------------------------------XXXX---------------------------------------------------------------------------------------------------------------------------------------------------------------------------------------------------------------------------------E--E-------------------------------------------------------------------------------------------------------------------------------------------------------------------------------------------------------------------------o----------------------------------------------------------------------------------------------------------------------------------------------------------------o---------------------------------------------------------SSSS--------E-----------------------------------------o-------------------------------------------------------------------------------------------------------------------------------XX-----o----X---------------------------------------------------------------------------------------------------------------------------------------------
----------------------------------------SSSSSSSSSSS-----S-----------------------------------------------------------------------------------------------------------------------------------------------------------------------------------------E-----------SS--E-----------?-------------------------E-------------------------------------------------------------------------------------------------------------------------------------------------------------------------------------------------------------------------------------------------------------------------------------------------------------------------XX---------------------------------------------------------------------------------------------------------------------------XXXXXXX-----------------------------------------------------------------XXX------------------------------------------------------------------oo--oo--------------------------------------------------------------------------E-------------------------------------------------------E-------------------------------------------------------------------------------------------------------E-----------------------------------------------------------SSSS----XXX---------------------------------------------------------------E---------------------------------------------------------------------------------------------------------------------------------------------------------------------------------------------------------------------------------------------------------------------
-----------------------XX---oooo--E----SSSSSSSSSSS-S-S--S-----------------------------------------------------------------SQS------------------------SSSS-------------------------------------------SS-------------------------------------------SQ--SSSS----SQQ-------------S---SSS-------Xoo--XXX-----E--E------------SSQ-------------------Q-------------------SSSSS--------------------------XXXXX--------------E--S-------------------------------------------------XXXX-----XX-X---------S-------------S?SSSSS-------------------------------S-----------------------------S-?----------------SSSS----------------------------------------------------------------SSSSSS--------E--------------------------Q---SSSS-----S-S-----------SS---?----SS----------------------------------------------------------------------------------------------------SSSSSS----SQS-Q--------------S----------oo----------------------------Q---------------------------------------------------E-----SQSS?----------------------------------------SSSS-------ESSS---SSSS----------------------------------------------o----X----------XX-----SS----SS----------------SS------S---S-------SS------------------------------------SS--SS---o---oo-------------SS---?--------------------------Q-------------SSSSSSSS--------------SS-----------------------------------------------------------------------S-XX-------------------------------------------------SSSS--------XXX----------------------------------------------------------------?-SS-----SSSS------------------------
----------------------XXX--------<>----S------------------------------------------------------------------------------------------------------------------------------------------------------------------------oooo-----------------------------------------S-------------------SSS----------------------XXXXXX---------------------------------------------------------------------------------------------------<>----------------------------------------------XX-------------------------------------------------------------------------------------oo-------------------------------------------------------------------------------E-----------------------------------------<>----------------------------------------------------------------------------------oooo----------------------------------------------------------------------------------------------------------------------------------------ooooo----------------------------------------oooo---------------<>------------------------------------------------------------------------------------------XXX-----------------------XX---------------XXX-----ES----------------------SS------------------------------------------------------------SS------------------------------------------------------------------------------------------------------------------------------------------------------------------------------------XXXXX--------------------------------------------------------------------------------------------------------------------XX-----------------------------
----------------X----XXXX--------[]----S--------------------------------------------------------------o-----------------------------------------------------------------------------------------------o----------------------XX------------------------------S-------------------SS-------------------------------------------------------------------------------------------------------------------XX-----------[]-------------------------------------------E-------------------------o---------------------------------------------------------------------E-----------------------------------------------o-----------------------XXXXXXX---------------------XX---------------[]--------------------------------------------------------------------------------------------X------------------------------------------------------------------------------------S----------------------------------------------------------------------------------X-------------------------[]---------------------------------------------------------XX-------------------------------------------------------------------------XXXX------S----------------------SS-----S-------------------E----------------------------------SS---S-S-SS----------E---------------------oo-------------------------------------------------------------------------------------------------------------------------------------------------------------------------------------------------------------------------------------------------------------------------------------------------
---------------------XXXX------SS[]----??oooooooo-------------S-----------------------------oo--------------XX--S----------------------------------------------------------------------E----------------------E---------------X------------------------E----SS---------------o??-SS--EE-------------------------------------------------E------------o-----------------------------------------------XXX-----------[]-----------E------------------------------------------------------------------------------------------------------------------------------<>-------------E------------------------------X------------------------------------S----o---------oooS--------E----E--XX------------------E----------------------------------------------XX-------------E----------XX------------E-----------------------E------------------------------------------------E-------SS-----------------XXX--------------------------------------------------XXX-------------------------[]-X--oooo------------------E-----------E-----E-----SSS-S--SX------------------------------------------------------QQo---------------XXXXX-----SS----S-----------S-----SS-----S------------------<>--------------------------------XoSS---SoS--So-----E--<>---------------------------------------------------------------E--------------------------------------------------------------------------------------------------------XXX---------------E--------------oo---oo-----------S------------------------XSS-SQ--------------------------------------------------------------
-------------------X-XXXX------SS[]----??SSSSSSSSS---S-S--------X-------------------S---------------SS-----XXX-XS------QQ?QQQ---------S--------Q-Q---SQS------------<>----------------<>---------E--SS-------<>-----------X-X-X-----------------S-----<>----SSSS-------------SS--SS----X------XX----XXXX-------------------------------<>-----?-----------------------------------------E<>---------XXXX-----------[]SS--------<>------------------E----------XX--------------XXX------------ooo------EXX-XX---------------------------------------------------[]-------E----<>--QoQ------------------------XX----S----------------------------------E--------------S---QQQ------<>--XX-----------------<>----E?QSS-------------SE----------QQQ--QQ-------------------<>---------XXX-----------<>----------------------<>-----------------------------------S----------QSSSS--------E------------------------XXX-----------------QQQ--------------------XXXX------------------E------[]-X--SSSSSS------S--------<>----------<>----<>------------SX-QQQ-----------------------XXX--------------X--X-----------------------XXXXXX-----SS---SSS---------X--X---SSSS----S--------E--S--E--[]--------------------------------XSSS---SSS--SSS---<>--[]----ooo-------XXX-XX--------------SS------------SS--S------X--<>----QQQS------------S-----------------------------------------------S--------E--XX--XXXXX--------------------------------<>-------------------------------XX-----------------------XXX-----------------------XXXX---SS-----X-------oo-o-----------------
-------------------XXXXXX--------[]-----------------------E-----X------S-----------------------------------XXX------------------------------------------------------[]----------------[]--<>----<>--------XX-[]-----------X-X-X-----------------E--E--[]--XX---------XX---X---------E--X-----------------------------------------------[]---------------------XX---X-------------------<>[]--------XXXXX--E--------[]---E------[]-----------------<>---------XXXX----------------X-------------------XXXX-XX-------------------------------------E-------------[]------<>----[]----------------------------XXX------E--------------------------E----<>---------------------------[]--XX-----------------[]------E-------E----------------------------------E----------[]--------XXXX---XX------[]----------------------[]---------------E-------------------------------E----------------------------------E-------E-----------------------------------XXXXX----E------E-----<>------[]-------------------------[]----------[]----[]------------S----------E----------------XXXX------E-------X--X----------------------XXXXXXX-------------------E--X--XX----SS------------<>----<>--[]------------------------E-------X-----------------[]--[]-------------XXXX-XX-------------------------------E-------X--[]------------------------------XXX---------------X---------------------------<>-------------------------------------------[]---------------X--------------XXX-XX-------------------XXXX--------EX------------XXXXX---------XX------------E--E---X--------
-------------------X-XXXX--------[]----------------------<>-----XX-------Q?------------------------------XXXXX------------------------------------------------------[]----------------[]--[]----[]-------XXX-[]-----------XXX-X-----------------------[]--XX--------XXX---X------------XXXXXX------------------------------------------[]-------------------X-XX---X------oo-----------[][]-------XXXXXX-----------[]----------[]-----------------[]--------XXXXX----------------X------------------XXXXX-XXXX---------X------------------------<>-------------[]------[]----[]------------E---------------XXX--------------------------------------[]---------------------------[]--XX-----------------[]------------------------------------------------<>----------[]----<>-XXXXX---XXX-----[]----------------------[]--------------<>-----------------------------------------------------------------<>------<>----------------------------------XXXXXX---<>-----<>-----[]--<>--[]-------------------------[]----------[]----[]------------S---------<>----------------XXXX----------E------X------------------E--XXXXXXXX----------------------X--XXX--SSS------------[]----[]--[]-----------------------<>-------X-----------------[]--[]------------XXXXX-XXX--------------------------------------X--[]--------------------<>--------------------------X---------------------------[]-------------------------------------------[]---------------X-------------XXXX---XX----------------XXXXX--------oX-----------XXXXX---------XXX-------------------X--------
-------------------X-XXXX--------XX-----------E-E--------[]-----X------------------E----------------E-E--XXXXX-----E----------------------------------------------E-[]---E----E---E-E-[]--[]----[]--E-EE-XXX-[]-----------XXX-X-----------------E-----[]--XX-------XXXXEE----E---------X---------------------------------E-E-----------[]------X--------------X----X------XX------E-E--[][]------XXXXXXX-----------[]------E---[]----E-EE----E-E--[]-------XXXXXX----------------X----------E------XXXXXX-XXXX--------XX--E-E-E-----------------[]-------E-EE--[]------[]----[]-E--------------------------XXX---------------------E-E---------E-E--[]---------------------------[]--XX----------EE-E---[]-------------------E-----------------E-EE-------[]----------[]----[]XXXXXX-E-XXX-----[]--E-E-E---------------[]--------------[]------------EE-E-------------------------------------------------[]------[]---------------------------------XXXXXXX---[]-----[]-----[]--[]--[]----E-E---------E-----E--[]---EE-E---[]----[]------------X------E--[]----------E-EE--XXXX-----------------X---------ooo--------XXXXXXXXX-----E-EE-------E-E---X--XXXX-ES--EE-E-------[]-E--[]--[]------------E-E-E------[]-------X--E-----------EE-[]--[]----E------XXXXX--XXXX---------X-----------E---------------X--[]------------------E-[]--------------------------X----EE-------------------E-[]---------------------------------EE-E------[]---------------X------------XXXXX---XX---------------XXXXXX--SSSSS-------------XXXXXX--------XXXX-------------------X---E----
-XXXXX------XXXXXXXXXXXXXXXXXXXXXXX-XXXXXXXXXXXXXXXXXXXXXXXXXXXXX---XXXXXXX---XXXXXXXXXXXXX----XXXXXXXXXXXXXX--XXXXXXXXXXXXXXXXXXXXXXXXXXXXXX--XXXXXXXXXXXXXXXXXXXXXXXX-XXXXXXXXXXXXXXXXXXXXXXXXXXXXXXXXXXX--XX----XXXXXXXXXXXXX--XXXXXXXXXXXXXXXXXXX-XXX-XXXXXXXXXXXXXXXXXXXXXXXXXXXXXX--------XXXX-------------X--XXXXXXXXXXXXXXXXXXXXXXXXXXXXXXXXXXXXXXXX--S----XXXXXXXXXXXXXXXXXXXXXXXXXXXXXXXXXXXXXXXXXXXX--XXXXXXXXXXXXXXXXXXXXXXXXXXXXXXXXXXXXXXXXXXXXXXXXXXXXXXXXXXXXX---XXXXXXXXXXXXXXXXXXXXXXXXXXXXXXXXXXXXXXXXXXXXXXXXXXXXXXXXXXXXXXXXXXXXXXXXXXXXXXXXXXXXXXXXXXXXXXXXXXXXXXXXXXXXXXXXXXXXXXX---XXX--XXXXXXXXXX--XXXXXXXXXXXX----XXXXXXXXXXXXXXX-XXXX---XXXXXXXXXXXX--XXXXXXXXXXXXXXXXXXXXXXXXXXXXXXXXXXXXXXXX--XXXXXXXXXXXXXXXXXXXXXXXXXXXXXXXXXXX-XXXXXXXXXXXXXXXXXXXX-XXXXXXXXXXXXXXXXXXXXX--XXXXXXXXXXXXXXXXXXXXXXXXXXXXXXXXXXXXXXXXXXXXXXXXXXXXXXXXXXXXXXXXXXXXXXXXXXXXXXXXXXXXXXXXXXX--XXXXXXXXXXXXXXX-XXXXXXXXXXXXXXXXXXXX---XXXXXXXXXXXX-XXXXXXXXXXXXXXXXXXXXXXXXXXXXXXXXXXXXXXXXXXXXXXXXXXXXXXXXXXXXXXXXXXXXXXXXXXXXXXXXXXXXX-XXXXXXXXXXXXXXXXXXXXXXXXX-XXXX--XX-XXXXXXXXXXXXXXXXXXX---XXX--XXXXXXXXXXXXXXXXXXXXXXXXXXXXXXXXXXXXXXXXXXXXXXXXXXXXXXXXXXXXXXXXXXXXXXXXXXXXXXXXXXXXXXXXXXXXXXXXXXXXXXX---XXXXXXXXXXXXXXXXXX--XXXXXXXXXXXXXXXXXX--XXXXXXXXXXXXXX--XXXXXXXXXXXXXXXXXXXXXXX--XXXXXXXXXXXXXXXXXXXXXXXXXXXXXXXXXX-----XXXX-XXXXXXXXXXXXXXXXXXXXXXXXXXXXXXXXXXXXXXXXX----------------------------XXXXXXXXXXXXXXXXXXXXXXXXXXXXXXX------XXXXXXXXXX--XXXXXXXXXXXXXX-XXXXXXXXX-------XS-XXXXXXXXXXXXXXX----X-XXXXXXXXXXXXXXXXXXXXX-X-X--XXXXXXXXX