------------------------------------------------------------------------------------------------------------------------------------------------------------------------------------------------------------------------------------------------------------------------------------------------------------------------------------------------------------------------------------------------------------------------------------------------------------------------------------------------------------------------------------------------------------------------------------------------------------------------------------------------------------------------------------------------------------------------------------------------------------------------------------------------------------------------------------------------------------------------------------------------------------------------------------------------------------------------------------------------------------------------------------------------------------------------------------------------------------------------------------------------------------------------------------------------------------------------------------------------------------------------------------------------------------------------------------------------------------------------------------------------------------------------------------------------------------------------------------------------------------------------------------------------------------------------
-----------------------------------------------------------------------------------------------------------------------------------------------------------------------------------------------------------------------------------------------------------------------------------------------------------------------------------------------------------------------------------------------------------------------------------------------------------------------------------------------S------------------------------------------------------------------------------------------------------------------------------------------------------------------------------------------------------------------------------------------------------------------------------------------------------------------------------------------------------------------------------------------------------------------------------------------------------------------------------------------------------------------------------------------------------------------------------------------------------------------------------------------------------------------------------------------------------------------------------------------------------------------------------------------------------------------------------------------------------------------------------------------------------------------------------------------------------------------------------------------------------------------------------------------------------------------------
------------------------------------------------------------------------------------SSSSSSSSSSSSSSSSSSSSSSSSSSSS----oo-----------------------------------------------------ooo--------------------------------------------------SSSSSSSSSSSSSSSSSSSSSSSSSSSS-----------------------------S----------------SSSSSSSSS-------------------------------------------------------------------------------------------------------------------------------------------------------------oo-------------S--------------------------------------------------------------------------------------------------------------------------------------------------------------------------------------------------------------------------------------------------------------------------o---------------------------------------------------------------------------------------------------------------------------------------------------------oo--------------------------------------------------------------------------------------------------------------------------------------------------SSSSSSS--S--SSSS------------------------------------------------------------------------------------SSSSSSSSSSSSSSSSSSSSSSSSSSSS------------------------------------------------------------------------------------------------------------------------------------------------------------------------------------------------------------------------------------------------------------------------------------------------------------------------oo----------------------
-------------------------------------------------------------------------------------------------------------------XXXX----------------------------------------------------XXXX---------------------------------------------------------------------------------------------------------------------------------------------------------------------------------------------------------------------------------------------------------------------------------------------------------------SS--------------?-------------------------------------------------------------------------------------------------------------------------------------------------------------------------------------o---ooo---------------------------------------------------------------------------------------------------------o------------------------------------------------------------------------------------------------------------------------------------------S----------------------o---------------------------------------------------------------------------------------------------------------o------------------------------------------------------------------------------------------------------------------------------------------------o--------------------------------------------------------------------------------------------------------------------------------------------------------------------------------------------------------------------------------------------------------------------------------------------E--E----------------
---------------------------------------------------------------------------------------------------------------------------------------------------------------------------------------------------------------------------------------------------------------------------oo---------------------------------------------------------------------------------------------------------------------------------------------------------------------------------------------------------------E-S---E-------------------------------------------------------------------------------------------------------------------------------------------------------------------------------------------------------------------------------------------------------------??------------------------------------------------------------------------------------------------------------------------------------------------------------------------------------------------E--------------------S---------------------------------E-------------------------------------------------------------------------------------------------------------------------------------------------------------------------------------------------------------------------------------X----------------X---E--------------------------------------------------------------------------------------------------------------------------------oooo--------------------------------------------------------------------------------------------------------------------------XXXXXXX--------------
S-----------E--S--------------------------------------------------------QSQ--?--------Q-----------------------------------------------------------------------------SSSS----------------------------------------------E-------------------------------------SSSSS-----------------------SQQ--------------------------------XXXX--------------------------QQQQQQ---------------------E--------oo----EQ-------------------E--------oo--------E----------------------------XX------XXX---------SS----SS-------------SSS---S------------------------------S-QQ---------------------------------------------S---------------SSS--SSSSSS-----------------------------------------------------SSSS-----??SSS------XXX----o--------o-----QSS??-----------------S----S-S--??---------XXX------------------------------------SS-----------XXX-----SSSS-----------QQQQQ-------------S-?-------------SSSSSSS----------------SSSSSSSSSSSS--SS----------------------------------SS---------S---------S--------------------------------SQS---------XX------SSSS------S----------------S----Q-----------------------SSoo--------------------------------------------------------------------------------------------------------------------ESSS---SSS----S---------SSSS-----------------SSS-------SQQ-----SSSS----------------------------------------------------SSSSSSSSSSSSS--------------------SSSSSS---------X----------------------------------------SSSS-------SQ?SSS---?--SSS----------SS--------------------------------------------------------------------------------------
-----------<>--------------------------------------------------------------------------------------------------------------------------------------------------------------------------------------------------------<>-----------------------------------------------------------------S----E----------------------------------------E--------------------------------------------<>----X------------------------------------------------<>-----------------------------------XXXX---------SS----SS-------------SS-------------------------------------------------------------------------------------------------------------------------------------------------------------------------------XXX----------S----------XX-------S---------------------------------------XXXX-----------Qooo---------------------------------XXXX----------------------------------------------------------------------------------------------------------------oooo-----------SS---------------------------------------------------------------XXX----------E-----------------------------------------------------------------------------------------------------------------------------------------------------------------------------------------------------S--------------oo----------------------------------------------------------------------------------------------------------------------------------------X----------o----------------------------------------------------------------------------------------------------------------------------------oooo-------
-----------[]------------------------------------------------------------------------------------------------------------------------------S-------------------------------------------------------------------------[]-----------------------------------------------------------------S--------------------------------------------<>---------X----------------------------------[]-----------------------------XXXX--------------------[]----------------------------------EXXXX---------SS--E-SS-------------S----------------------------------------------------------------------------------------------------------------------------------------------------------------------------------------------------------------SS-----------E-------------------------XXXXXX-----------------------------------------------XXXXX---------X---------------------------------------------------------------------------------------------------------------------SS--------------------------------------------------------------XXXXX-----------------------------------------------------------S-SS-S----------------------------------------------------S---------------------o-------------------------------------XX----------------------------S------------------------------------------------------------------------------------------------------------------------------------------------------------------XXX----------------------------------------------------o---------------------------------------------------------------------------------------
-----------[]-----------E-------------------------------------E-----E-------------------------------o---------------E-----------------E---------E------------------------S-------------------------------------------XX--------------------------------------------------------------oo-SE-------SSS-----------------o---------------[]--------------------------------------------[]-------------------------------------------ooo----E--XXX--------------------------------XXXXXX---------SS--ooSS----------??SSS--E---------------------------------------------E---------------------------E--SSSSQ-----------------------------------------------------------------------------------------SSS------------S--------------ooooSS----------<>----<>------------------XXXXXXX---------E---------o----------------------E-EXXXXXXX--------------------------------------------------------------------------------------------X-------E--S------E----------X-----SS-----------------------------------------------X-------------XXXXX-------------------------E-----S----------------------------SoS--S---------------------E----------------------------------------------E----------------------------ooooo----------SX--------------------------ooS------------------S--------------------------------------------ooo---oo-------------------------------------X--------------------------EX--------------------------------------------------------------------------------------o------------------------------------------------------S-SQ----------E------------
--E--------[]SS--------<>--------------oo----------------S---<>----<>--S----E-------SSSS---------------------------<>----------S-----<>--------<>-----E------------------------------------------XX-----Q-Q-------------E--------QQQ--------------------XXX-------QQ----X---------------SSSS---E-----------------------------------XXXX---------S--QQ--QQ?SSQQQ---------------E--SS[]-S--------XXX-SSSS------XXX-------------X--------<>-----------------X------------------XXXXXXX---------SSSSSSSS--S-------------SSSS-oo-------XXX-XX--------S------SSS--------<>------------QQQ-----------<>---------------QQQQ---------S-------------------------------E-------------------X--X--------------------------XXXXX-----------ESSSSS--S-------[]----[]--QS--S?S---------XXXXXXX--------<>-----E----------------------------XXXXXXXX---------X---Q--QQ--SQSQQ------------oooo-------XX--X----------XX-------------------SS-----XX---E--<>-----E--<>----------X------SS----S---S-------XXX--------------E-----------XX----SQS-----XXXXXX---------------SS-------<>---------E--S------E-XX------S----XSSSSS-----E--------E-----<>------------E-------E-----E------------------<>---S---E-------Q--------------------E-------XX-Q-Q---SSSS----X---------SSSSS-ES--------S-------------ESSS---------------------------------------XX---XX-------Q--------X--X----------XX----------------S--------<>X-----XXXXXXX--------------------------------SS-------------S?S--Q------------SS-----------------------------SS--------------------------------------------<>------------
-<>--------[]---E------[]--------------------XXX-------------[]----[]------<>--------------------------------------[]---------E------[]--XX----[]----<>--------------------------------------X---XXX-----------E------E<>------------------------------XXXX-----------------------------E-----<>-----------------E----------------XXXXX-XXX-----S----------------------------<>----------------------------------------------S--------[]-----------------X----------E------XXXXXXXX--------------------------------EE------------XXXX-XX---X----------------------[]--------------------------[]-----------------------------------------------------------<>------------------XX--XX----------------------EXXX--XX---------------------------[]----[]----------------XXXXXXXXX--------[]----<>--------------------------EXXXXXXXXX---------X-------------------------------------XXX--XX--------XXX----------XXX------E-----XXX--<>--[]----<>--[]----------X------------------------XXX-------------<>---E------XXX-----------XXXXXXX------------------------[]--E-----<>------XX<>-XX---------------SS----<>-------<>-----[]-----------<>------<>----<>------------------[]------<>---------------------------<>-------XX---------------X------------------------------------------------XX--X--------------------------------------------------XXX--XX--------XXX-------------------------[]X------------o-----o-----oXXX--------------------------------------------X---------------------------------------------------------------------------------[]------------
-[]------------<>------[]--------XXXXXXX---------------------[]----[]------[]--------------------------------------[]--------<]------[]-XXX----[]----[]--------------------------------------X---XXX----------<>-----<>[]-----------------------------XXXXX-----------------------------------[]------------------------------<>-XXXXXX-XXXXX---S----------------------------[]----------------------------------------------X--------[]-----------------X---------<>-----XXXXXXXXX--------X------------------------------------XXXXX-XXX--X----------------------[]--------------------------[]--<>-------------------X---X-------------------------------[]-----------------XXX--XXX---------X----------XXXXX--XX--------X------------------[]----[]---------------XXXXXXXXXX--------[]----[]--------------X-----------XXXXXXXXXX--------XS------------------------------------XXXX--XXX-----EXXXX---------XXXX--X--------XXXX--[]--[]----[]--[]----------X-----------------------XXXX-------------[]--<>--<>-XXXX----------XXXXXXXX------------------------[]-<>-----[]-----XXX[]-XX---------------SS----[]-------[]-----[]-----------[]------[]----[]------------------[]------[]---------------------------[]-------XX---------------X--------X--------------------------------------XXX--XXX-----------------------------------------------XXXX--XXXX-----XXXX-------------------------[]X-----------XXXX--XXX---XXX------------------------------------------E---X----------X----------------------------------------------------------------------[]----<>---X--
-[]------------[]--E---[]--------XXX-----------------E-EEE---[]----[]---E--[]-----------------------------EE-E--E--[]-E-EE---[]E-----[]-XXX----[]----[]-E-E------------X------E-EE----EE-E---X---XXX---EE-----[]-----[][]----------------------------XXXXXX-----------------------------------[]----------------------------E-[]XXXXXXX?XXXX?---S----E-EE-------EE-E---------[]-E--------------------------------------------X-----E--[]-------------E---X---------[]----XXXXXXXXXX-------XXE-EE-------E-----E----------E-E----XXXXX--XXX--X---------E------------[]---E-EE--------EE-E----E--[]--[]-----------E-------E-E-X--------------------E----------[]-E-E-E----E-----XXXX--XXXX--EE---XX---------XXXXXX-----------XX-E-E----------E---[]----[]----------------XXXXXXXXX-----E--[]----[]--------------X---------XXXXXXXXXXXX-------XXS-------E-E-----------------E-------XXXXX--XXXX----XXXXX----E---XXXXXE-X-------XXXXX--[]--[]-E--[]--[]----------X-EE-----------E--------XXXX---EE-E-EE-E-[]--[]--[]-XXXX--E------XXXXXXXXX-----------E-EE------E--[]-[]--E--[]-S--XXXX[]-XXX----------X--E------[]-----E-[]-----[]-----------[]------[]----[]-------------E-E--[]------[]---------------------------[]-------XX-------------X-X----EE--X-E---------------------------E-------XXXXE-XXXXE-EE-E--------------------------------E-E----XXXXXE-XXXX----XXXXX--------EE--E--E-----E---[]X--ooo--------------------------E--E--------E----------------------------X-----E----X-------------------------------------------------------------------E--[]----[]---X--
-XXXXXXXXXXXXXXXXXXXXXXXXXXXXXXXX----------------XXXXXXXXXXXXXXXXXXXXXXXXXXXXXXXXXXXXXXXXXXXXXXXXXXXXXXXXXXXXXXXXXXXXXXXXXXXXXXXXXXXXXXXXXXXXXXXXXXXXXXXXXXXXXXXXXXXXXXXXXXXXXXXXXXXXXXXXXXXXXXXXXXXXXXXXXXXXXXXXXXXXXXXXXXXXXXXXXXXXXXXXXX----XXXXXXXXXXXX-XXXXXXXXXXXXXXX-XXXXXXXX--XXXXXXXXXXXXXXXXXXXXXXXXXX--XXX---XX----XXXXXXXXXXXXXXXXXXXXXXXXXXXXXXXXXXXXXXXXXXXXXXXXXXXXXXX----XX---------------------XX-XX-X-XXX-XXXXXXXXXXXXXXXXXXXXXXX-XXXXXXXXXXXXXXXXXXXXXXXXXXXXXXXXXXXXXXXXXXXXXXXXXXXXXXXXXXXXXXXXXXXXXXXXXXXXXXXX--XXXXXXXXXXXXXXXXXXXXXXXXXXXXXXXXXXXXXXXXXXXXXXXXXXXXXXXXXXXXXXXXXXXXXXX-XXXXXXXXXXXXXXXXXXXXXXXXXXX---XXXXXXXXXXXXXXXXXXXXXXXXXXXXXXXXXXXXX--XXXXXXXXXXXXXXXXXXXXXXXXXXX---X-X-XXXXXXXXXXXXXXXXXXXXXXXXXXXXXXXXXXXXXXXX-XXXXXXXXXXXXXXXXXXXXXXXXXXXXXXXXXXXXXXXXXXXXXXXX--XXXXXXXXXXXXXXXXXXXXXXXXXXXXX---XXXXXXXXXXXXXXXXXXXXXXXXXXXXXXXXXXXXX--XXXXXXXXXXX-X-XXXXXXXXXXXXXXXXXXXXXXXXXXXX-XXXXXXXXX-XXX-XX--XXXXXXXXX-XXXXXXXXXXXXXXXXXXXXXXXXXXXXXXXXXXXXXXXXXXXXXXXXXXXXXXXXXXXXXXXXXXXXXXXXXXXXXXXXXXXXXXXXXXXXXXXXXXXXXXXXXXXXXXXXXXX-XXXXXXXXXXXXXXXXXXXXXXXXXXXXXXXXXXXXXXXXXXXXXXXXXXXXXXXXXXXXXXXXXXXXXXXXXXXXXXXXXXXXXXXXXXXXXXXXXXXXXXXXX-XXXXXXXXXXXXXXXXXXXXXXXXXXXXXX--XXXXXXXXXX--XXXXXXXXXXXXXXXXXXXXXXXXXXXXXXXXXXXXXXXXXXXXXXXXXXXXXXXXXXXXXXXXXXXXXXXXXXXXX----XXX-----X--X---XXXXXXXXXXXXXXXXXXXXXXXXXXXX----XXXXXXXXXXXXXXXXXXXXXXXX--XXX-----------------------XXXXXXXXXXXXXXXXXXXXXXXXXXXXXXXXXXXXXXXXXX--XXXXXXXXXXXXXXX--XXXXXXXX---------X-XXXXXXXXXXXXXXXXXXX-----XXXXXXXXXXXXXXXXXXXXXXXXXXXXXXXX----