-------------------------------------------------------------------------------------------------------------------------------------------------------------------------------------------------------------------------------------------------------------------------------------------------------------------------------------------------------------------------------------------------------------------------------------------------------------------------------------------------------------------------------------------------------------------------------------------------------------------------------------------------------------------------------------------------------------------------------------------------------------------------------------------------------------------------------------------------------------------------------------------------------------------------------------------------------------------------------------------------------------------------------------------------------------------------------------------------------------------------------------------------------------------------------------------------------------------------------------------------------------------------------------------------------------------------------------------------------------------------------------------------------S-X---Q-----------X----------------------------------------------------------------------------------------------------------------------------------------------
------------------------------------------------------------------------------------------------------------------------------------------------------------------------------------------------------------------------------------------------------------------------------------------------------------------------------------------------------------------------------------------------------------------------------------------------------------------------------------------------------------------------------------------------------------------------------------------------------------------------------------------------------------------------------------------------------------------------------------------------------------------------------------------------------------------------------------------------------------------------------------------------------------------------------------------------------------------------------------------------------------------------------------------------------------------------------------------------------------------------------------------------------------------------------------------------------------------------------------------------------------------------------------------------------------------------------------------------------------------------------------------------------X----X------------------------------------------------------------------------------------------------------------------------------------------------------------
-----------------------------------------------------------------------------------------------------------------------------------------------------------------------------------------------------------------------------------------------------------------------------------------------------------------------------------------------------------------------------------------------------------------------------------------------------------------------------------------------------------------------------------------------------------------------------------------------------------------------------------------------------------------------------------------------------------------------------SSSSSSSSSSSSSSSSSSSSSSSSSSS-----------------------------------------------------------------------------------------------------------------------SSSSSSSSSSSSSS-----------------------------------------------------------------------------------------------------------------------------------------------------------------------------------------------------------------------------------------------------------------------------------------------------------------------------------------------------------------------------------------------------------------------------------------------------------------------------------------------------oo------X-----------------------------------------------------------------------------------------------------------------------oo------------------------------------
---------------------------------------------------------------------------------------------------------------------------------------------------------------------------------------------------------------------------------------------------------------------------------------------XX-------------------------------------------------------------------------------------------------------------------------------------------------------------------------------------------------------------------------------------------------------------------------------------------------------------------------------------------------------------------------o----------------------------------------------------SSSSSSSSSSSSSSSSSSSSSSSSSSS------------------------------------------------------o-----o-----------------------------------------------------------------------------------------------------------------------------------------------E-------------------------------------------------------------------------------------------------------------------------------------------------------------------------------------------------------------------------------------------------------------------------------------------------------------------------------------------------------------------------------------------------------------------------------------XX----S----o--X-----------------------------------------------------------------------------------------------------------------------------------------------
----------------------------------------------E--------------------------------------------------oo--oo--ooo------------------------------------------------------------------------------------------------------------------------------------------------------------------------------------------------------------------------------------------------------------------------------------------------------------------------------------------------------------------------------------E----------------------------------------------------------------------------------------------------------------------------------------------------E-----------------------------------------------------E----------------XSSSSSSSSSSSSSSSSSSSSSSSSSSS-------------------------------------------------------S---------------------------------------------------------E-------------------------------------------------------------------------------------------X-XXX------------------------------------------------------------------------------------------------------------------------------------------------------------E-----------------------------------------------------------------------E--------------------------------------------------------------------------------------------------------------------------------------------------------------------------------------------------------------------------------------------------------------------------------------------------------E-oo----------------------E----------------------
-----------------------------SSQS------------S?SSSSS-------------------------------------oo-----------XXXX-X------SSQS---?-------------SS-----------------E----ooo--------SQQS---------------SSS-----SSSS-------SSS------SS------------------------?SSS---------------------------------------------------------------------------------------------------------------------SSSS-----SSSS-------?-------------------SS-------------------------------S?S--------SSSSS-----------------SSS-------ES----SSSS-SSS----------SSSSS----?SQS-------------------QSS---------SSSS-------S----------------------------------SS-------------------------------SSSSSSSS---------S?SSS-----------SSSQ------------------SQS---------------SSSSSSSSSSSSSSSSSSSSSSSSSSSS----------------------------------SS-----------SS---------SSSQS---?SSS---------------------------------------------SSQSSS---------------------------------------------S----SSS-----S----SQS---------SSSS---------------------------------------SQSSS-----------SQQS-----S-----------SSSS---------------------SSS---------S-----SS--SSSS--------S-S----------------------------E--E-----------------------oo---SSSS----------------------------------SSS--------S-------------------------SSS-SSS--SS--------------------SSSSS----------------QQQQ--------------------------------------------------------------------------------XX-------XXXX------------------o--------------S-S-------------S----------------------------------------------------------XX---XXXXX-------X------------SQS---?-----------------
----E-----------------------ES-------------------------------XXX----o------------------------------------------------------------------------ooo------o-----------------------------------------------------------------------------------------SS----------------------------------------E-------------------------------------------------------------------------------------------------------XXXX----------------------------------------------------------------------------------------------------------------------------------------------------------------------------------------------------------------------------------------------------------------------------------------------E--------------------------S-----------------------------------------------------------------------SS---------------------------------------------------------------------------------------------------oo---------------------------------------------------------------oo---------------------------------------------------------------------------------------------------------------------------------------------------------XXXXXX------------------------------------------------------------------------------------------------------ES-----------------------------------------------------------------------------------------------------------------------------------XX--------------------XXXXX---------------------------------------o-----------------------------------------o------------------------------S-S---------------------------------
-----------------------------S---------------------------XXX-oo-----Q----------XX----------------------------------------------------------------XXXXXXX-------------XoX-----------------------------------------------------------------------XX-------------------------------------------------------------------------------------------------------------------------------------------------------------------------------------------------------------------------------------------X----------------------------------------------E----------------------------------------------------------------------------------------------------------------------------------------------------------------------------E----SSS-----------------------------------------------------------------------SS-------------------------------------------------------------------------------------------------------E--------------------------------------------------------------E---------------------------------------S-----------------------------------------------------------------------------------------------------------X-X---------------------------------------------------------------------------------o-----------------------------S-------------------------X-------------------------------------------------------------------------------------------------------XXXXS---o-----------XXX-oo------------------------------------------------------------------------------------------------------------------XX------------------------XS---------
--E---------------------E-E-SS---------------------------XX--------------------XX------------------------------------------------------------------------------------------------------------S-------------------XSS---------------------------XXS------------------------E--o-----------S--------------------E----------------------------------S-----------------------E-E-----------------------------SSSSS-------------------E-----------------------------X----------------------------S---------------------------------------------<>------------------------------------------------E-----------------------------------------------------------------------------------------------------o-----------------E--<>------------------?E-oooooooooo----------------oo-----S-----------------------SSS--Q-----------------------SSS-S----ooo--------------------------------------------------------E------<>-------E-----------------------------------------------------<>-------------------------------------------------o----------------------------------------------------------------------------------oo------------XX-------------------------------------------------E--------------------------------------------------------E------S-------------------------X--EE-----EE--------------------E---------------------E----------------------------------------------S--XXXXX----------------------------XXX----------------------------X--------------------------E-------------------------------------------------S-----------------------XSS---------
-<>-----------------E--<><>---SSSS----E--------SSSS----X-XXX----------S--S-----XX----------XXXX--XXXX---XXXX------ESSS-------S----------------XXX-----------XXX----X------SSS------XX--X-------------ooo--------XXX------SS------o------------XXX----------X-------------<>-----E----------------------------<>------------XXXX-----------------------------S-----------<>---------Q?QQQQ--------------X------------S----X------<>------------------------X---XX-oo--------XX-XX------------S--QQQQ--Q-QQ-------------E----Q--QQQ---------[]---E--------SSS----E--------------SS-----------<>---------E-----------SS-----------------------QSS----------QQ?-------------S--o--------S-----------------------SS-S---<>--[]--SSSSSSSSSSSSSSSSSSSSSSSSSSSSS----S----------------------------SSS-------X----S----SS-----S?S-------------------------------------X-X---------------------XX--XS----------E--<>------[]------<>-----E----QQ--QQQ--Q--QQQQ---------------E--------E--[]-----E--------------Q--QQQQ------------SQS--------------------------------------------------S---Q-----------Q------------S--------E--------------XXXX----------------------XX------XXXX-------------<>----------------------SSS---XX------------------E-----E<>---QSSSSS---SS---------------X-XXSSSSSS--SSSSSS-Q--Q--QQQQ-----<>--------S--S--------<>--Q--------------------QQ------------------------XXXXX----XX----XXXX---------------------------------S----------XX-----------XX------------<>-------SXS------E---E-----E-------XXXX--------XXXX-----------S?S--------XXX--X-------
-[]----------------<>--[][]----------<>-X------E-------XXXXX-------------------XX----------------------------o--------------------------------------------------------------------XXX--XX----------------------XXXX----E-------X------------XXXXX---------XX-------------[]----<>----------------------E-----[]--E------------------------------------------------------[]-----------------------------X-----------------X--XXX-[]------------X---X----E--X--XXX---------XXXX-XXX-----------S------------------------<>-------------------[]--<>--------------<>-----------E---------------[]--------<>------------------------------X-----------------------------------------------------------------------------[]--[]--SSSSSSSSSSSSSSSS--SS----------------------E-----------------------------XX-----E-------------------------------------------------XXX--------------------XXX--XX-------------[]----<>[]------[]----<>------------------------------------------E<>--[]----<>--------------------------------------------------------------------------------------S-------------------------------E----<>-------------XXXXX----------------------XX-----------------------[]----------------------------X------------------<>----<>[]--------------------------EEXX-XXSSSSSS--SSSSSS----------------[]-----E-----------X--[]------------------------------------------------XXXXXX------XXXXX-------------------------------------------E--XXX-----------------E-------[]---------------<>--<>----<>-----------------XXXXXX-SSSSS---------------XXXX--XX------
-[]----------------[]--[][]----------[]------------E---XXXXX-------------------XX---------------------------XXXX-----------------------------------------------XXX---------------XXXX--XXXX-------------------XXXXX-----------XX----------X-XXXXX--------XXX-------------[]----[]---------------------<>-----[]-<>---------------------XXX------------------------------[]-----------------------------X-----------------X--XXX-[]-----------XX---------X-XX--XX--------XXXXX--XXX---------XS------------------------[]-------------------[]--[]--------------[]---X-----------------------[]--------[]------------------------------X-X---------------X-----------------------------------------------------------[]--[]--[SSSSSSSSSSSSSSS--SS------------------------------------------------X---XXX-------------------------------------X------------E---XXX--------X----------XXXX--XXX---------X--[]----[][]------[]----[]-----------------------------------------<>[]--[]----[]----------------------------------------<>---------------------------------------------------------------------------<>----[]------------XXXXXX----------------------XXXX---------------------[]----------------------------X------------------[]----[][]-------------------------XXXXX-XXSSSSSS---S-SSS----------------[]----<>--------------[]------------------------------------------------XXXXXX---------------------------------------------X-------<>-XXXXXXXX------------<>-------[]---------------[]--[]----[]-------------XXXXXXXXXX-----------------<>-XXXXX--XXX-----
-[]----------------[]--[][]-E-EE---XX[]-E--------------XXXXX------E--------EE--XXXX------oo---------------------E------------E---------EE-E------------------------------E------XXXXXE-XXXX--EE--------------XXXXXX--SS------XXX-----------XXXXXX-------XXXX---EE--------[]----[]-E---E-------E-EE----[]-E---[]-[]--------------------------------------EE-E-EE---E-X-X-[]-S----------------------E----X-----------------XE-XXXX[]----E-E---XXXE-------X--X---XXE------XXXXXX-XXXX--------XXS-------E---E------------[]--E----------E-----[]--[]-------EE-----[]-E-X-----------------E-EE--[]-E-E----[]------------------E-E---------XXX-----------E-E-X---E-EE----------------E-E-----------------------EE-E------[]--[]--[SSSSSSSSSSSSSSSSSSS---E-----------------------------------EEE------XXE-XXXX------------------------------EE---XX--------------E-XXX-----E--X---------XXXXX--XXX---EE-E--X--[]----[][]------[]----[]------------------------------E----------[][]--[]----[]-----------E-E-E-----E-EE----X-E-E------[]---------EE-E-E------------E-----------------------------E--------------E--[]----[]-----------XXXXXXX------EE-E-----E--E---XXXX-ooo-----------------[]----EE---E--E-EE-E-EEE------X---------EE-------[]----[][]-----E------------------XXXXXX-XXSSSSSS-oSSSS--------------EE--[]----[]-E-----EE-----[]---E-EE--------------E-EE---X--------------E---XXXXXXX-----------------------------------E----EE-E-X-------[]XXXXX----------------[]---E-E-[]---------------[]--[]----[]-E--ooo----XXXXXX--XXXX---ESS-----------[]-XXXXX--XXXX----
-XXXXXXXXXXXXXXXXXXXXXXXXXXXXXXXXXXXXXXXXXXXXXXXXXXXXXXXXXX---XX--XXXXXXXXXXXX-XXXXX--XXXXX---------------------XXXXXXXXXXXXXXXXXXXXXXXXXXXX----------------------------XXXXXXXXXXXXX--XXXXXXXXXXXXXXXXXXXXXXXXXXX---SX--XXXXXXX-XXXXXXXXXXXXXXXX-----XXXXXXXXXXXXXXXXXXXXXXXXXXXXXXXXXXXXXXXXXXXXXXXXXXXXXXXXXXXXXXX--XXX------XXXXX-----------XXXXXXXXXXXXXXXXXXXXXXXXXXXXXXXXXXXXXXXXX----XXXXXXXXXXXXXXXXXXXXXXXXXXXXXXXXXXXXXXX-XXXXXXXXXXXXXXXXXXXXXXX-XXXXXXXXXXXXXXXXXXXXXXXXXXXXXXXX-XXXXXXXXXXXXXXXXXXXXXXXXXXXXXXXXXXXXXXXXXXXXXXX-XXXXXXXXXXXXXXXXXXXXXXXXXXXXXXXXXXXXXXXXXXXXXXXXXXXXXXXXXXXXXXXXXXXXXXXXXXXXXXXXXXXXXXXXXXX-XXXXXXXXXXXXXXXXXXXXXXXX-XXXXXXXXXXXXXXXXXXXXXXXXXXXXXXXXXXXXXXXXXXXXXXX-XX--XXX-XXXXXXXXXXXXXXXXXXXXXXXXXXXXXXXXXXXXXXXXXXXXX---XXXXXXXXXXXXXXXXXXXXXXXXXXXXXXXXXXXX-XXXXXXXXXXXXXX---XXXXXXXXXXXXX-XXXXXXXXXXXXXXXXXXXXXXXXXXXXXXXXXXXXXXXX-XXXXXXXXXXXXX--XXXXXXXXXXXXXXXXXXXXXXXXXXXXXXXXXXXXXXXXXXXXXXXXXXXXXXXXXXXXXXXXXXXXXXXXXXXXXXXXXX-XXXXXXXXXXXXXXXXXXXXXXXXXXXXXXXXXXXXXXXXXXXXXXXXXXXXXXXXXXXXXXXXXXXXXXXXXX-XXXX-XXX-XXXXXXXXXXXXXXXXXXXXXXXXXXXXXXXXXXXXXXXXXXXXXXXXXXXXXXX--XXXXXXXXXXXXXXXXXXXXXXXXXXXX-------X---XXXXXXXXXXXXXXXXXXXXXXXXXXXXXXXXXXXXXXXXXXXXXXXXXXXXXXXXXXXXXXXXXXXXXXXXXXXXXXXXXXXXXXXXXXXXXXXXXXXXXXXXXXXXXXXXXXXXXXXXXXXXXXXXXXXXXXXXXXXXXXXXXXXXXXXXXXXXXXXXXXXXXXXXXXXXXXXXXXXXXXXXXXXX---XX---XXXXXXXXXXXXXX----------------------------X-X-XXXXXXXXXXXXXXXXXXXXXXXX---------XXXX---XXXXXXXXXXXXXXXXXXXXXXXXXXXXXXXXXXXXXXXX--XXX---------?--XXXXXX---XXXXXXXXXXXXXXXXXXXXXXXXXXXXXX