-----------------------------------------------------------------------------------------------------------------------------------------------------------------------------------------------------------------------------------------------------------------------------------------------S--o--X------------------------------------------------------------------------------------------------------------------------------------------------------------------------------------------------------------------------------------------------------------------------------------------------------------------------------------------------------------------------------------------------------------------------------------------------------------------------------------------------------------------------------------------------------------------------------------------------------------------------------------------------------------------------------------------------------------------------------------------------------------------------------------------------------------------------------------------------------------------------------------------------------------------------------------------------------------------------------------------------------------------------------------------------------------------------------------------------------------------------------------------------------------------------------------------------------------------------------------------------------------------
---------------------------------------------------------------------------------------------------------------------------------------------------------------------------------------------------------------------------------------------------------------------------------------------XXQ-XXX-X------------------------------------------------------------------------------------------------------------------------------------------------------------------------------------------------------------------------------------------------------------------------------------------------------------------------------------------------------------------------------------------------------------------------------------------------------------------------------------------------------------------------------------------------------------------------------------------------------------------------------------------------------------------------------------------------------------------------------------------------------------------------------------------------------------------------------------------------------------------------------------------------------------------------------------------------------------------------------------------------------------------------------------------------------------------------------------------------------------------------------------------------------------------------------------------------------------------------------------------------------------------
------------------------------------------------------------------------------------------------------------------------------------------------------------------------------------------------------------------------------------------------------------------------------------------oo----S-X-------------------------------------------------------------------------------------------------------------------------------------------------------------------------------------------------------------------------------------------------SSSSSSSSSSSSSSSSSSSSSSSSSSSS----------------------------------------------------------------------------------------------------------------SSSSSSSSSSSSSSSSSSSSSSSSSS-S-------------------------------------------------------------------------------------------------------------------------XX-----XS--------------------------------------------------------------------------------------------------------------------------------------------------------------------------------------------------------------------------------------------------------------------------------------------------------------------------------------------------------------------------------------------------------------------------------------------------------------------------------oo------------------------------------------------------------------------------------------------------------------------------------------------------------------------------------------------------------------------
-----------------------------------------------------------------------------------------------------------------------------------------------------------------------------------ooX-----------------------------------------------------------------------------------------------------XX-----X---XX------------------------------------------------------------------------------------------------------------------------------------------------------------------------------------------------------------------------------------------------------------SSSSS--SSoSS------------------------------------------------------------------------------------------------------------------SSSS---Q-?oS--SS--SS---ooS-----------------------------------------------------------------------------------------------------------------------o--oo-X-XX---------------------------------------------------------------------------------------------------------------------------------------------------------------------------------------------------------------------------------------------------------------------------------------------------------------------------------------------------------------------------------------------------------?-----------------------------------------------------------------------XXX-----------------------------------------------------------------------------------------------------------------------------------------------------------------------------------------------------------------------
--------------------------------------------------------------------------------------------------------------------------------------------o-----------oo-------oo-----oo----------?---------------------------------------------------oo--oo-------------------------------------------------------XSX------------------------------------------------------------------------------------------------------------------------------------------------------------------------------------------------------------------------------------------------------------SSSSS--SSSSS---------------------------------------E--------------------------------------------------------------------------SSSS--E--?SS--SS--SS----SS-----------------------------------------------------ooo--------oo--oo------------------------------------------o-----------?---?---XXX------------------------------------------------------------------------------------------------------------------------------------------------------------------------------------------------------------------------------------------------------------------------------------------------------------------------------E--------------------------------------------------------------------------------------------------------------------------------------------------------------------------------------------------------------------------------------------------------------------------------------------------------------------------------------------------oo------------------
-------------------------X------------------------------------------------------SQQQ------------------SSSSS---------------------------------XX------------------XXX-----XXX----E-----XXSoo-----------------Q-Q-Q-----------E-------?------------------------SSS-----?SSS-----E--?----------XXX------------------ooo-Q----------SS---SSSSS---------------------------------------------------------------SS-?-----------------SS-----------------------------------E--E---------------X-----------------SSS------------------------------SSQSSSS------------------------SS---------------------------------------------SQ-----SSSSS----------SSS------------SS---SSS-------S----------------------------SS-----------SS--------------------SSSSSSS?SSSSSS---------------------------Xoo---------------------SSS----------------SSSS--------SSXX-----E-----XXSoo--------------------------SSS--SSS---S-------------------------------------------------------------------------SSSSS----SQ---S--------------------------------------------------Q----S-Q-----------------------------------------------------------------------------------------------------------S---SS--------------SSS--------SQ--?SSS------E---------Q?SSS---?-----------?-------?S?-------------SS---S-----S-----------------S----SSSSSSSSSSS---?------------?---------------------------------S----------------------------?SSS----S-----------------------------------------------------S--------------------------------------SSSSS---SSS----------------SSS----------------XXXX-------XXX-------
-----------------------------------------ooo----------------------------------------ooo--------------------------------------------------------------------------------------XXXXXX--------E------------------------------<>--------------------XSSSS-----------------------<>-----XXX---------o--------XXXXX-------------------------------------------------------------------------------------------------------------------------------------------------------XXXXXX-----------XX--------------------------------------------------------------------------------------------------------------------------------------------------------------------SS------------------------o-----------------SS-----------SSS--------------------------------------------------------------------------------------------------------------------------XXXXXXX--------------o----------------------------------------------------------------ooooo-------------------------------------------------------------------------------------------------------------------------------------------------------------------ooo----------------------------------------------E----------------oo--------------------------<>-------------------------------XXX---ES-------------------S---------------------------------------------------------------------------------------------------------------------------------------------------------oooo------------------------------------------------------------------------------------------------------------------o---XXXX-------
-----------------------------------------------------------------------------------------------------------------------------------------------------------------------------XXX-XXX--------------------------------------[]-------------------XXX--------------------------[]-----------------XX--XX-----------------------------------------------------------------------------------------------------------------------------------------------------------XXX-oo------------XXXXX---------------------------------------------------E-----------------------------S----------------------------------------------------------------------------------SS-----------------------------------------SSS-----------SS-----S---------------------------------------------------------------------------------------------------------------------------------------------------------------E---------------------------------------------------------------------------------------------------------------------------------------------------------------------------------------------------------------------------------------------------------------X-----------------------E-------------------------[]--------------------------------------S-------------------S---------------------------------------------------------------------------------------------------------------------------------------------------------------------------------------------------------------------------------E------------------------------------------------EXXXX-------
--E---------------ES----XX---------o------------------------E---------E-----------------------------------------------S------------------oo-------XXXX---------------------------------XXXX-------------------------------XX----X---oo--------XXXXS-SQ----------------------[]-----------------------------------XXX---------------------------------------------------E-----------------------------------------------------------------------------------E--o-S---------------S---X-X------------------------------------------E-------------------------------------SS---E-?-----------------------------S--E-------------------------------------------SS----------------------E------------X-oooooSS-------oo?oSS---EEX----------E------------------------------------------E--XXX---------------SSSSSSSSSS-------------------------------------------XXXX------------------E--S-----<>----------o--------------------------------------------------------E------------------------SSSSSSS-----------------------------------------------------o--------ooo--------------------------E----------------------------------------------------------------X-------------------E--S--SS----------------------]------S-----S----------------------S---S-------------------S---------------E---------------------------------------------S------------------------------------------E----------------------------------------------E-------------------------------------E---------E----------------------------------------------------------oo--oo----------XXXXX-------
-<>--------------<>-----XX--------------------------------E<>--------<>-----E-----------------------------------------------S---------------XX----------------XXXXXX----XXXXX------------------XXXX--QQQQ--S?S-Q-QQ------XXX---E-o-o--o------XXXXX---------X--<>------XXXX--[]----------XX-----XXX------------------QQ-------Q--Q--QQ------------QQQ-------------E----<>------------------E-----E-------oS------------------------XX-------o--------------<>---S------------------X-------------QQQ-----------------------------<>------SSS---X----X-----------XX--X---S----SSS----------------E--S-----------<>------QQQ--QSQS--QQS--------S?S-----X--S---------SS-Q-Q-----------<>--------------SSSSSSS-S--S---S--SS--SSSS---------<>------SSSSSSSSS-------XXXX---------------<>-----------------------------------------E--S--------SSSS-XXX----------------------XX---------<>-----E--[]-----------------------------------------------------SS-----XX----<>------Q-Q---SQS--S?S--------------------------------------------X---------SSSS-------S-----E--------------S--------------<>----------------------------------<>--------------------------X-X--------SSS-------<>----------------S?S-------------------------So-oo------XXX--------------------E---------------XX---E----<>------QQQ------XX--------------E--XXXX-----------------X-------SS-------SS-------------<>--------------------------S------------------<>---------------<>--S--------SQS-----<>---E----<>--------------XX--X----SSS------------------<>----------X----------------XXXXXX-------
-[]--------------[]-----XX----X---------------X----------<>[]---E----[]----<>--------------------------------------------------E-----X----------------------------------------------------------------------------------XXXX--XX------------XXXXXX-------EXX--[]------------[]-------------XXXX-----------------------------------------------------------------<>----[]-----------------<>----<>-----------E----------X---------XXX-------------E--------[]----------------------X-X-------------------------------------------[]------E-----E-E--X---------XXXX--XX-----E--------------------E----XX--------[]-----------------------------------EX--XX-----E-------------------[]---------E----------------------------------XXXX-[]--------------------------------E--------[]---------E------------------------------<>----------E-----------------------------------------[]----<>--[]------------------------------------------------------------X-----[]--------------------------------------------------XXE----------XX--------E----------------<>-----------------------------[]------------------E---------------[]--------E-----------------X-X------------------[]-------------------------------------------------------E---------------------<>--------------XXX--<>----[]--------------XXX--------E----<>------------------XX<>-XX---XX----------SS-------------[]----------------XX----------E----------------[]------------E--[]-------------------[]--<>----[]-------------XXX----------------------------[]--E------XX---------------XXXXXXX-------
-[]--------------[]-----XX----X---------------X----------[][]--<>----------[]------X------------------------------------------<>-----X----------XXXX-------------------------------------------------------------------XXXXX--XX-----------XXXXXXX-------XXX--[]------------[]---------------------XXXX---------------------------------------------------------[]----[]-----------------[]----[]------X---<>----------X--------XXXX------------<>--------[]----X-----------------X-X-------------------------X-----------------[]------------XX---X--------XXXXX--XXX------------------------<>----X---------[]----------------------------------<>X--XXX------------------------[]--------<>---------------------------------XXXXX-[]-------------------------------<>--------[]--------<>------------------------------[]----------------------------------------------------[]----[]--[]------------------------------------------------------------XX----[]-------------------------------------------------XXX----------XXX-------------------------[]-----------------------------[]-----------------<>---------------[]-------<>-----------------X-X------------------[]-----------------------------------------------------------------------------[]-------------XXXX--[]----[]-------------XXXX-------<>----[]-----------------XXX[]-XXX--X-----------SS-------------[]-----------X----XX---------------------------[]-----------<>--[]-------------------[]--[]----[]------------XXXX-------------X-----------------<>-----XXX-----------<>-XXXXXXXX-------
-[]-----------E--[]-----XXE---X---------E-EE--X----------[][]--[]---E-E----[]-----XX------------------------------------------[]-----X---------XXX----------------------------------------------------------E------EE-XXXXXX--XX-----------XXXXXXX--S-SSXXXX--[]------------[]----------------------------------------------EE-----------------------E-EE-------[]----[]--------E--------[]----[]------X---[]------E---X-------XXXXX------------[]----E---[]-------------E--EE-E--X-X-------------------E-E---X-------------E---[]-E----------X---XX----E--XXXXXX--XXXX------------E----------[]-E--X-XX------[]----------------------------E-----[]X--XXX--------------E-EE---E--[]--------[]----E----------E-----E--E-----E-XXXXXX-[]-------------E---------------E-[]-----E--[]--------[]------------S-----------------[]---------------------------------------------E-EE---[]-E--[]--[]------------------E-------------------------E--------E-E----XX---E[]-----E-------------------------------------------------------XXXX---XS-------------EE-E---[]-------E-EE--------EE-E------[]------EE-E--X----[]--E-----EE-----[]-------[]-----------------X-X-----EE--------E--[]--------------------------------------------------------------------E----E---[]-E----------XXXXX--[]----[]------------XXXXX-------[]----[]----------------XXXX[]-XXXE-X--E-------E--------E-EE---[]-------E---X--X-XX-------------------E--E----[]--E-----EE-[]--[]------E------------[]--[]----[]-E---E-----XXXXX------------XX---EE-E--E-------[]----XXXX-----------[]XXXXXXXXX-------
-XXXXXXXXXXXXXXXXXXXXXXXXXXXXXXXXXXX-XXXXXXXXXX-XXXXXXXXXXXXXX-XXXXXXXXXXXXXXXXXXXXXXXXXXXXXXXXXXXXXXXXXXXXXXXXXXXX-------XXXXXXXXXXXXXXXXXX--------------------------------------------------------XXXXXXXXXX-XXXXXXXXXX-XX--XXXXXXXXXXXXXXXXXXX------XXXXX--XXXXXXXX------XXXX--XXXXXX----------------------------XXXXXXXXXXXXXXXXXXXXXXXXXXX--XXXXXXXXXXXXXXXXXXXXXXXXXXXXXXXXXXXXXXXXXXXXXXXXXXXXXXXXXXXXXXXXXXXXXXXXXXXXXXXXXXXXXXXXXXXXXXXXXXXXXXXXXXXXXXXX---XXXXXXXXXXXXXXXXXXXXXXXXXX-XXXXXXXXXXXXXXXXXXXXXXXXX-XXXXXXXXXXXXXXXXXXXXXXXXXXXXXXXXXXXXXXXo--XXXXXXXXXXXX-XXXXXXXXXXXXXXXXXXXXXXXXXXXXXXXXXXXXXXXXXXXXXXXXXXXXX-X-XXXXXXXXXXXXX-XXXXXXXXXXXXX-XXXXXXXXXXXXXXXXXXXXXXXXXXXXXXXXXXXXXXXXXXXXXXXXXXXXXXXXXXXXXXX--XX--XXXXXXXXXXXXXXXXXXXXXXXXXXXXXXXXXXXXXXXXXX-XXXXXXXXXXXXXXXXX----XX-XXXXXXXXXXXXXXXXXXXXXXXXXXXXXXXX----------------------------XXXXXXXXXXXXXXXXX-XXXXXXXXXXXXXXXXXXXXXXXXXXXXXXXXXXXX--X---XXXXXXXXXXXXXXXXXXXXXXXXXXXXXXXXXXXXXXXXXXXXXXXXXXXXXXXXXXXXXXXXXXXXX---XXXXX---XXXXXXXXXXXXX---XXXXXXXXXX--XXXXXXXXXXXXXXXXXXXXXXXXXXXXXXXXXXXXXXXXXXXXXXXXXXXXXXXXXXXXXXXXXXXXXXXXXXXXXXXXXXXXXXXXXX-X---XXXX-XXXXXX-X---XXXXXXXXXXXXXXXXXXXXXXXXXXXXXXXXXXXXXXXXXXXXXXXXXXXXXXXXXXXXXXXXXXXXXXX-----XXXXXXXXXXXXXXXXXXXXXXXXXXXXXXXXXXXXXXXXXXXXXXXXXXXXXXXXXXXXXXXX-XXXXXXXXXXXXXXXX------XXXXXXXXXXXXXX-XXXXXXXXXXXXXXXXXXXX-X-XXXXXXXXXXXXXXXXXXXXXXXXXXXX---XXXXXXXXXXXXXXXXXXXXXXXXXXXXXXXXXXXXXXXXXXXXXXXXXXXXXXXXXXXXXXXXXXXXXXXXXXXXXXXXXXXXXXXXXXX--XXXXXXXXXXXXXXXXXXXXXXXXXXXXXXXXXXXXXX----------XXXXXXXXXXXXXXXXXXXX