------------------------------------------------------------------------------------------------------------------------------------------------------------------------------------------------------------------------------------------------------------------------------------------------------------------------------------------------------------------------------------------------------------------------------------------------------------------------------------------------------------------------------------------------------------------------------------------------------------------------------------------------------------------------------------------------------------------------------------------------------------------------------------------------------------------------------------------------------------------------------------------------------------------------------------------------------------------------------------------------------------------------------------------------------------------------------------------------------------------------------------------------------------------------------------------------------------------------------------------------------------------------------------------------------------------------------------------------------------------------------------------------------------------------------------------------------------------------------------------------------------------------------------------------------------------------
------------------------------------------------------------------------------------------------------------------------------------------------------------------------------------------------------------------------------------------------------------------------------------------------------------------------------------------------------------------------------------------------------------------------------------------------------------------------------------------------------------------------------------------------------------------------------------------------------------------------------------------------------------------------------------------------------------------------------------------------------------------------------------------------------------------------------------------------------------------------------------------------------------------------------------------------------------------------------------------------------------------------------------------------------------------------------------------------------------------------------------------------------------------------------------------------------------------------------------------------------------------------------------------------------------------------------------------------------------------------------------------------------------------------------------------------------------------------------------------------------------------------------------------------------------------------
----------------------------------------------------------------------------------------------------------------------------------------------------------------------------------------------------------------------------------------------------------------------------------------SSSSSSSSSS--------------SSSS----------------------------------------------------------------------------------------------------------------------------------------------------------------------------------------------------SSSSSSSSSSSSSSSSSSSSSSSSSSSS-------------------------------------------------------------oo-------------------------------------------------------------------------------------------------------------------------------------SSSSSSSSSS------------------------------------------------------------------------------------------------------------------------------------------------------------------------------------------------------------------------------------------------------------------------------------------------------------------------------------------------------------------------------------------------------------------------------------------------------------------------------------------------------------------------------------------------------------------------------------------------------------------------------------------------------------------------------------------------------------------------------------------------------------------------------------------------------
-----------------------------------------------------------------------------------------------------------------------------------------------------------------------------------------------?---o------------------------------------------------------------------------------------------------------------------------------------------------------------------------------------------------------------------------------------------------------------------------------------------------o------------------------------------------------------------------------------------------------------------XX-------------------o---------------------------------------------------------------------------------------------------------------------------------------------------------------------------------------------------------------------------------------------------------------------------------------------------------------------------------------------------------------------------------------------------------------------------------------------------------------------------------------------------------------------------------------------------------------------------------------------------------------------------------------------------------------------------------------------------------------------------------------------------------------------------------------------------------------------------------------------------------------------------------------------------------------------------------
--oo--oo-------------------------------------------------------------------------------------------------------------------------------------------------------------------------------oooooooo---------------------------------------------------------------------------------------------------------------------------------------------------------------------------------------------------------------------------------------------------------------------------------------------------------------------------------------------------------------------------------------------------------------------------------------ES-------------------------------------------------------------------X-----------------------------------------------------------------------S--------------------------------------------E-------------------------------------------------------------------------------------------------------------------------------------------------------E-----------------------------------------------------------------------------------------------------------------------------------------------------------------------------------------------------------------------------------------------------------------------------------------------------------------------------------E----------E--------------E------------------------------------------------------E--------------oooo-----------------oo-----------------------------------------------------------------------------------------oo--------------------------
----------------------------------------------------------------------------------XX--------E-------------------S------------------------------------------------XX----------------XXXX----XXX---------?--------------------------SSSS----------------------------------------------------SSQ----------------SSSS---------SS-------------------SSSSS-----------SSSSSSSSS----------SS-?-------S---SSS---S-----------SS---SSSS-----SSS----------------------------------------------------Q-----------E------------------?-----------ooo--------------------------------SSSS-E----E-S--------XX-----oo?--------S----SS----------------SS-SSSSSS------------------S----SSSSS-------XXoo----oo-----------------------------------------SSQS------oo----oXX------------------SS---S-----S----------SQS----------------SSSSS--------SSSSSSSSSS-------------------------------S-SSS--------------------SSS-----------------SSS-----------------------------XX----------------------XX----------SS--SQS----------------SSSSS----------QQ----------------SS--SQS--------------SSSSS-----SSS---------------------------S-----SSSSSSS---------S---------------------?------SSSS---SSS---SSQ-----------------------SSS----------------SSS--------------?SSS--SS-------------------E--------------------------------------?SSS---------SSQSSS-----SSSSSQS--------SSSSSSSSSSSS----QSSSS-----?SSS---SSSSSS----------------SSSSSSSSS?S------XXXX-------------------X-----------------S---X-------------------------------------o------------------------SSSSXXX---?----XXX----oo--------
-------------------------------------------o-----------------------------------------------<>---------------------------------------------------------------------------XXX------------------------E-----------------------------------------------------------------------------------------------------------------------S------------------------------------------------------SS-------------------------------------------------------o-------------------------------------------------------<>---E--------------QS----E--------------------------------------------<>------XXXXX---------------XXXXXXE-----SS----------------SS------------------------------X-X---------------------XXXX------------------ooo-------------------XXX----------------------------------------------------------------------------------------------------------------------------XES----------------------SS----------------------------------------------------------------oooo------XX-S----------------------------------------------------------------------------------------------------------------------------------------------------------------------------------------------------------------------------------------------------------------------------------o--<>-------------------------------------------------------------------------------------------------------------------------------------------------------------------------------------------------XXSS----------------------------------XX----------------------------XXX---------------------XXXX
-------------------------------------------------------------------------------------------[]---E----------------------------------------------------------------------------------------------XXXXX-------------------------------S--------------------------------------------------------------------------S-----------S-------------------------------------------------------SS--------------------------------------------------------------------------E------------------------------------[]--<>---------------S----------S--------------------------------------[]----------------------------------------------------S---SS------E-----------------------------------------------------oo-------------------------------------------------------------------------S---------------------------------------------------------------------------------------XXX-S----------------------SS-------------------------------------------------------------------------XXX------------------------E------------------------------------------------------------------------S-----------------------------------------------------------E-------------------------------------------------------------------------------------------------------------------------[]---------------------------------------------------------------------------------------------------------------------------------------------------------------XX-------------------------------XXX-----------------------------------XXX--------------------------------------------------------
--------------------------------E------------------oo-----------------------------------E--[]--<>-------------E----------------------------------------------------------------------------------------------------E---------------------------------------------------------E---E----------------------------------------S---------------------------------------------------ooo-SS-------------------------------E-----------oo-------E-------E---------E--<>X-----------------------------------[]--[]-----------E--------------SS-------------------------------------[]-----------------------XXX------------S-------------S---SS------------------------------------------------------------------------------------------------------------------------------------?--S---------E--------------------E--o-----------------------------------------------------XXX-S----------------SS----SS--------------------------------------------------------------E---------XXXX----------E------------<>-------E--?SS------------------------E--oE----------------------oo-------o-----------------------S---------------------E--------E--<>-------------------------------------------------SSSSSSSS-------XSS-SQ--------SSSSSS-------------------------------------[]------------o---------------------------------------------------------------------------E---------------------------------oo-----------------------E------------------------------S-SSS--------XXXXS---------------------------------XXXX--------------E-----------------------------------------
-------------------------------<>-----E---------------------------o-----------------S--<>--XXX-[]-------E----<>--------o-----QQQQ------E-----------------------------XX---------------XXXXX-XXX------QQQ----------<>------------S---SS--------------------------------------<>--<>--------SSSS------E--------SSSS---------SS--S----E---E-----E-------------X-------SSSS----X---SSSSS--S-----S--------ESS----------<>---S----------S----<>------<>-------E<>--[]X-----------------------QQQQ?S-E---SXXX-XXX---------<>---SSS-----X-----------------E-----------------------[]---E----------XXXXXX-----S-----------SSS--E----S--------SSSS--S?S-----------Q----Q-Q--------------XXX---XXXX--SS--------------------S---------------XXXXX-----------XXX-S-----------------E-SSS--------S--<>------SS-----------<>-----SSS--------------SSSSS-------------<>-----S-------XXXXSS-S--------------SS----SS------------------------------------------------------X---o--<>--------XXXXX---------XXS--S?S------[]------<>---Q-----------S-----E------<>---XS--S?S----XX--X-----------------S----<>----------------S--------Q--Q--Q-----<>---S---<>--[]---------QQ--S------------oQoQ--QQ-Q--Q------------------------XXX---------X----------------------------------------------X--------------------------------------------------SSSS--------SSSSSSS--------E-------SSSSSS--Q---S?S------------------------------------XXX-------<>-XXX----------------XXXXXX----------------XXXXX---------X-----------------------XXXXX-------------<>-----------XXXXX----------XXXXXX---------
-------------------------------[]----<>----------------------------------XXXXX---------[]------[]------<>----[]--------------E--------<>--------------------------------------------------------------------------[]----------------------------------------------E---------[]--[]--X-X---E------XXXX-----------------------------<>--<>----<>------------XX--XX---E-------X------------------------<>------------[]------E---E--------[]------[]------<>[]--[]X----------XXS-?------E-------<>--------------------[]-----------X--------------XXXXX--------------------X-[]-------------------------------X---------<>---------------SS--------------------------------------------------------------------------------------------------------------------------------E-------------[]-------------------[]-------------------X--------------------[]-----------EXXXXX-----------XXX-?-------------------------------------------E-------------------XXX-----[]-------XXXXXX-------EXX-------------[]------[]-------E-----------------E--[]-------------XXX--XX---------------------[]-------------------------------------[]-------[]--[]-----------------------------------E--------------------------XXXX--------XX----------------------------------------------X---------------------------------E----------------------------------------XXX-----E-EE------------------------------------------------------------[]-----------------------------------------XXXXXX--------XX------X--?------------XXXXXX-------------[]----------XXX----------------------------
------------XXX---XXXX---------[]----[]-----------------------XX--------------------X--[]------[]------[]----[]-------------<>--------[]--------------------------------------------------XXXXX---XX--------------[]-----------E---------------------------------<>---------[]--[]--X-X---------XXXXX-----------------------------[]--[]----[]-----------XXX--XXX------E---X------------------------[]------------[]-----<>------------[]------[]------[][]--[]X--------------------<>-------[]--------------------[]---------XXX--------------------------------------XX-[]---Q-----------------o--------XX---------[]---------------SS---------------------------------------------------------------------------------X------------------------------------------------------------[]-------------------[]--------------X----X--------------------[]-----------XXXXXX----------------------------------------------------------<>------------------XXXXXX---[]------EXXXXXX-------XXX-------------[]------[]------<>--------------------[]------------XXXX--XXX--------------------[]-------------------------------------[]-------[]--[]-------------------X-----------------------------------------XXXXX-------XXX----------------------------------------------X--------------------------------<>--X------------------------------------XXXXX------------------------------X-------------------------------------[]------XXX-------------------------------XXXXXXX-------XXX---------------------XXXXXXX----<>-------[]---------XXXX----------------------------
-------XXXXX-------------------[]----[]---------------------------------------------X--[]------[]------[]----[]-------------[]--E-E---[]---------------------------------------XXXXXXX----------------------------[]-E---------S-----------------------EE-E------[]---EE----[]--[]--X-X--------XXXXXE----------------E--E---------[]--[]----[]----------XXXX--XXX----------X-E-E----------E---------[]-----EE-E-E-[]-----[]---------E--[]-E-E--[]------[][]--[]X--------------------[]-------[]--------------E-E---[]--------XXXX--------------------------EE------EE-XXX-[]--E---------oo------XX-------XXX---E-----[]------E-------E---E---------------------------------ooo---ooo------------------E-E------EE-----------------------------------------E---E--X--------------------[]----E-------EE-E---[]-E------------X----X----EE---XX-----E-E-[]-------E--XXXXXXXE-E----------------------E--------------------------------[]------------------XXX------[]------XXXXXXX------XXXX-E-EE--------[]------[]------[]--------------E-E---[]---E--E----XXXXX--XXXX-------XX---E------[]----------E-E-E----E-----------------[]-------[]--[]-------------------X----------------------------------------XXXXXX------XXXX----------------------E-E-E---------EE----E---X-----E-E----------------------E-[]--X-----------------------------------XXXXX----------------E------------E-X------E-E------X-----------------E-E-[]----------------------------------------XXXXXXX------XXXX---------------------XXXXXXX----[]-------[]--------XXXXX----------------------------
XXXX------------------------XXXXXXXXXXXXXXXXXXXXXXXXXXXXXXXXXXXX----XXXX------XXXXXXX--XXXXXXXXXXXXXXXXXXXXXXXXXXXXXXXXXXXXXXXXXXXXXXXXXXXXXXXXXXXXXXX--XXXXXXX-------------------------------------XXXX----XXXXXXXXXXXXXXXXX--XXXXXXXXXXXXXXXXXXXXXXXXXXXXXXXXXXXXXXXXXXXX-XX--XX--XXX-XXXXXXXXXXXXXXXXXXXXXXXXXXXXXXXXXXXXXXXXXXXXX-XXXXXXXXXX--XXXXXXXXXXXXXXXXXXXXXXXX-XXXXXXXXXXXXXXXXXXXXXXXXXXXXXXXXXXXXXXXXXXXXXXXXXXXXXXXX-XXXXXXXXXXXXXXXXXXXXXXXX-XXXXXX-XXXXX-----XXXXXXXXXXXXXXXXXXXXXXXXXXXXXXXXXXXXXXXXXXXXXXXXXXXXXXXXXXX--XXX-----XX--XXXXXXXXXXXXXXXXXX-XXX-XXX-----XXXX-----------XXXXXXXXXXXXXXXXXXXXXXXXXXXXXXXXXXXXXXXXXXXXXXXXXXXXXXXXXXXXX-X-------XXX---XXX-------XXXXXXXXXXXXXXXXXXXXXXXXXXXXX----XXXXXX-----XXXXX---------XXXXXXXXXXXXXXXXXXXXXXXXXXXXXXXXXXXXXXXXXXXXXXXXXXXXXXXXXXXXXXXXXXXXXXXo-XXXXXXXXXXXXXXXXXXXXXXXXXXXXXXXXXXXXXXXXXXXXXXXXXXXXX----XXXXXXXXXXXXXXXXXXXXXXXXXXXXXXXXXXXXXXX--XXXXXXXX-XX-X-----XXXXXX----XXXXXXXXXXXXXXXXXX--QXXXXXXXXXXXXXXXXXXXXXXXXXXXXXXXXXXXXXXXXXXXXXXXXXXXXXXXXXXXX--XXXXXXXXXXXXXX--XXXXXXXXXXXXXXXXXXXXXXXXXXXXXXXXXXXXXXXXXXXXXXXXXXXXXXXXXXXXXXXXXXXXXXXXXXXXXXXXXXXX-XXXXXXXXXXXXXXXXXXXXXXXXXXXXXXXXXXXXXXXXX-XXXXXXXXXXXXXXX----XXXXXXXXXXXXXXXXXXXXXX--XXXXXXXXXXXX---XXXXXXXXXXXXXXXXXXXXXXXXXX---XXXXXXXXXXXXXXXXXXXXXXXXXXXXXXXXXXXXXXXXXXXXXXXXXXXXXXXXXXXXXXXXXXXXXXXXXXXXX-XXXXXXXXXXXXXXXXXXXXXXXXXXX--X---XXXXXXXXXX----XXXXXXXXXX--------------------------XXXXXXXXXXXXXXXXXXXX---XXXXXXXXXXX-----XX-XX--XXXXXXXXXXX-XXXXXXXXXXXXXXXXXXXXXXXXXXXX-----------------------XXXXX