------------------------------------------------------------------------------------------------------------------------------------------------------------------------------------------------------------------------------------------------------------------------------------------------------------------------------------------------------------------------------------------------------------------------------------------------------------------------------------------------------------------------------------------------------------------------------------------------------------------------------------------------------------------------------------------------------------------------------------------------------------------------------------------------------------------------------------------------------------------------------------------------------------------------------------------------------------------------------------------------------------------------------------------------------------------------------------------------------------------------------------------------------------------------------------------------------------------------------------------------------------------------------------------------------------------------------------------------------------------------------------------------------------------------------------------------------------------------------------------------------------------------------------------------------------------------
------------------------------------------------------------------------------------------------------------------------------------------------------------------------------------------------------------------------------------------------------------------------------------------------------------------------------------------------------------------------------------------------------------------------------------------------------------------------------------------------------------------------------------------------------------------------------------------------------------------------------------------------------------------------------------------------------------------------------------------------------------------------------------------------------------------------------------------------------------------------------------------------------------------------------------------------------------------------------------------------------------------------------------------------------------------------------------------------------------------------------------------------------------------------------------------------------------------------------------------------------------------------------------------------------------------------------------------------------------------------------------------------------------------------------------------------------------------------------------------------------------------------------------------------------------------------
------------------------------------------------------------------------------------------------------------------------------------------------------------------------oo--------------------------------------------------------------------------------------------------------------------------------------------------------------------------------------------------------------------------------------------------------------------------------------------------------------------------------------------------------------------------SSSSSSSSSS-----SSSSSSSSSSSSS------------------ooo-------------------------------------------------------------------------------------------------------------------------------------------------------------------------------------------------------------------------------------------------------------------------------------------------------------------------------------------------------------------------------------------------------------------------------------------------------------------------------------------------------------------------------------------------------------------------------------------------------------------------------------------------------------------------------------------------------------------------------------------------------------------------------------------------------------------------------------------------------------------------------------------------------------------------------------------------------------------
----------------------------------------------------------------------------------------------------------------------------------------------------------------------------E--E--------------------------------------------------------------------------------------------------------------------------------------------------------------------------------------------------------------------------------------------------------------------------------------------------------------------------------------------ooo-------------------------------------SSSSSSSSSSSS------------------XXXX------------------------------------------------------------------------------------------------------------------------------------------------------------------------------------------------------------------------------------------------------------------------------------------------S--------------------------------------------------------------------------------------------------------------------------------------------------------XXXX---------------------------------------------------------------------------------------------------------------------------------------------------------------------------------------------------------------------------------------------------------------------------------------------------------------------------------------------------------------------------------------------E-------------------------------------------------------------------------------------------------------
---------------------------------------------------------------------------------------------------------------------------------------------------------------------------XXXX-oo---o-oooooooo----------------------------------------------------------Eoo------------------------------------------------------o-------------------------------------------------------------------------------------------------------------------------------------------------------------------------------------------------------------------------------------------------SSSSSSSSSSSS--------oo--oo------------------------------------------------------------------------------------------------------------------------------------------------------------------------------------------------------------------------------------------------------oo----------------------------------------------E---------------------------------------------------------------------------------------E-------------------------------------------------------------------------------ooo-------------------------------------------------------------------------------------------------------------------------------------------------------------------------E----------------------------------------------------------------------------------------------------------------------------------------------------E--------------oo-------------------------------------X----------------------------------------------------------------------------------------------------
---------------------------------SSSSS---Q-Q----------SS---------SSSS------------------------SSSS-------------------------------------------QQQ-----------SSSSSSSS------oo-----------XX----XXX--------S--QSS-?-------------S----S-----------------------XXXX---------------SQSSSSS------SSS------SSS---------oo------------------------------------?----------------SSSSS---------------------S---------------S---------------------------S----SSS-----------------------------SSQS-------------SSSSSSS-------------------SSS-----------XX------SSSS--oo--------SSSSSSSSSSSSSSSSoo-------------------------------------------------------------------------XX----------------Q---------------------------------------------------------------------------------------------XXXX---------------------SS---------------------------------------------XXXX-------XX-------------------------SSS------S-SS---SS---------------------Q?SSS---?---------SSS--?SSSS-----------SSS---------------SSSQS-------SSQSSS---------------------SS----------------------XXX-----------------XX----------------------------------------------------E---------XX--------------------------------------------ES-----------------------------------------------------------SSQ-SS----------------------------------------------------------------------SSSSS-------Q-Q-----------------------------------------SSSSS--S-SSS----SSS-SSSSSSSSS---SXX----?-----------------------------------------------------------------------------S--------SSSS-------------------------------------------
------------oooo--------------------------------------------------------------------------------------------------E--------------------------------------------------------------------------------XE-----------------------------------------------------------------------------------------------------------------------------------------------------------------------------oooo---------------------------------------------------------------------E----------------------------------------------------------------------------XX---------------------SS--------------------------------oo-----------------------------------------------------XSSXX---------------------------------------------------------------------oooo--------------------------oo-------------------------------------------------------------------------------------------<>[SSS--------------------------------------------------SS---------------------------------------------------------------------------------------------------------------------------------------------SSSS---------------o-------------o---------------------------<>-----------------------------------ooo----------------<>-------------------------------------------------------E--------SS-------------------------------o---o-----------------------------------------------------------------------------------------------------------------------------------------------------------------------------------------------------------------------------------------------------------------------
-----------------------------XX-----------------------------------------------------------------------------------------------------------------------------------------------------------------XXXX------------------------------------------------------------------------------------------------------------------------------------------------------------------------------------------------------------------------------------------------------XXX---------------------------------------------------------------------------XX-------------------------------------------------------------------------------------------------------------XXX-oX------------------------------------------------------------------------------------------------------------------------------------------------------------------------------------------------[]XX-------------------E-------------------------------X----------------------------------------------------------------------------------------------------------------------------------------------XX------------------------------------------------------------[]------------------------------------------------------[]-------------------------------------------------------E---------S-----------------------------XXXX-XXX--------------------------------------------------------------------------------------------o----------------------------------------------------------------------------E--------------------------ooo---------------------------------------------------------------
----------E------------------XX----------------------------------------------------------------------------------S------------------------------------------------------XXX----------------------------------------E--------------------------E-----------------------------------------------------------------------------------------------------oo--------------------------E---------o-----E----------------------E---------E------------------------------S------E--S--------------------------------------E---------SS---------X-XX-------------------------oooo---------XX--o-----------------------QSSSSSSS------------------------oo---------XXS--------------------------------XX-------------------E--------------------------------------------E--o---------------------------------------------XS------------E--------------------------------XXXX------------E------<>---------------E---------------XSS-SQ--------------------------------------------------------XS-----------------------------------------------E-----S-------------------------XX----------X-----------------o-------------------------------[]------------------------------------------------------XXXSSSSSS----------------------------------E---------E--<>----Sooo-S--------------------------------------------oo-------------oooo------------------------------------------------------E------------------------------------------------XXXX---------oo------------------------<>------------E-----------XXS-SQ-oo------E---------------------E------------------------------
------E--<>--SQS-------------XX---S----S?SQS----E-----------QQQ--SQQQ-----------E--------------S--------------------------------------------??S-----------SSSSS---------S---------------XX--------------SSSS------<>----------------------E--<>----------------------Q--Q--SS--S-S----E----------S?S------XXX--SX----o---------------------------o-o--o------------------------<>--------------<>-----E-Q------QQ-----<>--------<>--------Q-----S---------E--------E--<>-----E-E?SS--QQQ-------EQQQ--Q?S--------<>-------S----------XXX-XX----S----------XX-------SSSSSSSS---S-----------XXX-----------------------------------------------o--o-------XXXX----------------QQ?SSQQ--------XXX------------------<>-------------------------------------E--E--<>--------------------------E--------------------XXX-----------<>----E---------E----------------XXXXX-----------<>------[]-----------E-E-XS--SSS--------XXX---------X---S?S--------------SSSSSSSS----Q------QS----S--XXXX-E--S-SS?S------QQ-Q--Q--QQ-Q--Q--------------<>------------------------------XXXX-----------------------E-------XX------------E--?----------[]------------------<>------------------------S---------<>X-------------X-------------X-----------<>--------<>--[]-X--SSSSSS-------------E-----------XX---------------X--------------E-------------E?S---QQQ--QQQ------------------------------X<>------SSSS-------SSS----XX--X-----------X-----------------------------------------E-E--[]-----------<>----------XXX------------<>-Q--QQQQ------------<>------------------------Q-QQQQ
---<><>--[]------------------XX----------------<>------------------------------<>---------------------E-----------------------------------E--------------------------------E-E-E----------------------------------[]---------------------<>--[]---E----------------------------------<>-------------------------------------------X--------------------------------------------[]--------------[]----<>---------------[]--E-----[]---------------------XX<>-------<>--[]----<>----------------------------------[]----E------------XXXX-XX---------------XX--oo------------------------------------------------E----------------------XX-------------XXXXX-X----------------------------XXXX------------------[]--E---------------------E-----E-----<>--E--[]-------------------------<>----------E--------XXXX-----------[]--------E----<>---------------XXXXXX-----------[]------[]---------------------------XXXXXX-------EXX------------------------------------------------XXXX<>--S-----------------------------------------[]-----------------------------XXXXX----------------------<>------E-------------<>-------------[]------------------[]--XX------------------------------[]X-------------X---X--------XX-----------[]--------[]--[]----------------------<>----------------------------X--------E----<>-------------------------------------------------E------EX[]-----E-----------------XXX--XX---------XX----------------------------------------<><>--[]-----------[]---------XXXX-------E----[]--------------------[]------------------------------
---[][]--[]------------------XX----------------[]------X-----------------------[]--X-----------------<>--------------------------X----------------------------------------<><><>------------------oo--------------[]--<>-----------<>----[]--[]--<>----------------------------------[]----------------<>------------------------EXX-------------------------------------------[]--------------[]----[]---------------[]-<>-----[]--------------------XXX[]-------[]--[]----[]----------------------------------[]---<>-----------XXXXX-XXX--------X-----XX--XXX---------------------------------------------------------E---X-------XXX------------XXXXXX-----------------------------XXXXX------------------[]-<>--------------------------<>-----[]--E--[]-------------------------[]------------------XXXXX-----------[]-------<>----[]--------------XXXXXXX-----------[]------[]-----------XXX-------------XXXXXX-------XXX------------E---X------------------------------XXXXX[]--S-----------------------------------------[]---------------------------XXXXXXX----------------------[]-----<>-------------[]-------------[]-----------------X[]--XXX----------------------------X[]X-------------X---X-------XXX-----------[]--------[]--[]----------------------[]------------------------------------<>----[]------------------------------------------------<>--------[]----<>----------------XXXX--XXX-------XXX---XXXXX--------------------------------[][]--[]-----------[]--------XXXXXX-----------[]--------------------[]------------------------------
E--[][]--[]------------------XX---------E-EE---[]---E--X--------------EE-E-E-E-[]-EX-----------------[]------------E----EE-E-X---X-------X-X---------E------E-E-----------[][][]---XXXX--------------EE-----------[]--[]-----------[]----[]--[]--[]------------------E---------------[]----------------[]-----------E-------------X--X--------------------------------------E--[]----E---------[]-E--[]-----EE--------[]-[]--E--[]-------------------XXXX[]-------[]--[]-E--[]-------E--------------------------[]---[]----------XXXXXX-XXX--EE-E-XX-----X---XXX--------E--------------------------------------------E-------X------XXXX-----------XXXXXXX-SSSSSS---------------------XXXXX-------------------[]-[]---E-----E---E---EE-----E-[]-----[]-----[]---------------EE--------[]----------E-E----XXXXXX-----E--E--[]-------[]-E--[]---------------XXXXXX-----------[]------[]-----------XXX-E-----------XXXXXX-------XXX------------X-E-X-------------------EE-E------X-XXXX[]--S---------------------E--------E-------E--[]-----------X--------------XXXXXXXX-----------------E-E--[]-----[]-------------[]-------------[]----------------XX[]--XXX--------E------------------XX[]X-------------X---X------XXXX-----E--E--[]--------[]--[]------E---------------[]------------------------------------[]-E--[]-----------------------------------------EE-E---[]--------[]----[]--------E-E----XXXXX--XXXXE-E--XXXX----------------------------------------[][]--[]--------E--[]-------XXXXXXX-----------[]--------------------[]------------------------E-----
XXXXXXXXXXX--XXXXXXXXXXXXXXXXXX-XXXXXXXXXXXXXXXXXXXXXXXXXXXXXXXXXXXXXXXXXXXXXXXXXXXXXXXXXXXXXXXXXXXXXXXXXXXXXXXXXXXXXXXXXXXXXXXXXXXXXXXXXXXXXXXXXXXXXXXXXXXXXXXXXXXXXXXXXXXXXXXXXXXXXX--------E-----XXXXXXXXXXXXXXXXXXXXXXXXXXXXXXXXXXXXXXXXXXXXXXXXXXXXXXXXXXXXXXXXXXXXXXXXXXXXXXXXXXXX---XXXXXXXXX-XXXXXX----XXX--XXXXXXXXXXXXXXX---XXXXXXXXXXXXXXXXXXXXXXXXXX--------E---XXXXXXXXXXXXXXXXXXXXXXXXXXXXXXXXXXXXXXXXXXXXXXXXXXXXXXXXXXXXXXXXXXXXXXXXXXXX-XXXXXXXX-[]XXXXXXXXXXXXXXXXXXXX----XXXXXXXXXXXX-XXXXXXXXXXXXXXXXXXXXXXXXXXXXXo-XXXXXXXXXXXXXXXXXXXXXXXXXXXXXXXXXXXXXXXXXXXXXXX-S---XXXXX-----------XXX-XXXXXXXX-XX-----XXXXXXXXXXXX--XXXXXXXXXXX--SS---XXXXXXXXXXXXXXXXX---XXXXXXX---XXXXXXXXXXXXXXXXXXXXXXXXXXXX--XXXXXXXXXXXXXXXXXXXXXXXXXXXXXXXXXX-X-XXX---XXXXXXXXXXXXXXXXXXXXXXXXXXXXXXXXXXXXXXXX-XXXXXXXXXXXXXXXXXXXXXXXXXXXX----XXX-X-XXXXXXXXXXXXXXXXXXXXXXXXXXXXXXXXXXXXXXXXXXXXX-XXXXXXXXXXXXXXXXXS---XXXXXXXXXXXXXXXXXXXXXXXXXXXXXXXXXXXX-X-XXXXXXXXXXXXXXXXXXX-XXXXX-XXXXXXXXXXXXXXXXXXXXXXXXXXXXXXXXXXXXXXXXXXXXXXXXXXXXXXXXXXX---XXXXXXXXXXXXXXXXXXXX------X-X-XXXXXXXXXXXXXXXXX-XXXXXXXXXXXXXXXXXXXXXXXXXXXXXXXXXX----XXXXXXXXXXXXXXXXXXXXXXXXXXXXXXXXXXXXXXXXXXXXXXXXXXXXXXXXX--XX--XXXXXXXXXXXXXXXXXXXXXXXXXXXXXXXXXXXXXXXXXXXXXXXXXXXXXXXXXXXXXXXXXXX-XXXXX---XXXXX--XXXXXXXX---XXXXXXXXXXXXXXXXXXXXXXXXXXXXXXXXXXXXXXXXXXXXXXXX-XXXXXXXXXXXXXXXXXXXXXXXX-XXXXXXXXXXXXXXXXXXXXXXXX--XXXXXXXXXXXXX------------------X----XXXXX-XXXXXXXXXXXXXXXXXXXXXXXXXXXXXXXXX-XXXXXXXXXXX--XXXXXXXXXXXXXXXXXXXXXXXXXXXXXXXXXXXXXXXXXXXXXXXXXXXXXXXXXXXXXXXX