---------------------------------------------------------------------------------------------------------------------------------------------------------------------------------------------------------------------------------------------------------------------------------------------------------------------------------------------------------------------------------------------------------------------------------------------------------------------------------------------------------------------------------------------------------------------------------------------Q--------------------------------------------------------------------------------------------------------------------------------------------------------------------------------------------------------------------------------------------------------------------------------------------------------------------------------------------------------------------------------------------------------------------------------------------------------------------------------------------------------------------------------------------------------------------------------------------------------------------------------------------------------------------------------------------------------------------------------------------------------------------------------------------------------------------------------------------------------------------------------------------------------------------------------------------------------------------------
------------------------------------------------------------------------------------------------------------------------------------------------------------------------------------------------------------------------------------------------------------------------------------------------------------------------------------------------------------------------------------------------------------------------------------------------------------------------------------------------------------------------------------------------------------------------------------------------------------------------------------------------------------------------------------------------------------------------------------------------------------------------------------------------------------------------------------------------------------------------------------------------------------------------------------------------------------------------------------------------------------------------------------------------------------------------------------------------------------------------------------------------------------------------------------------------------------------------------------------------------------------------------------------------------------------------------------------------------------------------------------------------------------------------------------------------------------------------------------------------------------------------------------------------------------------------
SSSSSSSSSSSSSSSSSSSSSSSSSSSS--------------------------------------------------------SSSSSSSSSSSSSSSSSSSSSSSSSSSS-----------------------------------------------------------------------------------------------------------------------------------------------------------------------------------------------------------------------------------------------------------------------------------------------------------oo-------SSSSSSSSSSSSSSSSSSSSSSSSSSSS---------------------------------------------------------------------------------------------------------------------oo-------------------------------------------------------------------------------------------------------------------------------------------------------------------------------------------------------------------------------------------------------------------------------------------------------------------------------------------------------------------------------------------------------------------------------------------------------------------------------------------------------------------------------------------------------------------------------------------------------------------------------------------------------------------------------------------------------------------------------------------------SSSSSSSSSSSSSSSSSSSSSSSSSSSS--------------------------------------------------------------------------------------------------------------------oo------------------------------------------------------------------------------
S--SSSS------SSSS--------------------------------------------------------------------------------------------------------------------------------X-------------------------------------------------------------------------------------------------------------------------------------S----------------------------------------------------------------------------------------------------------------------------------XXXX--------SSSS-------SSSS-SSSSSS--SS-------------------------------------------------------------------------------------------------------------------------EE--E-----------------------------------------------------------------------------o-----------------------------------------------------------------------------------------------------------------------------------------------------------------------------------------------------------------------------------------------------------------------------------------------------------------------------------------------------------------------------------------------------------------------------------------------------oo--------------------------------------------------------------------------------------------------------------------------------------------------------------------------------------------------------SSSSSSSSSSSSSSSSSSSSSSSSS------------------------------------------------------------------------------------------------------------------------E--E------------------------------------------------------------------------
S--SSSS------SSSS-----------------------------------------------------------------------------------------------------------------------------------------------------------------------------------E--------?-------------------------------------------------------------------------S-----------------------------------------E-E----------------------------------oooo------------------------------------------------------------SSSS-------SSSSSSSSSSS--SS-----------------------------------------------------------------------------------------------------------------------XXXXXXXXX------X---------------------------------------------------------------------------------------oo--------oo--oo-----------------------------------------------------------------------------------------------------------------------------------------------------------------------------------------------------------------------------------------------------------------------------------------------------------------------------------------------------------------------------------------------------------------------------------------------------------------------------------------------------------------------------------------------------------------------------------------------------------------------------SSSSSSSSSSSSSSSSSSSSSSSSS--------------------------------E--------------------------------------------------------------------------------------XXX-XXX--------------XX------------------------------------------------------
S---S-S---S-----------------QQQ---------------SSSSS---------------------------------oooo--E-------QQ---------------------QQQ---------------------------------------------------------E------------------SSS--??-------------------SSSS------SSSS-----?------------E-------------SS-----------------QQQ-----------?--SSSSS---?---SSSS-SSSSS----------------------------XXXX--------------------------Q----SSS--S-------------------------------oSS---------SSo-SS----------------------------------------------------------------------E-----oo----------QSS----SSS---SSSSSSSS-------------------------------SSS-----------oo----ooo-----------------------------Q-----------XXXX-----ooo--------o----------------------------------------------------------SSSS-----------------SSSSQQ----------------------------S---S--------------------------------------S-----SS---------SQQ-----------------------------------------------------------------S?SSS----------------------------SSSSS--------------------------XX-------------------SSSSSS---------------------------SSSS--------------------------XX-------------------SS---SS----------------------------------------------XXXX------QQQQ-------------------------S-----------SSSSSSSSSSSS---------------------------------SSS------SSSS-------?---------------------------SS--SSSS----SSSSSSSSSSSSSSSSSSSSSSSS----------------SSSSSS----S----S?S-S---SSSQQ----------SS-----------------------------S---------------SSSSSS-----S-Q-----------------------------------QQQQ----------------------SQSQS---------------
----------S------------------------------------------------------------------------------<>---------------------------------------------------E-------------------------------------<>---------------------------------------------------------------------------<>-------------SS------------------------------------------------------------XX----------------------------------------------------------------------------------------------XXS-------------SS--------------------------------------------------------------o-------------------------------------------------o-----------------ooo---------------------------------------------------------------S-------------------------------------------------------------------------------------------------------------------------------------------------------------------------------------------------------------------------------------Qooo----------------------------------------------------------------------------------------------------XX--------------------------------------------------------------oooo---------------XXX-------------------SS---SS---------------------------------------------XXXX-----------------------------------------------------------------------------------------------------------------------------------------------------------------S-----------------------------------------------------------------------------oooo---------------------------------------------------------------ooooo--------------------------------------------------------------
----------------------------------------------E---------------------------------------SS-[]---------------------------------------------------------------o------------o------------[]-----------------------------------------------------o---------------------[]-------------SS------------------------------------------------------------o-----------------------------------------------------------------------------------------------SSS---------S-SSSS-------------------------------------------------------------XXX-XX--------------Eo--------------------------------------------------------------------------------------------------------------------------------------------------------------------------------------------E-----------------------------------------------------------------------------------E----------------------------------------------------------XS----------------------------------------------------------------------------------------------------------------XXXS--------------------------------------------------------------------------------XXXX------------------?SS---SS--------------------------------------------EXXXX-----------------------------------------------------------------------------------------------------------------------------------------------------------------S--------------------------------------E----------------------------------------------------------E--------------------------------o--------------------------------------------------------------------------------
---------------------------o--------------------------------------------------E-------SSS[]-----------------------------------------------E--S-----------------------E-E-XX---------[]--------------E------------------------------------------------------------[]------oo--?--S---Q-----------------------------------------------------------------------------------------oo-----------------------------------------------E--o-------------Sooo-SoS--ooS?-S------------------------------------------------------------------------------------------------------------------------------------------oo-----------------------------------------------------------------------XXXXXX-------XX-------------E--SSSS----------------------------------------------XS-------------------------------------E-------------------E--<>-----E---------------------------------------------------XX---o-----E---------------SS-oo--------------o--------------------------------------------------------E-----------XXXX-------------------------------------------------------------------------------XXXXX-------------------SS---SS----------------------S--------------------XXXXXXX-----------------------------------------------------------E-----SSSSSSS-----------------E-----E------------E-------E--?--------------------------------E--------?ooooooooooo-----------------------------------------------------------------------E------------<>---------------------------------------------------------------------------------E--o-------------------o-o------
--------SSSSS--S?SS-------ESQQS-------------S?S------------------------------<>---Q----SS[]-S--E?QQQ--QQQQ---------------SQQQ------------<>-------------S-----------<>---X---------SXXX-------------Q---S?SQS---S----X--X---------SSSS-----------XXX-SSSS-------SS-----E--S-----S--SSSS------------SSS-----------S----SSS----------XXXX--SS-----E-------------------------XX----------------E----------QQ-Q---S?S------E---E--<>----------------SSSSSSSS--SSS--S------------E-----------E----Q---------------------------XXXX-----------XXXX--XXX-----ESQS------X--X--------------X-----------------------------------XXXX--XXXXX--SS-------------------------QQQQ----------XXXX------------------------------<>-------------------------E-----------------SSS-----XXX-XX-----------QQ--Q-QQ-Q------------<>----------SSS-----<>--[]----<>----------------------------XX--Q---S?S---S----X--XXXX-------<>-------------E-------------------------XXX---------------------------------SS-------------<>----------XXXX-------------------------------------------------------------------------------XXXXXX-----------X-------SS---SSS----------------XXX---------X----o-------XXXXXXXX--------QQQ-------------------E-----------------------XSSSSSSS--------------S-----------<>----<>-----S?S---<>------<>----------------XXXXX------------------SSSSS??SSSSSSSSSSSSS-----------Q---XSS---SSS----S-----------SSQS---------S?S-----------<>-----E-E----[]-QQQQ-----------E-----------XSSS-----------------------------------S?SQQQ-------<>---------QQ?SSSS---------------
-------SSSSSSSS--SS----------------E-----------------------------------------[]----------[]----------------------------------------------[]----------------E-----XX-[]--XX---------------E-------------------------E-X--XX-------------------S------------------------<>-----------------------------------------------------------------------------E------E-E---E---E--------------------<>---<>--------------------<>------[]-----EE-------------------------------------E----------EXXS-------------------------------------------------------------------XXX--XX------------------------E-E-----------------------------------------------------------------------------------------------------E--------[]--E----------------E----<>----<>-----E------------XXXX-XX---------------------------------[]------------------[]--[]----[]----------------------------XX---------------E---XXXX--------[]------E----E<>------EX--------------------------------------------------------------------[]---------XXXXX---------------X----------------------------------------------XXX-------------EXXXXXX---------XXXX--XX-----E-------------------XXXX-------XXX----E------XXXXXXXXX-----------------------------<>--------X-----------E--X---------------------------------[]----[]-----------[]------[]----------------XXXXX--------E---E-----SSXS---SS---------------------------------------S--------------------------------------[]----<><>----[]-------------------------E--X---------------------------------------------------[]-------------------------------
----------SSSSS--SS---------------<>-----------------------------------------[]-<>-------[]----------------------------------------------[]---------------<>----X-X-[]--XXX-------------<>---------------------------X--XXX----E-------------S------------------------[]-----------------------------------------------------------------------XX---<>-----<><>--<>--<>--<>----------------[]---[]--------------------[]------[]-----------------------------------<>------<>------<>-XXXXX------------------------------------------------------------------XXXX--XXX----------------------<><>--<>-----------------------------------------E------------------------------------o-----------------<>--------[]-<>---------------<>----[]----[]----<>-----------XXXXX-XXX--------------------------------[]------------------[]--[]----[]---------------------------XXX--------------<>-XXXXXX-----X--[]-----<>---<>[]----------------------------------------------------------------------------[]--------XXXXXX-----------E---X-------------------------------------------------------------XXXXXXXX--------XXXXX--X----------------------<>-XXXXX-------XXX---<>--<>-XXXXXXXXXX-----------------------------[]--------X-----------X--XX--------------------------------[]----[]-----------[]------[]----------------XXXXX--------XX-<>-----SSXS---SS------------------------------------------------------------------------------[]----[][]----[]----------------------------X---------------------------------------------------[]-------------------------------
---------------ooSS---------------[]-------------------------EE-E------E-E---[]-[]-------[]---------E-E-EE----------------------E----E-E-[]-------E-EE-E--[]-EE-X-X-[]--XXX-------------[]---------------------------X--XXXX-----------------------------------E-E----[]----------E------------EE-------EE------------------------------------XXX-E-[]-----[][]--[]--[]--[]-----------E-E--[]---[]------E-------------[]------[]---S--------------------E---E--EE--[]----E-[]------[]XXXXXX-------------------------EE-E-------------ooo--------------E-----XXXXX--XXXX---------------------[][]--[]---------------ooo----------------------------o-------------------XXXXXX------------------------[]--------[]-[]-------------E-[]----[]----[]----[]---E-EE---XXXXX--XXXX--EE---XX----------------------[]-----E---------E--[]--[]-E--[]-S-E-EE------E---------E--XXXX--------------[]XX-XXXX-----X--[]-----[]---[][]--------------------------------------------E----E-EE-----------------------[]-------XXXXXXX---------------X----X-------X---EE-E------------E-EE---X--------------------XXXXXXXXX-------XXXXXXE-X--------------------E-[]XXXXXX-----XXXXXX--[]--[]XXXXXXXXXXX------XX----EE-E-------EE-E--[]---X----X-----------X--X--------------------------EE-----[]----[]-----------[]------[]-----------EE---XXXXX-------XXX-[]-----X---ooo-----EE---------------E-E---------------X------------E----------------------E---[]----[][]----[]------------E-----E---------X----------------------------E----------E-----E-E---[]-------------------------------
XXXXXXXXXXXXXXXXXXXX--XXXXXXXXXXXXXXXXXXXXXXXXXXXXXXX--XXXXXXXXXXXXXXXXXXXXXXXXXXXXXXXXXXXXXXXXXXXXXXXXXXXXXXXXXX--XXXXXXXXXXX--XXXXXXXXXXXXXXXXXXXXXXXXXXXXXXXXXXXXXXXXXX------XXXXXXX-XXXXXXXXXXX-XXXXXXXXXXXXXXXXXXXXXXXXXXXXXXXXXXXXXXXXXXX--E---XXXX---XXXXXXXXXXXXXXXXXXXXXXXXXXXXX--XXXXXXXXXXXXXXXXXXXXXXXXXXXXXXXXXXXXXo--------XXXXXXXXXXXXXXXXXXXXXXXXXXXXXXXXXXXXX---XXXXXXXXXXXXXXXXXXXXXXXXXXXXXXXXXXXXXXXXXXXXXXXX-XXXXXXX--XXXXXXXXXXXXXXXXXXXXXXXXXXXXXXXXXXXXXXXXXXXXXXXX-XXXX----XXXX---XXXXXXXXXXXXX-----XXXX----XXX------------XXXXXXXXXXXXX-XXXXXXXXXXXXXX-----XXXXXXXXXXXXXXXXXX--XXX-------XXX--------------X---XX---XXXXXX---XXXX----XXXXXXXX--------------------------XXXXXXXXXXXXXXXXXXXXXXXXX--XXXXXXXXXXXXXXXXXXXXXXXXXXXXXXXXXXXXXXXXXX--XXXXXXXXXXXXXXXXXX-XXXXXXX---XXXXXXXXXXXXXXXXXXXXXXXXXXXXXXXXXXXXXXXXXXXXXXXXXXXXXXXXXXXXXXXXXXXX-XXXXXXXXXXXXXXXXXXXXXXXXXXXX--XXXXXXXXXXXXXXXXXXXXXXXXXXXXXXXXXXXXXXXXX-----XXXX--XXXXXXXXXXXXXXXXXXXXXXXXXXXXXXXXXXXXXXXXXXXXXXXXXXXXXXX-X---XXXXXXXXX--X-XXXXXXXXXXXXXXXXXXXXXXXXXXXXXXXXXXXXXXXXXXXX-----XX-----XXXXXXXXXXXXXXXXXXXXXXXXXXXXXXXXXXXXXXXX--XXXX--XXXXXXXXX-XXXXXXXXXXX--XXXXXXXXXXXXXXXXXXXXXXXXXXXXXXXXXXXXXXXXXXXXXXXXXXXXXXXXX--XXXXXXX-XXXXXXXXXXXX--XXX--XXXXXXXXXXXXXXXXXXXXXXXXXXXXXXXXXXXXXXXXXXXXXXXXXXXXXXXXXXXXXX-XXXXXXXXXXXXXXXXXXXXXXXXX---XXXXXXXXXXXXXXXXX---XXXXXXXXXX--XXXXXXXXXXXXX-XXXXXXXXXXXXXXXXXXXXXXXXXXXXXXXXXXXXXXXXXXXXXXXXXXXXXXXXXXXXXXXXXXXXXXXXXXXXXX---XXXXXXXXXXXXXXXXX---XXXX--XXXXXXXXXXXXXXXXXXXXXXXXXXXXXXXXXXXXXXXXXXXXXXXXXXXXXXXXXXX