-----------------------------------------------------------------------------------------------------------------------------------------------------------------------------------------------------------------------------------------------------------------------------S-So------------------------------------------------------------------------------------------------------------------------------------------------------------------------------------------------------------------------------------------------------------------------------------------------XX-------------------------------------------------------------------------------------------------------------------------------------------------------------------------------------------------------------------------------------------------------------------------------------------------------------------------------------------------------------------------------------------------------------------------------------------------------------------------------------------------------------------------------------------------------------------------------------------------------------------------------------------------------------------------------------------------------------------------------------------------------------------------------------------------------------------------------------------------------------------------------------------------------------------------------------------------------------------------------------
-------------------------------------------------------------------------------------------------------------------------------------------------------------------------------------------------------------------------------------------------------------X-----XXX------X--XX-SXX-----------------------------------------------------------------------------------------------------------------------------------------------------------------------------------------------------------------------------------------------------------------------------------------------------------------------------------------------------------------------------------------------------------------------------------------------------------------------------------------------------------------------------------------------------------------------------------------------------------------------------------------------------------------------------------------------------------------------------------------------------------------------------------------------------------------------------------------------------------------------------------------------------------------------------------------------------------------------------------------------------------------------------------------------------------------------------------------------------------------------------------------------------------------------------------------------------------------------------------------------------------------------------------
------------------------------------------------------------------------------------------------------------------------------------------------------------------------------------------------------------------------------------------------------------SSSSSS------SSS--S--------oo-------------------------------------------------------------------------------------------------------------------ooo--------------------------------------------------SSSSSSSSSSSSSSSSSSSSSSSSSSSS------------------------------------------------------------------------------------SSSSSS----S------SSSSSSSSSSS-------------------------------------------------------------------------------------------------------------------------------------------------------------------------S----oo--------------------------------------------------------------------------------------------------------SSSSSSSSSSSSSSSSSSSSSSSSSSSSSSSSSSSSSSSSSSSSSSSSSSSSSSSS-------------------------------------------------------------------------------------------------------oo-------------------------------------------------------------------------------------------------------------------------------------------------------------------------------------------------ooo--------------------------oo-----------------------------------------------------------------------------------------------------------------------------------------oo-----------S------------------------------------------------------------------------------------------------------------
-------------------------------------------------------------------------------------------------------------------o---------------------------------------------------------------------------------------------------------------------------------------------------XX----XX-------XX-------------------------------------------------------------------------------------------------------------------XXXX----------------------------------------------------SS-----------------------------------------------------------------------------------------------------------SSSS------------------------------------------------------------------------------------------------------------------------------------------------------------------------------------------------o-o--XXXX----------------------------------------------------------------------?---------------------------------------------------------------S-------------------------------------------------------------------------------------------------------------------------------XX-------------------------------------------------------------------------------------------------------------------------------------------------------------------------------------------------XXXX------------------------XXXX-----------------------------------------------------------------------oo-------------------------------------------------Q--------------------------S------------------------------------------------------------------------------------------------------------
-------------------------E----E------------------------------------E---------------------------------------------------------------------------------------oo-------------------------------------------------------------------oooo-----------------------------------X-------------EX--------------------------------------------------------------------------------------------------------------ooo------------------------------------------------------oo---SS----------------------------------------------------------------o------------------------------------------SSSS----X------------------------------ooQXoo-----------------------------------------------------------------------------------------------X---E------------------------------------oo--oo---------S-S---------------------------------------------------------------o----oo--------------------------------------------------------------------------------------------------------------------------------------------------------------------------------------------E------------oooo--------------------------------------oo---------------E-------------------------------------oooo--------------------------E-------------------------------------------------------o----------------oo---------------------------------------------------------------------------------------------E-----------oo----------------------------------------E-oo--------E------------------------------------------------------------------------------------------------------------------------
Q---SQSSS?-------------SSSSS--E--E-----------------XXX-------------QS--SQS---------SSQQS-------------S----------SSSS----------------oo------SSS----------------------------------SSQS-------------------SSS----------XX---------XXXXX------------------------------------oo-o--------XXX---------------------------S---?---------------SSSSS----------------SSSSSSSSSSS------------------------------XXX---?-----------------SSS---S----------SXX------------------QQ-------------------ooo------------------oo---XXX-------ooo-XXXX----------------------------------------SSS---SS----------------------SSSSSSS------------------------------SS---------------SS-------------------QS----------------------------------------SQSSS-----SSS-----Q---------XXoo----------------------------S-------------------S---------------------?------E-----oo----XX------?-----------------------------QQQ-----QQQ--------------------------------------------SS----------------------------------------------------------------SS-----SSSS-----------------------E--E---------XXXX-----------------SSSS---------o----------------------SSSSS----------------SSSSSSSS-----------XXXX--------------------------E--E---------------------S----------------------------XXXXX------oo--------SSSS-------SSSS-------------E----------XXX-----------------------------------------------oo----XXXX------------o---S---------SSSS--SS---SS---------XXXXX------XXX--------S??-------------S---SSS------SS---S-------SSSS--------SSSSS-------------SSSSS------SS--------------------------
--------------------------------XXXXXX-------------XX-------------------------------S--------------------------------------------------------------------------oooo--------------------------------------------------XX-------------------X-------------------------------------------------------------------------------------------------------------------------------------------------------------E------------------------------XXXX-----------------XX--------------------------------------------------------------------------------------------------------------------SS----------------------------------------XX---oooo-------------------------------------------------------------------------------------------------------------------------------------------------------------------------------------------------------XXX---<>----------------XX--------------------------------------------------------------------------------S-----------------------------------------------------------------------------------------------------XXXXX--------------------------------------------------------------------------------------------------------------------------------------XXXXX----------------------------------------------------XXXX--------------------------------------------------------------------------------------------------------------------------XX-------------------SS---------XXXX-------o----XXX-------SS-------------------SS-------------------------------------------------------------------oooo----oo------X-----
------------------------------X-o-----------------XXX-------------------------------S-------------------------------------X---------------o--------------------------------------------------------------------------XX--------------------------------------------------SSSSSS------SS---------------o--------XS------------------------------------------------------------------------------------------------------------SS---------------------------------------------------------S-----------------------------------------------------------------------------------------SS---------------E---E---------------------------------------------------------------------------------------------------------------S-------------------------------------------------------------------S------------------------------------------------------[]--------------E--------------------------------------------------------------------------------------------------------------------------------------------------------------------------------------------------------------------------------------------------------------------------------------------------------------------------------------------------------------------------------------------------------------------------------------------------------------------------------------------------------------------------oo----S---------------SS------------------------XXXX-------SS-------------------SS--------S------------------------------------------------------------------------XXX-----
------------------------------------------------XXXXX-------------------------------S--------S----------------------------------------------S------------------------------------------------------------------------XX-------------------XX-----------------------------SSSSSS------------------------------XXX------------------------------XX-----------------------E-----------------------------------------------E-----SS------------------------XXX------?---------------------SS-------------------------------------XXX------------------------------------------------ooSS--------------<>--<>-----------------------E---XXX----------------------------EX--------------------------------------------------XX------------------------------------------------------SQ----ooS----SS----o---------------------------------------------E--XXX----------XXXXX------------------------------------------------o------------------------S-----------------------------E----S------X------------E-------------ESS----------------------------------------------------------E------------------------XX------------E----------SS--S-------------------------------------------------oo------------------------------------------------------------------------------XXX-----------------------------------Q-SSSS-------------------------------------------E-------------------------------------oo-----------?-SS---E-------------------XXXXX-------SS-------------------SS--------------------------------X----------E--o--------------------o---------S---XXX-----
---E?QS---------X------------XX--------------S--X-XXX------------------SSSS--------SSSS----E--------S-----------SS---------oo---XXX--XXXX------E---------E--<>---------------------S----------E-----------------XX---XX------------XXX--------------X---S---S--------------------------------------QS--------XXX---E-ooQ---------------------XXX--------------------SSSSS-------------------------E------o------------<>----------XX---------XXX------------------SSS-------ES---SS----SS----------XXX--XXXX-----XX-----------------------XX-X--------------------------E-------SSSSS--------E--SS[]--[]----------SQS--XX-----<>---------------------------------<>X----------------QQQ------------------------------XXX-------S?S-----SSSSS------QQQ----------XXXX-----------------SSS----SS<>---------------------------------XXXX--SS------<>------XXXXX-------------------------------XXX--SS-----SSS-----------S------------SSS-------------SS--------S--------------<>----------XX-----------<>---S---E----<>-----Q-Q--QQQQ---------------------XXXXX-------------------<>------------SS-----XX-X-S------------<>-----------------------------SS---oo------S--------------------o-----Q---SS----------XXXX---XXX-------S-----XXX-X-----------X-----XXXX-----XXX-------------QQ--QQQQ--Q----------------------------------------------------------------<>-----------XXXX---XXXXXX-XXX----------S-----E--S----SS---SSS----------------XXXXXX-------SS--------XX--X------------X-------SS----SSSS--S------XXSSS------<>-----------------oS--------------------X-----
------------XX--XX----------XXX---------------X-X-XXX----------------------------E--------<>-----------------X-------------------E--E---------<>--------<>--[]-------------------------------<>---------E------XXX---XX--------------------------------------------XX-------------X-----X-------------------XXXX-----------E------X---------XXXX---X---------------E-----------E----------E------<>-------------------[]--------EXXX---------------------------X----------------------------------------------------o--------------------XXX-X---S---------------------<>--------------------E----[]--[]----------------------[]---------------------------------[]X------------------------------------------------XXXX-----------------S-------------------------------XX------S-----------[]------------------------E----------------------[]--------------------------------------------------------------------------------------------------------E--X--------------[]--E---E--XXX-----------[]------<>----[]-----------------------------------------------------------[]------------------XXX-X------E-E-----[]--------------------------------E--E----------------E-----X----E-------------------------------------------XXXX-XXX--------XX-------------------------SS----------------------------------------------------------------------<>------[]--------------------------------X----------<>----------E-------------------XXXXXXX--S-------------XXX--XX--------E--X-------------------------XXX---------[]-------------------------------------X-X-----
------------XX--XXX---------X-X---------------X-X-XXX---------------------------<>XX------[]---------------XXX--------XXXX-XX-----------------[]--------[]--[]-------------------------------[]--------<>-----XXXX---XX---------------------------------------------XXX-----------X-----S------------------XXXXX----------<>---------------XXXXX---X--------------------------<>---------<>------[]-------------------[]-------XXXXX-----------------o--------XX----------------------------XX---------------------XXXXXXXo-------------XXXX-X-X-----------------------[]-------------------<>----[]--[]----------------------[]--------------------------------X[]X-----------------------------------------------XXXXX-----------------S------------------------------XXXX-----------------[]--------------X--------<>----------------------[]-------------o----------------SS---------------------------------------------------------------------------X--------------[]-<>--<>-XXXX-----------[]------[]----[]-------------------------------------------------------XX--[]-----------------XXXX-X-----<><>-----[]---------------------------------------------------<>-----X-----------------------------------------------XXXXX-XXX-------XXX-----------------XXX-----------------------------------------------------------------------------[]------[]-------------------------------XX----------[]-----------------------------XXXXXXXX---------------XXXX--XXX----------X------------------------XXXX---------[]-----------------------------------X-X-X-----
------------XX--XXX---EE------X-------E-E-E---X---XXX-------E-E--E----E---------[]XXE-----[]--------------XXXX--------------------------------[]--------[]--[]---------------E-EE--------EE--[]-E------[]----XXXXX---XX-----------------------------------------------------------X-X---S----E-EE-------E-XXXXXX---XE-----[]---E----------XXXXXX---X---------E----------------[]---------[]--EE--[]-E----E-E-------EE-[]------XXXXXX--------o----------------XXX------------------------EE-------------------------------X---oo-------XXXXXX-X-XXXS-------------E-E----[]E-----X--E---------[]-E--[]--[]----------------------[]-------------E-E----E-E--------XX[]X-E-EE-E------E-------EE-E---------------------XXXXXX--------------------------------XXXXooo--------XXXX------X--E-EE-E---[]----EE--------X--------[]-----ooo--------------[]--ooo-------XXX-------------------o------------------------------------EE----------------------------------X---EE---------[]-[]--[]--XXX-------EE--[]------[]-E--[]-----------------------EEE---------------------------------[]----E-E-----E---XXXXX[]-----[][]-----[]-----------XX--------EE-E-EE---------------------E-[]-----X---------X-------------------------------E----XXXXXX-XXX------XXXX--ooo--------------------------------------------------------------------------------------------[]------[]---------ooo----XXX-----------XXX----EE-E--[]-E------------------------------XXXXX-------E------XXXXX--XXXX---------X-----------------------XXXXXE--------[]-----------------E---------------------X-----
XXXXXXXXXXXXXX--XXXXXXXXXXXXXX--XXXXXXXXXXXXXXXXXXXXXXXXXXXXXXXXXXXXXXXXXXXXXXXXXXXXXXXXXXXXXXXXXXXXXXXXXXXXXXX-XXXX----------------------XXXXXXXXXXXXXXXXXXXXXXXXXX-XXXS-XXXXXXXXXXXXXXXXXXXXXXXXXXXXXXXXXXXXXXXXX-XXXXXXXXXXXXXXX---------------------XXXXXXXXX-----------XXXXXXX-XXXXXXXXXXXXXXXXXXXXXXXXXXX----XXXXXXXXXXXXXXXXXXXXXXXXXXXXXXXXXXXXXXXXXXXXXXXXXXXXXXXX-XXXXXXXXXXXXXXXXXXXXXXXXXXXXXXXXXXXXXXXXXXXXXXXXXXXXXXXX--X-X-XXX----------XXXXXXXXXXXXXXXXXXXXXXXXXXXXXXXXXXXXX-----XX-----------------------------XX-XXXXXXXX--XXXoXX-XXXXXXXXXXXXXXXXXXXXXXXXXXXXXXXXXXXXXXXXXXXXX-XXX-XXXXXXXXXXXXXXXXXXXXXXX-XX-------XXXXXXXXXXXXXXXXXXXXXXXXXXXXXXXXXXXXXXXXXXXXXXXXXXXXXXXXX-XXXXXXXXXXXX--XXXXXXXXXXXXXXXXXXXXXXXXXXXXXXXXXXXXXXX------XXX-------X-X-----------XXXXXXXXXXXXXXXXXXXXXXXXXXXX-X-XXXXXXX---XXX-------XXXXXXXXX--XXX-------------------XXX-XXXXX--------X----XXXXXXXXXXXXXXXXXXXXXXXXXXXXXXXXXXXXXXXXXXXXXXXXXXXXXXXXXXXXXXXXXXXXXXXXXXXXXXXXXXXXXXXXXXX--XXXXXXXXXXXXXXXXXXXXXXXXXXXXXXXXXXXXX-----XXXXXXXXXXX--XXXXX------XXXX-----------XXXXXXXXXXXXXXXXXXXXXXX--XXXXXXXXXXXXXXXXXXXXXXXXXXXXXXXXXXXXXXXXXXXXXXXXXXXXXXXXXXXXXXXXXXXXXXXXXX--XXXXXXXXXXXXXXXXXXXXXXXXXXX------------XXXXXXXXXXXXX-XXXXXXXXXXXXXX--XXX-----------------------XXXXXXXXXXXXXXXXXXXXXXXXX---XXXXXXXXXXX--X-----XXXXXXXXXXXXXXXXXXXXXXXXXXXXXXXXXXXXX----XXX----------------XX-S-XXXXXXXXXXXXXXXXXXXXXXXXXXX-X-------XXXXXXXXXXXXXXXXX-XXXXXXXXXXXXXXXXXoXXXXXXXXX--X--XXXXXXXXXXXXXXXXXXXXXXXXXXXXXXXXXXXXXXXXXXXXXXXXXXXXXXXXXXXXXXXXXX---XXXXXX-XXXXXX