------------------------------------------------------------------------------------------------------------------------------------------------------------------------------------------------------------------------------------------------------------------------------------------------------------------------------------------------------------------------------------------------------------------------------------------------------------------------------------------------------------------------------------------------------------------------------------------------------------------------------------------------------------------------------------------------------------------------------------------------------------------------------------------------------------------------------------------------------------------------------------------------------------------------------------------------------------------------------------------------------------------------------------------------------------------------------------------------------------------------------------------------------------------------------------------------------------------------------------------------------------------------------------------------------------------------------------------------------------------------------------------------------------------------------------------------------------------------------------------------------------------------------------------------------------------------
------------------------------------------------------------------------------------------------------------------------------------------------------------------------------------------------------------------------------------------------------------------------------------------------------------------------------------------------------------------------------------------------------------------------------------------------------------------------------------------------------------------------------------------------------------------------------------------------------------------------------------------------------------------------------------------------------------------------------------------------------------------------------------------------------------------------------------------------------------------------------------------------------------------------------------------------------------------------------------------------------------------------------------------------------------------------------------------------------------------------------------------------------------------------------------------------------------------------------------------------------------------------------------------------------------------------------------------------------------------------------------------------------------------------------------------------------------------------------------------------------------------------------------------------------------------------
-----------------------------------------------------------------------------------------------------------------------------------S----------------------------------------------------------------------------------------------------------------------------------------------------------------------------------------------------------------------------------------------------------oo---------------------------oo-----------oo----------------------------------------------------------------------------------------------------------------------------------------------------------------------------------------------------------------------------------------------------------------------------------------------------------------------------------------------------------------------SSSSSSSSSSSSSSSSSSSSSSSSSSSS---------------------------------------------------------------------------------------------------------------------------------------------------------------oo-----------------------------------------------------------------------------------------------------------------------------------------------------------------------------------------------------------------------------------------------------------------------------------------------------------------------------------------------------------------------------------------------------ooo--------------------------------------------------------------------------------------------------------------oo-----------------------------------
--------------------------------------------------------------------------------------------------------------------------------------o--E--------------------------------------------------------------------------------------------------------------------------------------------------------------------------------------------------------------------------------------Q-o----------------------------------------XXX-----------------------------------------------------------------------------------------------------------------------------------------------------S-------------------o-------------------------------------o---------------------------------------------------------------------------------------------------------------------------------------------------------------------------------SSSSSSSSSSSSS----------------------------------------------X----------------------------------------------------------------------------------------------------o----------XXXX----------------------------------------------------------------------------------------------------------------------------------------------------------------------------------------------------------------------------------------------------------------------------------------------------------------------------------------------------------------------------------------------------XXXX------------------------------------------------------------------------------------------------------------XXXX----------------------------------
---------------------------------------------------------------------E---------------------------------------------------------------XXXXX------------------o--oo----------------------------------------------------------------------------------------------------------------------------------E---------------------------------------------------------------------------------oo--------------------------------------------------------XXX--------------------------------------------------------------------------------------------------------------------------------------------------------------------------------------X---------------------------------------------------------------------------------------------------------------E-----------------------------------------------------------------------SSSSSSSSSSSS-------------------------------------o--------------------------------------------------------------------------------------------------------------------------------------------------------------------------------------------------------------------------------------------------------------------------------------------------------------------------------------E--------------------------------------E--------------------------------------------------------------------------------------------------------------------------------------------------------------------------------------------------------------------------------------------------------------------------------------------------------
------------------SSSSSSS--------------------------------------------E--E-E-----oo--------------QQ--------------------------------------------SSS---QQQQ----------------------------------X?SSS---------------SSS--------------------------SSS----------------------------------------------------SQS--SSSS----------------------------------------ooo------------------------------XXXX----------------------------SX-----SSSS--------------------------------S-S-S-------SSS---------------------------------XXX---------------------------------------------------S-SS----SSS------------SS---S---SSS-----------------SSQSSSS-?---------SSS-----Q---------?----------------------------------SS---QSS--------------------------------------------QQQ-SS--------------------SSSSSS--QQ--------SSSSSSSSSSSS--------------------SSSSSSSSSSS--?SSSS----QQQQ--------------SSSSS----E?-E---------------Q?SSQS----SQQS----------------------------SSSSS--------S----------------------------SSSSS-------------------------S-Q---------------------------------------SSS--------------------SSS------------------------------SSS--------S--------------------------------------------SSS--------S---------SSS-----E---------------SS---?SSS------------------------SQS--SQS----------------------------E--------------------S--------------------------------------------SSSS--------SSS--SSSSSS-----E----ooo----XXXSo---------------------------------------SSSS----SQQQ------------------S---SQ-------------------SQ?SSS-----?SSS------------------------------------------
-------------------------------------------------------------XXX-------XXXXXX----------------------------------------------------------------------------------o--------------------------------------------------------------------------------------------------------------------------------------------------------------------------------------------o---o-------------XXXX-------------------------------------------------------------------------------------------------------------------------------------------------------------------------------------SS-----------------------------S-----------------------------------------------------------------------------------------E------------------------------------------------------------------------------------------------------------------------------------------------------------------------------------XXXX---------------------------------------------E----------------------------------------------X-----------------XXX--------------------------------------------------------------------------------------------------------------------------------------------------------------------------------------------------<>-----------------------------------------------------------------------------------<>--------------------------------------------------------------------------------------------------X------------------------------------------------------------------------------------------------------------------------------------------------------------------
------------------------------------------------------------------------------------------------------------------------------------------------------------------------------------------E------------------------------------------------------------------------------------o---------------------------------------------------------------------------XXX-XXX----------------------------------------------------------------------------------------------------------------------------------------------------X------------------------------------------------SS-----------------------------S----------------------------------SSS----------------------------------------------------S---------------------------E--------------------------------------------------------------------------------------------------------------------------------------------------------------------------------------------------------------------------------------------------------XX---------------------------------------------------------------------------------------------------------------------------------------------------------------------------------------------------------------------[]-----------------------------------------------------------------------------------[]---------------------------------------------------------------------------------------------------------------------------------------o---------------------------------------------------------------XSS--o--------------------------------------------------------
-----------------------E------------------------------------------------------------------------------------------------E-----------------------------------------------------------------------------------------------SSS--S-----SSS-----------------ooo--o------------------------------E---------------------------------------------------------------------------X----QQ-S-------------XS--------------------------------------S----------S-------------------------------------------------------E------------XX------------------------oo---------------ooo--?-SS---E--------------------------------------------------------------So?-----------------------S-SQS----------------------S--------------------SSSSS--E-------E-------------------E-------------E------SSSSSS-------------------------------------------?--o------------------------------------------------------------------S------------------------------S------------------------------------E----------XXXX-----------------------XXXX---------------------------------------------------------------------------------------------------------------------------------E----------E-------------ooo-----------------------------[]-------------------------------------X---------------------------------------------[]------E----------------------------------------------------------------------------------------------------------------------------------------XS---------------------E-------------------------------XXS---ES------------------------S-S-----------oo--ooo----------
-----------XX--X--XX--SSSS------XXX----------------------XX------------------------------------E?QQ---Q----------------<>-------------------------QQQSSQS-------------------------------S?S----------------------E--Q----------------------------X--X-------------------------------------<>-----QQQQ---S----------X----Q-Q------XX-XX---------------XXX---------------XX--------------SS---EXX-X--------------------------------------------------E--S---------E?QQQ--Q-Q-----------------------------<>-----------XXX-----------------------------o---------E--------SS--SSSSS--SS------XXX--X------------X-----------QSQS-----S----E-X--SSS------SQQS--Q-----Q--Q--------------------------------SSSS---------------------------<>------------E--SSS-XS--SSS------<>---------------SS-------------------SS----------E-XX---??SSSSSSS---------Q--QQ?SSQQQ------------------XXXXXXX----------------S------QQQ--QQQQ--Q--------Q---SSS--S-----SSQ----QQQQ--S----E------<>---------XXXXX-------XXXXXXX-----------------SSS----------------------------------Q----------------------QS-------------------------------E-----------------QQQ----------<>-----------X----E-----E---------------SS---E------ES--E-----------------S?S-------------------XX-------QQQ--Q--Q--Q--------------------------[]-----<>-------Q--QQQQQ-------------------------S-S--E------------?SSSS-------ES----------------------XXXXXXXX-----XXXXXX----------------------XXX-X---------QQ?SSQ---<>------------Q---SSS---S-------XXXX-SSS----S?SQS-----------------------------------------------
---------XXXX--XX-XX--------------------o-----------S-?------------------------XXXXX----------------------------E------[]-----------------------------------------------------------E---------------------------<>-------------------------------X--XX--------------------------------XX--[]----------------------XX---E---------XX--X--------------------E------------XX-----------------EXXXX-XXX-------------------------------o---------------<>-----------S---------------------------------------[]----------XXXX------------E--------E-----------E----<>-----------EE-------------XXXX--XX----E------S------------------------<>-S-------E---------------------------------------------------------------------------S------[]-----E-----<>-------------------[]-------E----------------X--------------------XX<>-XX------------------------------------------------------------E-----------------------------------------------------------------------<>------[]--------<>-XXX---------------------------------------X-----------------------------------------------------------------------XX---------X[>------------------------------[]--------XXXX---<>----<>-------------------<>---------<>------------------------------X-------XXX-------------------------E-------------E-----[]--X--[]--------------------------------------------<>------------------------E--E------------------------------------------------------------XXXX--------------------[]-------------------------E---XXXXX--SS--------------------------------------------------------
--------XXXXX--X--XXX------------------XXXXX---------------------------------------------<>----------------------------[]----------------------------------------------------------<>---------------------------[]-------------------------------X--XX-------------------------------XXX--[]---------------------XXX-------------XX--X---------X--XX----------E----E---XX---------------EXXXXXX-XXX------------------------------XXX--------------[]-----------SS--------------------------------------[]------<>-XXXXX-----------<>-------<>----------<>----[]-------------------------XXXXX--XXX----------S------------------------[]-S------------------------------------------------------------------------------------------[]----<>-----[]-------------------[]------<>----------------X---X---------------XXX[]-XXX----------------------------------------------------------<>-----------------------------------------------------------------------[]------[]--------[]-XXX--------------------------------------XXX---------------------------------------------------------------------XXX---------X[]---X-----------X--------------[]-------XXX-----[]----[]---------------X---[]---------[]----------------------------X-X------XXXX------------------------<>------------<>-----[]-----[]-----------------------------X--------------[]-------------------------------E-------------------------------------------------------XXXXX--------------------[]------------------------<>--XXXXXX--SS--------------------------------------------------------
-------XXXXXX--X--XXX--------oo----XX-----------------oo------------------------------E--[]---------E-E----------------[]-----E-----X--E-E-----------------------------E------E-EE-[]---------------------------[]-------------------------------X--X-X-----------------------------------[]----EE-E---------EE-XXXX---------E---X---X---EE-E--X---X------------E--E---XX-X-------------XXXXXXX?XXXX?----------------------X-----------------E-E--[]-E--------SSS--------------------------------------[]------[]XXXXXX---------E-[]-------[]---E-E----[]-E--[]-------------------EE---XXXXXX--XXXX--------X-----E-E----E------------[]-S-----------------------------------EE-E--EE------------E-E-----X-XX-----E-----------------[]--E-[]-----[]-------E-EE--------[]------[]----------------X-E-X--------------XXXX[]-XXX-----------------------------------------EE---------------[]------------------------------------E-E------E----------------------E--[]-E-E--[]-E-EEE--[]--XXX------------------------------E-----XXXX-----------E-E----------E-------------------------------------------XXXX---EE-E-XX[]-E-X-----EE---XX--------------[]------XXX------[]-E--[]--------EE---------[]---------[]------------------------E---X-X-----XXXXX----------------E-----E-[]----------E-[]-----[]-----[]---------E-------------------X---------E-E--[]-------------------------------X----------XXXXX------X-X-----------------EE-E-----E-E-XXXXXX--------------------[]----------E-------E-----[]-XXXXXXX--SS-E------------------------------------------------------
XXXXXXXXXXXXo-XXXXXXXXXXXX-XXXX-----------------------XX----------------------------XXXXXXXXXXXXXXXXXXXXXXXXXXXXXXXXXXXXXXXXXXXXXXXXXXXXXXXXXXXXXXXXXXXXX---XXXXXXXXXXXXXXXXXXXXXXXXXX-XXXXXXXXXX---XXXXXXXXXXXXXXXXXXXXXXXXXX-XXXXXXXXXXXXXXXXXXXXXXXXXXXXX--XXXX--XXXXXXXXX---XXX---S-XXXXXXXXXXXXXXXXXXXXXXXXXXXXX---XXXXXXXXXXX-XXXXXXXXXXXXXXX---X--X-XX-X-XXXXX--XXXXXXXXXXXXXX-XXXXXXXX-XXXXXXXXX--XXXXXXXXXXX------XX-----S-XXXXXXXXXXXXXXXXXXXXXXXX--SXXXXXXXXXXXXXXXX-XXXXXXXXX---XXXXXXXXXXXXXXXXXXXXXXXXXX--X---XXXXXXXXXXXXXXXXXXXXXXX-XXXXXXXXXXXXXXXXXXXXXXXXXXX---XXXXXXXXXXo--XXXXXXXXXXXXX--XXXXXXXXXXXXXXXXXXXXXXXXXX--XXXXXXXXXXXXXXXXXXXXXXXXXXXXXXXXXXXXXXXXXXXXXXXXXXXXXXXXXXXXXXXXXXXXXXXXXXXXXXXXXXXXXXXXXXXXXXXXXXXXXXXXXXXXXXXXXXXXXXXXXXXXXXXXXXXXXXXXXXXXXXXXXXXXXXXXXXXXXXXXXXXXXXXXXXX-XXXXXXXXXXXXXXXXXXXXXXXXXXXXXXXXXXXXX--XXXXXXXXXXX-XXXXX------XXXXXXX--------XXXXXXXXXXXXXXXXXXXXXXXXXXXXXXXXXXXXXXXXXXXXXXXXXXXXXXXXXXXXXXXXXXXXXXXXXXXX--XXXXXXX-XXXXX------XXXXX-----------XXXXXXXXXXXXXXXXXXXXXXXXXXXXX-X-XXXXXXXXXX--XXXXXXXX--XX--XXXXXXXXXXX----XXXXXXXXXXXXXXXXXXXXXXXXXXXXXXXXXXXXXXXXXXXX--XXXXXXXXXXXXXXXXXX---XXXXXXXXXXXXXXXXXXXXXXXXXXXXXXXXXXXXXXXXXXXXXXXXXXXXXXXXXXXXXXXXXXXXXXXXX-XXXXXXXXXXXXXXXXXXXXXXXXXXXXXXXXXXXXXXXXXXXXXXXXXXXXXXXXXXXXXXXXXX---XXXXXXXXXX---XXXXXXXXXXXXXXXXXXXXXXXXXXXXXXXXXXXXX--XXXXXXXXXXXXXXXXXXXXXXXXXXXXX----------------------------XXXXXXXXXXXXXXXXXXXXXXX----XXXXXXXXXXXXXXXXXXXXXXXXXXXXXXXXXXXXXXXXXXXXXXXXXXXX---SXXXXXXXXXXXXXXXXXXX---XXXXXXXXXXXXXXXXXXXXXXXXXX---XXX---