------------------------------------------------------------------------------------------------------------------------------------------------------------------------------------------------------------------------------------------------------------------------------------------------------------------------------------------------------------------------------------------------------------------------------------------------------------------------------------------------------------------------------------------------------------------------------------------------------------------------------------------------------------------------------------------------------------------------------------------------------------------------------------------------------------------------------------------------------------------------------------------------------------------------------------------------------------------------------------------------------------------------------------------------------------------------------------------------------------------------------------------------------------------------------------------------------------------------------------------------------------------------------------------------------------------------------------------------------------------------------------------------------------------------------------------------------------------------------------------------------------------------------------------------------------------------
------------------------------------------------------------------------------------------------------------------------------------------------------------------------------------------------------------------------------------------------------------------------------------------------------------------------------------------------------------------------------------------------------------------------------------------------------------------------------------------------------------------------------------------------------------------------------------------------------------------------------------------------------------------------------------------------------------------------------------------------------------------------------------------------------------------------------------------------------------------------------------------------------------------------------------------------------------------------------------------------------------------------------------------------------------------------------------------------------------------------------------------------------------------------------------------------------------------------------------------------------------------------------------------------------------------------------------------------------------------------------------------------------------------------------------------------------------------------------------------------------------------------------------------------------------------------
--------------------------------------------------------------------------------------------------------------------------------------------------------------------------------------------------------------------------------SSSSS---------------------------------------------------------------------------------------------------------------------------------------------------------------------------------------------------------------------------------------------------------------------------------------------------------------------------------------------------------------------------------------------------------------------------------------------------------------------------------------SSSSSSSSSSSSSSSSSSSSSSSSSSSS--------------------------------------------------------oo--------------------------------------------------------------------------------------------------------------------------------------------------------------------------oo-------------------------------SSSSSSSSSSSSSSSSS---------------------------------------------------------------------------------------------------------------------------------------------------------------------------------------------------------S----------------------------------------------------------------------------------------------------------------------------------------------------------------------------------------------------------------------------------------------------------------------------------------------------------------
----------------------------------------------------------------------------------------------------------------------------------------------------------------------------------------------------------------------------------SS------------------------------------------------------------------------------------------------------------------------------------------------------------------------------------------------------------------------------------------------------------------------------------------------------------------------o------------------------------------------------------------------------------------------------------------------------------------------------------------------------------SSSSSSSSSSSSS------------------------------------------------------------E--E------------------------------------------------------------------------------------------------------------------------------------------------------------------------E--E--------------------------------------------------------------------------------------------------------------------------------------------------------------------------------------------------------------------------------------------------SS-------------------o-----------------------------------------------------------------o--------------------------------------------------------------------------------------------------------------------------------------------------------------------------------------------------------------------------
----------------------------------------------------------------------------------------------------------------------------------------------------------------------------------------------------------------------------------SSS-----------------------------E-----------------------------------E---E--------------------------------------------------------------------------------------------------------oo--oo--------------------------X---------------------------------------------------------------------------------------------------------------------XX---------------------------E---------------------------------------------------------------------------------------------------------------------o---------------SSSSSSSSSSSS--------------------------------E--------------------------XXX-X------------ooo--------------------------------------------------------------------------------------------------------------------------------------------------------XXXXXXX-----------------------------------------------------------------------------------------------------------------------------------------------------------------oooo---------------o-----------------------------X-----------------------------SS--E-----------------------------------------------------------------------------X---E---------------------------------------------------E-----------------------------------------------------------------------------------------------------------------------------------------------------------------------
--------------------------------------------------------oo----------------------SSS-S?SSS--SS-------------------S---------------------------SSSSS---?-----------------------SQS----SSSSS-------S----------------------------------S-----S-----------------S-----ES?S-QSQQQ----------------SQQS------SSSSSSQS-SSS----------SQ----------------------------------------------------------QQQ-------------------------------------------------------------------------------------SSS----?SSSSS-----------------------------SSS-----------oo----?oo---------------------------------SSS-----E--------o----E--E------------------------------------S----------------------SQQ-----------------SSS----SSSSS-------XX-------?---------------------SSSSSSSSSSSSS-----------SSS------SSSS-------SQS----SSSS--------------------------XXXo----XXX-------------------------------------E------QQ--------------------------SSS----SSSSS--S----SS--SQQ-QQ------------------------------------SSS-----------------------------------Q-------------------------SSSSS------------------------------------------------------------S-S--------------------------------S----SSS-----------XXXX--------------XXX----------S---------------------SSQS---SSSSS------------------SS---------S---SSS---S------------------------SSSSQSSSS-----QQQS----SSS----------SQS-SS-------------------o------------------------------SSQS----------------SSSSS------------SS--SSSSS----------?------------XXX----------------------------------------SSQSS---------------------SSSS-------SSSSSSSSSSSS----
-------------------------------------------------------------------------------------------------------------E--------------------------------------------------------------------------------------------XXX---------------------S----SS----------E----------------------------------------------------------------------------------------------------------------------X------------------------------------------------oooo--------o---o--------XXXX--------------------------------------------------------------------------------<>-----XXX--XX--o--E---------------------------<>---------------XXXX---------------------------------------------------------S---------------------------------------------------XXX-----------------------------------------------------------------------------------------------------------------------------------------------------------------------------------------------------------------------------------------------------------------------------oooo---------------------------------------------------------------------------------------------------------------------------------------------------------------------------------------------------------------------------------------------SS-----------------------------------------------------------------------E-----------ES--------------------------------------------------?--------------------------------------------------------------------XXS---------------------------------------------------------------------------------------------
--------------------------------------------------------------------------------o--------------------------XXXX-------------------------------------------------------------------------------------------------------------------S-S---S---------<>---------XX---------------------------------------------------------------------------------------------------------XXXX----------------------------------------------------------XXX-XXX---XX-oo---------------------------------------------------------------E-------------------[]----------S--XXXXXX--------------------------[]----------------------------------------------------------------------------S--E----------------------------------------------oooo--------------------------------------------------------------------------------------------------------------Eo-----------------------------XX-----------------------------------------------------------------------------E-------------------------------------------------------------------------------------------------------------------------------------------------------------------------------------------------------X------------------------------------------------------------------------------------------SS-----------E----------------------------------------------------------<>-------S----S-------------------------------------------------------------E-------------------------------------------------------XXXXX---------------------------------------------------------------------------------------------
--SSSSSS-----------------E---SSSSSS--------E------------XXXX-----------------------------------------------------------E--------------------------------------------------------------------------------------------------------?-SoS-------------[]---------XX---------------------E------------------------------------------------------E-----------o---------------XX-X----------------------------------------------------------------------------------------------------------------------------E--------E---------XXX-----------[]------------------------------------o--------[]--------------------------------------------o----------------------------------------------------Q-------XXS-----------------------------------ooo----------------------------E-----S------S------------------------E--------------------------------------------o-------------S-------------------------o------------------------------------------------E--<>-----SQSQS------------S-SQ---------------------------------------------oo---------------------------------------------------------------------X------------------E-------E-----------E-----E----------XX-----------------------------------------------------E---XX--------------------------ooQ--SS----------<>----------------------------E-----------------------------[]--o--X-So?-------------------------------------E--SSSSSSSS--E----E-------<>------E-------------------------S------------E---------XXXXX------------------------------------------------E--------------------------------------------
------------S-----------<>----------------<>---------E-----------------------S-----------oQQo-------------------S-----<>---------SQQQQ---------S?S----------X--X-----------SSSS----XX--X-------------------o----------------------SSS--------E--SS[]---------XX------?SSQSQS----E--<>-----SSS--------------S-S------QQQQ--QQQ------E---E--<>--------------------------XXX-XX-------QQSQQQQ--------------S--E-----------------------------------------------------------------------S--SSSSS-----------<>----E--<>-----------------XXXX--XXXXX-------SSS----------------------E---------XXS---------XXX---------------------------------------SS--------------------X--SSS----------------------------------S---XXXX--SSS--------------E----------SSSSSSS--------------<>------------S--QQQ---QQQQ------E----<>-------------XX---XXXX--XXXX--QQ--------------------------S---Q-Q--SSQS----S----E-----Q--QQQ--------------SSQQQ---------QQQSSQS----E<>--[]-E-----------------------------X--Q---S?S-------------------SSS----------------------------------------Q--Q---------QQ------------<>--------XXXX-----Q--Q--Q------------<>-----E----<>----<>---------XXX---------------------X-----------Q--Q--SS-----------<>---XX---S----S?SQS--------------SS--SSS-S-------[]-------------E--------E----<>-----S-QQ--Q-QQQQSQQ---------[]---S---SSS--S------QQQQ-----------------------<>------------XS--S?S------[]-----<>----S?--------------------S-oo--S-o--<>-----E---XXXXX------------E------------------------------S---<>------------------SSS--------S----X---------
------------------------[]----------------[]--------<>---------E-----------------------------------E------------------[]---------------------------------XX-X--X------------------XXX--XX---------------------------------------------------<>----[]---------XX----------------<>--[]-------------XXX----------------------------E<>--<>--[]-------E-----------------XXXX-XX------------------------------<>--------------------------------------------------E----------X-------------E--------------[]---<>--[]------------------------------------------------E---------XXXXX----------------------------------------------------------------------------------XX--------------X--------------------------------------------------<>-------------------------------[]-----------X------------------------[]----------------------------------------------------------S--------------------<>------------------------------------------------E<>[]--[]<>----------------------------XX-----------------------XXXXX-----------------XXX---------------E----------------------------------[]-------EXXXX----------------X-------[]----<>----[]----[]-------EXXXX---------------------X------------------------------[]---XX-------------------------------------------[]------------<>-------<>----[]-----------------------------[]-----------------------------E----------------[]-------------------------[]-----[]-------------------------EE-E--------[]----<>-XXXXXXX-----------<>----------------------------------[]------E---------------------E--E------------
------------------------[]----------------[]--------[]--------<>----X----------------------------------X--------------[]--------------------------------XXX----X-----------------XXXX--XXXX-------------------------------------------------[]----[]----<>---XX----------------[]--[]------------XXXX--X------------------------<>[]--[]--[]------------------------XXXXX-XX------------------------------[]--------------------------------------E----------<>----------X----------------------------[]---[]--[]-----------------------------------------------<>-----------------------------------------X-----------------------------------------------------XXX-----------------------------------------------------------------[]-------------------------------[]-----------XS-----------------------[]----------------------------------------------------------S--------------------[]--------------------X--------------------------<>[][]--[][]---------------X-----------XXX--------------------------------------------------------------------------------------------------[]------XXXXXX----------------X-------[]----[]----[]----[]------XXXXXX---------------------X-X---------------------<>-----[]---XX-------------------------------------------[]------------[]-------[]----[]-----------------------------[]----------------------<>----<>----------------[]-------------------------[]-----[]-------------------------------------[]----[]-XXXXXXX--------X--[]----------------------------------[]-----<>-------------------------------------
-----------------EE-----[]----------------[]--------[]--------[]---XXXX--------------------------------X---E-E----E---[]-----------------E------------XXX---X--X---E------E-----XXXXX--XXXX--------------------------------------EE---------[]-E--[]----[]---XX-------------E--[]--[]-----------XXXXXE-X------------E-----------[][]--[]--[]-------------------E---XXXXXX-XX----------------E-------------[]-------------------------------------------------[]-----E----X---------------------EE--E--[]---[]--[]--------------ooo------------------------------[]-----------------------------------------X-----------------------------E-E-----E-EE-----------XXXX--E-----X--X-----------------------------------------------EE-E--[]------------------E-E-------E--[]-----------X---E--------------------[]---------------ooo----------XX----E-----------------------S------EE------E-----[]------------------E-X-------------E----------E-[][][]--[][]-----------E--XX---------S--XX--------------------------------------------------------------------------------------------------[]-----XXXXXX-------------E---X-----E-[]----[]----[]----[]-----XXXXXXX---------------E--EE-X----E------------------[]--E--[]-E-XX---------E----------------E---------E-E----[]------------[]-------[]----[]-------------------------E---[]----------------------[]--E-[]----------------[]-------------------------[]--E--[]-E------E---------EE--------------E--[]----[]--XXXXXX-------XX--[]----------E-EE-E-------------E-E--[]-----[]---E-EEE--------------E----------E---
XXXXXXXXXXXXXXXXXXXXXXXXXXXXXXXXXXXXXXXXXXXXXXXXXXXXXXX-XXXXXXXXXXXX-X-------XXXXXXXXXXXXXXXXXXXX----X-XXXXXXXXXXXXXXXXXXXXXXXXXX-XXXXXXXXXXXXXXXXXXXXXXXX--XXXXXXXXXXXXXXXXXXXXXXXXX--XXXXXXXXXXXXX---XXXXXXXX-XXXXXXX----XXXXXXXXXXXXXXXXXXXXXXXXXXXXXXXXXXXXXXXXXXXXXXXXXXXXXXXXXXX-X--XXXXXXXXXXXXXXXXXXXXXXXXXXXXXXXXXXXXXXXXXXXXXXXXXXXXXXX---XX-X-X-XX-X-XXXXXXXX--XXX---XXXXXXXXXXXXXXXXXXXXXXXXXXXXXXXXXXXXXXXXX-XXXXXX---------------XX---XXXXXXXXXXXXXXXXXXXXXXXXXXXXXXXXXXXXXXXXXXXXXXXXXXXXXXXXXXXXXXXXXXXX-------XXX-------------XXXXX-----XXXXXXXXXXX--XXXX----------------------------XXXXXXXXXX------X-XXXXX---XX----XXXXXXXXXXXXXXXXXXXXXXXXXXXXXXXXXXXXXXXXXXXXXXXXXXXXXXXXXXXXXXXXXXXX-----------XXXXXXXXXXXXXXXXXXXXXXXXXXXXXXXXXXXXXXXXXXXXXXXXXXXXXXXXXXXXX-XXXXXXXXXXXXXX---XXXXXXXXXXXX------XXX----XXX------------XXXXXXXXXXXXXXXXXXXXXXXXXXX-XXXXXXXXXXXXXXXXXXXX-XXXXXXXXXXXXXXXXXXXXXXXXXXXXXXXX---XXXXXXXXXXXXXXXXXXXXX-XXXXXXXXXXXXXXXXXXXXXXX----XXXXXSX-XXXXXXXXXXXXXXXX--XXXX-----XXXXXXXXXXXXXXXX----XXXXXXXX--XXXXXXXXXXXXX--X---XXXXXXXXXXXXXXXXXXXXXXXXXXXXXXXXXX-XXXXXXXXXXXXXXXXXXXXXXXXXXXXXXXXXXXXXXXXXXXXXXXXXXXXXXX-XXXXXXXXXXXXXXXXXXXXXXXXXXXXXXXXXXXXXXXXXXXXXXXXXXXXXXXXXXXXXXXXXXXXXXXXXXXXXXXXXXXXXXXXXXXXXXXXXXXXXXXXXXXXXXXXXXXXXXXXXXXXXXXXXXXXXXXXXXXXXXXXXXXXXXXXXXXXXXXXXXXXXXXXXXXXXXXXXXXXXXXXXXXXXXXXXXXXXXXXXXXXXXXXXXXXXXXX-XXXXXXXXXXXXXXXXXXXXXXXXXXXXXXXXXXXXXXXXXXXXXXXXXXXXXXXXXXXXXXXXXXXXXXXXXXXXXXXXXXXXXXXXXXXXXXXXXXXXXXXXXXXXXXXXXXXXXXXXXXXXXXXXXXXXXXXXXXXXXXXXXXXXXXXX--XXXXXXXXXXXXXXXXXXXXX