------------------------------------------------------------------------------------------------------------------------------------------------------------------------------------------------------------------------------------------------------------------------------------------------------------------------------------------------------------------------------------------------------------------------------------------------------------------------------------------------------------------------------------------------------------------------------------------------------------------------------------------------------------------------------------------------------------------------------------------------------------------------------------------------------------------------------------------------------------------------------------------------------------------------------------------------------------------------------------------------------------------------------------------------------------------------------------------------------------------------------------------------------------------------------------------------------------------------------------------------------------------------------------------------------------------------------------------------------------------------------------------------------------------------------------------------------------------------------------------------------------------------------------------------------------------------
-----------------------------------------------------------------------------------------------------------------------------------------------------------------------------------------------------------------------------------------------------------------------------------------------------------------------------------------------------------------------------------------------------------------------------------------------------------------------------------------------------------------------------------------------------------------------------------------------------------------------------------------------------------------------------------------------------------------------------------------------------------------------------------------------------------------------------------------------------------------------------------------------------------------------------------------------------------------------------------------------------------------------------------------------------------------------------------------------------------------------------------------------------------------?------------------------------------------------------------------------------------------------------------------------------------------------------------------------------------------------------------------------------------------------------------------------------------------------------------------------------------------------------------------------------------------------------
-------------------------------------------------------------------------------------------------------------------------------------------------------------------------------------------------------S--------E-----------------------------------------------------------------------------------------------------------------------------------------------------------------------------------------------------------------------------------------------------------------------------------------------------------------------------------o------------------oo---------------------------------------------------------------------------------------------------------------------------------------------------------------------------------------------------------------------------------------------------------------------------------------------------------------------------------------------------------------------------------------------------------------------------------------------------------------------------------------------------------------------------------------------------------------------------------------------------------------------------------------------------------------------------S--------S----------------------------------------------------------------------------------------------------------------------------------------------------------------------------------------------------------------------SSSSSSSSSSSSSSS?S?SSSSSSSSSS---------------------------------------o----------------
--------------------------------------------------------------------------------------------------XX----------X---------------------------------------------------------------------------------------SSSS---Q-------S?-------oS--------------------------------------------------------------------------------------------------------------------------------------------------------------------------------o-------------------------------------X-X--------------------------------------------------------------------------------------------------------------XX----------------------------------------------------------------------------------------------------------------------------------------------------------------------------------------------------------------------------------------------------------------------------------------------------------------------------------------------------oo-------------------------------------------------------------------------------------------------------------------------------------------------------------------------------------------------------------E---E---------------o-oS-------------------------------------------------------S-------------------o-------------------------------------------------------------------------------------------------------------------------------------------------------------------------------------------------------------------------------------SSS----------------------SS-------------------------------------------E--E---------
--------------------------------------------------------------------------------------------------------------------------------------------------------------------------oo--oo----------------------SSSS--E--------S---------S----------------------------------------------------------------------------------------------------------------------------------------------------------------------------------------------------------------------------------------------------------------------------------------------------------------------------oo--oo-----------o-----------------------------------------------------------------------------------------------------------------------------------------------------------------------------------------------oooo----------------------------------------------------------------------ooXXX---------------------------E---------------------------------------------------------------------------------------------------------------------------------------------------------------------------------------------------------------------------------------------------XXXXXXX------------------------------------------E-----------------------E---------E-----------E-----------------------------------------------------------------------------------------------------------------------------------------------------------------------------------------------------------------------------------------SSSS-----------------------------------------oo--oo------Eooo---------XXXXXX--------
------------------------S-----------------------XXX-------------------------------------XX--------------------X?-----S------------------------------------------------------------------------------------SSS?----------SS--SSS----------------------------S---SQS-S---QQ-------------------------?SSS--SSSS------------------------SSSS------------------------SSS------------------??SSS--------------------o--XXXX-----oo--------SSSSS---SQS---------------------------------------Q-Q------------------------------------------S-----SS---------oo-------------------------------------------------------------------------------------------------------------------------------E--------------------------------------------------E----X------------------------------XXXXX-------SS----------QSQ--?--------S---SS??--SSS------S----------------------------------SSSSS---------SSSSSSSSSS-----S---------------S---SSS---S---?----------------------------------------SS--------------------SQS---------------SS-?-------------------------------------E-XX--------------------?SSS--------------S-----------------------------------------------------------S---Q-------------------SSS--SQSS----------------SS--------SS-?------SSQ--SSS---S-----------------S---SSS-------------------SSSSSSSSSSSSS-----------Q-------------------------------SSS-------SSS---SS---------SSSS------SSSS---------------SSSS--------S----------------------------SSS--------------------------S----------ooooooo-------o--------------------X---------XXXXX----------------------
-----------------------------------------------------------------------------------------------------o---o---------------------------------------------------------------------o--o---o--------oo----------SS-----------SS----------------------------------------------------------------------------------------------------------------------------------------------------------------------------------XXX---------------------------------------------------------E-----------------------------------------------------------------------------------------------------------------------------------------------------------------E-----------------------------------------<>-------------------------------------X-----------<>---------------o--------E----------------------------------------------------SS--------------------------E--------XXXXXX-----------------------------------E--------------------------X------------------------------------------------------------E-----------------------------Qooo---------------------------------XX-------E--o-----------------------------------------------------------E-------------oo-------------------------------------SS----------------------SS--------SS-----------------------------------------SS----------------------------------------------------------------------------------------------------------------------------------------------------------------------------------------------------------S------------------------------------------SSS---------E-----------------------o---
--------------------------o-------------------------------------------------------------------------XXX-XXX-------------------------------------------------------------------XXXXXX-XXX------------------SSS-----------SS--S-S------<>---------------------------------------------------------------------------------------------------------------------------E----------------------------------------------------------------------------------------XXXXX-------<>-------------------------------------------------------------------------------------------------------------------------------------------------------------------------------------XSSS-o----------------[]-------------------------------------X-------<>--[]-----------------------------------------------------------------------------SS-----------------------XX--------------------------------------------------------------------------X-------------------------------------------------------------------------------------------------------------------------XXX---------------XXXXX--------------------------------------------------------XXXXXXXX------------------X--------S------S--------E----SS----------------------SS--------SS-------------S---------------------------SS----------------------------------------------------------------------------------------------------------------------------------------------------------------------------X----------------------------------------SSSSSSS------------------------XX---------------------------------------
-------------S-E-------E-------o------ooo------------------------------------E----------------------------------------------------------E---X-----------------------------------------X-----------XX--oooooSS--------o?-SS--QoS------[]-------------E-----------o--------------------------------------------------X-S-------------------------X------------------------------------------------SS-------------------------XXX-----------------------------------ooo---[]-o-------------------------------------------------------------------------XXXX----------------S------------------------------------------------------------E---S-------------------XX--S------------------[]--SSSSSSSS-----------------------S---X-------[]--[]-----------E----------------XXXXX---------------------------------------------S-------------------------------------------XXXX---------------------------------------------------XS---X---------------E----------------------------------------------------------------E-------E----------------------X-----------------------------------------------------E-----------------E---------E---------------------------XXS-------SoS---o-----E--<>----SS----------------S-----SS----ooo-SS-------------SS-----------------------??-SS--E-----------E---------------------E--------------------------------------------------------------------------------------------------------------------------------------XX-----------------------------------------SSS-SQ---------o---oo---------XXS--S----------------XXXXX--------------
----o-------XXXXX-XX--SSSS------------------XXXX--XSS-----------------------<>---------XX---------------------------X-------SQQQ-------<>----------------X-------------XXX------------------XXXXX------SSSSSS-S------S--SS--SSS----SS[]-S---E------<>----E-S---SQS-QQQ--QSQQ--------E-----------------------------XX---------------E----------XX----------------S?S---QQ-------Q?Q--Q------E-------------------XXXXXXXXXX----------------XXX--XXXXXXXX-----------------XX?------E-XXX-------------------S---------------Q-QQ--Q--------E---------------------XXX-------------------------------S-----------------Q---------S--------<>--------------S----X--XXX--SS----------E------------------------S---------------XX--XX-------[]--XXS---------<>------EEEE-EE---------XXXXX--------S---SSS----Q-QQ--Q-----Q--SS--SSS-----------------XX---------XXXX---------------oSSSSSSSSSSSSSSSSS-SSSSSSS-------SS--------------XXX-XXXoQoQ----------<>------------------------------------------E---S---SS----E---E--<>---o--<>----------S----------XX-XXXX------------------X------------QQ-Q---S--------<>-----Q-S--------<>---E----<>--------------------------XXXX-------SSS--SSS---<>--[]----SS--S?SS---------X--X---SSSS--SSSSSS--S--------------------------E------QQ?--S----SX---E----<>----E?SSS-----------<>------------------E----------<>-------SSS---------E-----------<>---S----------------------------SSS--------S-------------------------XXX----------------------------SSSS----X---------S-----------------------XXXX----------XXX-------------------------
-----------XXX-XXXXX--------------------------------------------------E-----[]-----------------------XXX------------X------------------[]--X-----E-------X------------XX---XXXXXX------------------------------------------E---------[]----<>------[]------------------------------------------------------------XXX--------------<>---------XXX------------------------------------------<>--------------------------------------------------------------------------------E--<>--------------------------E---------E----------------<>-------E-------------------------------------------E------E---------------------------E-----[]-------------------?-XXXX----S--------<>---------------------------------------XXX-XXX-------[]-------E------[]---XXXXXXXXXXXXXXX----------XXX-----------------------------------------------------EXX-----------------------------SSSSSSSSSSSSSSSSS------------------------------XXXX-XXX--------------[]-----------------------------------------<>-----E------<>--<>--[]------[]------E------E------XXX----------------------------------------------------[]----------------[]--<>----[]------------------------EXXXXX------------------[]--[]---------------------X--XX----SS------------------------------------<>--------------E-----<>----[]------E----------X--[]-----------------<>----------[]-------------------E-----------[]--------------------------------------------------------------------XXXX---------------------------------E--X------------------X------------XXXXXX--------XX----------------------------
S--------XXXXX--X-XXX---------------------------------o--------------<>-----[]------------XXXXX---------------------X------------------[]--X----<>-------X-----------XXX-------------------------------------------------------------[]----[]------[]--------------------------------------------------X--------XXXX--------------[]--------XXXX------------------------------------------[]-------------------------------------------------------------------------------<>--[]-------------------------<>--------<>----------------[]------<>-------------------------------------------E-----<>--------------------------<>-----[]-------------------XXXXXX---SS--------[]--------------------------------------XXXX-XXX-------[]------<>------[]--XX----------------------------------------------------------------------X--------XXXX----------------------------SSSSSSSSSSSSSSSSSS------------------<>---------XXXXX-XXX--------------[]-----------------------------------------[]------------[]--[]--[]------[]-----<>-----<>--<>-XXXX-------XX-------------------------------------------[]----------------[]--[]----[]-----------------------XXXXXXXX-----------------[]--[]---------------------X--XXX---SS---------------X--------------------[]--------------------[]----[]-----------------X--[]-----------------[]----------[]------------------<>-----------[]----------------------------------------------->-------------------XXXXX---X--------------------------------X------------------X------------XXXXXX-------XXX-------o--------------------
S------XXXXXXX--X-XXX--------------------ooo----------XX-------------[]-----[]-E------------------------------EEEE--X------E-------E---[]--X----[]-------X-------EE-XXXX-------------------------------E------------------E-------E--[]----[]------[]------------E-E-----------E-----------E-------E---X--X----XXXXX------E-EE-E--[]-------XXXXX---------E-------------------E------------[]-------------------------------------------------------------------------------[]--[]-------------------------[]--------[]--------EE------[]------[]---X------X------------------------EE-E--------E-[]-----XX------E----------E-[]-----[]----------EE---E---XXXXXX---SS-EE-E---[]-------------------------------------XXXX--XXXX------[]------[]--E-E-[]----------------------------------------------------EE----X-------------E-X-------XXXXX----------------------------SSSSSSSSSSSSSSSSSS----------EE------[]-E--E---XXXXXX-XXX-----------E--[]---------------EE--------------E-EE------[]------------[]--[]--[]---E--[]---E-[]---E-[]--[]XXXXX-------------------------------E-E----------------E-[]---E---------E--[]--[]----[]---------------------XXXXXXXXX------E--------E--[]--[]----E-EE---------E---X--XXX--E---E-E-------E-E-X---E---------E-EE---[]-------E-E-E-----X--[]E---[]-E-E-------------X--[]-E-EE-----E-E----[]----------[]------------------[]----E-EE---[]---------EE-E------------------E-----------X-X[]------------------XXXXXXEE-X--------------------------------X------------------X-----------XXXXXXX-SS?SSXXXX------XXX-----------------o-
XXXXXXXXXXXXXX---XXXXXXXXXXXXXX--XXXX----XXX-----E-XX---XXXXX-X-XXXXXXXXXXXXXXXXXXXX----------------------XXXXXXXXXXXXXXXXXXXXXXXXXXXXXXXX-XXXXXXXXXXXXXXX---XXXXXXXXXXX----------------------------XXXXXXXXXXXXXXXXXXXXXXXXXXXXXXXXXXXXXXXXXXXXXXXXXXXXXXXXXXXXXXXXXXXXXXXXXXXXXXXXXXXXXXXXXXXXXXXXXXXXXXXXXXXXXXXXXXXXXXXXXXXXXXXXXXXXXXXXXXXXXXXXXXXXXXXXX---XXXXXXXXX---XXXXXXXXXXXXXXXXXXXXXXXXXX-X-----------------------XXXXXXXXX-------------------XXXXXXXX--XXXXX-XXXXXXXXXXXXXXXX---XXXXXXXXXXXXXXXXXXXXXXXXXXXXXXXXXXXXXXXXXXXXXXXXXXXX-XXXXX---------XXXX---XXX-----XXXXXXXXXXXXXXXXXXXXXXXXXXXXXXXXXXXXXXXXXXXXXXXXXXXXXXXX--X-XXXXXXXXXXXXXXXXXXX--SSXXXXXXXXXXXXXXXXXXXXXXXXXXXXX-XXXXXXXXXXXX---XXXXXXX--XXXXXXXXXXXXXXXXXXXXXXXXXXXXXXX----------------------------XXXXXXXXXXXXXXXXXXXXXXXXXXXXXXXXXXXXXXXXXXXXXXXXXXXXXXXX---XX--XXX------------------XXXXXXXXXXXXXXXXXXX-XXXXXXXXXXXXXXXXXXXXXXXXXXXXXXX--SSXXXXXXXXXXXXXXXXXXXXXXXXXXX-XXXXXXXXXXXXXXXXXXXXXXXXXXXXXXXXXXXXXXXXXXXXXXX-XXXXXXXXXXXXXXXXXXXXXXXXXXXXXXXXXXXXX----------------------------XXXXXXXXXXXXXXXXXXXXXXXXXXXXXXXXXXXXXXXXXXXXX-XXXXXXXXX-----XXXX-X-XXXX--XXXXXXXXXXXXXXXXXXXXXXXXXXXX-XXX-XXXXXXXXXXXXXXXXX-XXXX-XXXXXXXXXXXXXXXXXXXXXXXXXXXXXXXXXXXXXXXXXXXXXXXXXXXXXXXXXXXXXXXXXXXXXXXXXXXXXXXXXXXXXXXXXXXXXXXXXXXXXXXXXXXXXXXXXXXXXXXXXXXXXXXXXXXXXXXXXXXXXXXXXXXXXXXXXXXXXXXXXXXXXXXXXXXXXXXXXXX--XXXXXXXXXXXXXXXXXXXXXXXXXXXXXXXXXXXXXXXXXX--XXXXXXXXXXXXXXXXXXXXXXXXX-XXXXX--XXXXXXXXXXXXXXXX----XXXXXXXXXXXXXXXXX--XXXXXXXXXXX-----ESXSS--------------------------X--