------------------------------------------------------------------------------------------------------------------------------------------------------------------------------------------------------------------------------------------------------------------------------------------------------------------------------------------------------------------------------------------------------------------------------------------------------------------------------------------------------------------------------------------------------------------------------------------------------------------------------------------------------------------------------------------------------------------------------------------------------------------------------------------------------------------------------------------------------------------------------------------------------------------------------------------------------------------------------------------------------------------------------------------------------------------------------------------------------------------------------------------------------------------------------------------------------------------------------------------------------------------------------------------------------------------------------------------------------------------------------------------------------------------------------------------------------------------------------------------------------------------------------------------------------------------------
-----------------------------------------------------------------------------------------------------------------------------------------------------------------------------------------------------------------------------------------------------------------------------------------------------------------------------------------------------------------------------------------------------------------------------------------------------------------------------------------------------------------------------------------------------------------------------------------------------------------------------------------------------------------------------------------------------------------------------------------------------------------------------------------------------------------------------------------------------------------------------------------------------?------------------------------------------------------------------------------------------------------------------------------------------------------------------------------------------------------------------------------------------------------------------------------------------------------------------------------------------------------------------------------------------------------------------------------------------------------------------------------------------------------------------------------------------------------------------------------------------------------------------------------------------------------------------
--------------------------------------------------------------------------------------------------------------------------------------------SSSSSSSSSSSSSSSSSSSSSSSSSSSS------------------------------------------------------------------------------------o-------------------------------------------------------SSSSSSSSSSSSSSSSSSSSS---------------------------------------------------------------------------------------------------------------------------------------------------------------------------------------------------------------------------------------------------------------------------------------------------------------------------------------------------------------------------------------------------------------SSSSSSSSSSSSSSSSSSSSSSSSSSSS---------------------------------------------------------------------------------------S---------------------------------------------------------------------------------------------------------------------------------------------o--------------------------------------------------SSSSSSSSSSSSSSSSSSSSSSSSSSSS------------------------------------------------------------------------------------------------------------------------------------------------------------------------------------------------------------------------------------------------------------------------------------------------------------------------------------------------------------------------------------------------------------oo--------------------------------------------------
--------------------------------------------------------------------------------------------------------------------------------------------S--SSSS--SS-----------------------------------------------------------------------------------------------------------------------------------------------------------------------------------------------------------------------------------------------------XX---------------------------------------------------------------------------------------------------------------------------------------------------------------------------------------------------------------------------------------------------------------------------------------------------------------------------------------------------------------------------XX-------------------------------------------------------------------------------SSS--------------------------S----------------------------------------------------------------------------------------------------------------XXXX------------------------------------------------SSSSSSSSSSSSSSSSSSS-----------------------------------------o--------------------------------------------------------------------------------------------------------------------------------------------------------------------------------------------------------------------------------------------------------------------------------------------------------------------------------------------------------------------------XXXX-------------------------------------------------
-----------------------------------------------------------------------------------------------------------------------------------------------SSSS--SS-----------------XXX-------------------------------------------------------------------------------------------------------oooo----------------------------------------------------------------------------------------------------------------------------------------------------------------------------------------------------------------------------------------------------------------------------------------------------------------------------------------Eooo----------------------------------------------------------------------------------------------------------------------------------------------------------------------------------------------------------------------------------------SSS---E---------------------S-----------------------------------------------------------------------------------------------------XXX-------------------------------------------------------------SSSSSSSSSSSSSSSSSSS---------------------ooooo---------------------------------------------------------------------------------------------------------------------------------------------------------------------------------------------------------------------------------------------------??------------------------------------------------------------------------------------------------------------------------------------------------------------------------------------------
-S-------------------------S---SSSQS---SS-----------------------------------------------------------------------SS--------------SSSSSS---SSSS---SSS--------------------o-----------QQQ-------------?-----------------SSS-------S-QQQQ----------------------------------------E----XXXX----------SSSSS----E------------------------------------E-Q----------------------?SSSS----------------------------------S--------------------------------------------S---S--------------------------------------------------------------------------------------------------------------------------------------------------------------XXXXX---------------------------------------------QQQQQSS--?------SSQS-------SSSSSSS---------------SSSSS-------------------------------------------------?-----------------------S----S----------------Q-QQ------------E--E-----------------S----SS?-------S----------------SS---------S---------S--------------------XXQ--QS-SSSS---------------------------XXX-------------------------------------------------S----------------------------SSSSSSSSSSSSSSSSSSo---Q-----S--------XX-------------------SSS-S---------------------------SSS-------------------------------------o---------?SSSS-------S-----XXX--------------------------------------------------------------------------------------------SS---S-------------------------SQS---?------------------------------------------------------------------XXX--------S----SSSS-------------------------SS-----SSSSS---------------------------------S-----------S---SSS----------
------oooo-----------------------------------------------------------------------------------------------------------------------------------------------------------------------------------------Q---------------------------X--------------------------------------------<>---------------------------------------------------------------<>--------------------------------------------------------------------------------------------------------------------------------------------------------------------------------------------------------------------------------------------------------------------------------------XX-----------------------------------E---------------------------------------------------------------------------------------------------------------Qooo------------------------------------------------------------XX--------------S----SS-------------------------------o-o-----------XX---------------------------------------------oo--------------------------------------------------------------S----------------------------------------------[]-----------------------------------------------------------------------------------------------------------X--------------------------------XXX----------------o------------------------------------------------------ooo--------------------------------------------------------------------------------------------------------------------------XXX------------------------------------------------------------------------------------E-------------------------------
-------------------------------S--------------------------------------E------------------------------------------------------------------------------------------------S----------------------------------------------------------------------------------------------------[]---------------------------------------------------------------[]-----------------------------------------------------E--------------------------------------------------------------------------------------------------------------------------------------------------------------------------------------------------------------------------------------------------------------------<>------------------------------------------------------------------------------------------------------------------------------------X----------------------------------------------------------S----SS--------------------------------------------XXX----------------------------------------------------------------------------------------------------------XSSS-o----------------------------S---------S-----[]--------------------------------------------------------------------------------------------------------------------------------------------XXX-----------------------------------------------------------------------------------------------------------------XS-------------------------------------------------------------------------------XXXXX----------------------------------------------------------------------------------X-SS-Q----------------------------
----E---------------------XX-----------E--------------------E--S----ooo-----------E--------------------------oo----------------------------------------------------oo-------------------E-------E--o-----------------------S---X-----------oo------------------X-----------SXXX---------------------------------SSSS------------ooo-----E-------------------------------------------E-----------E--<>------------------E---------------------------------------------------E-----------oo----------------------------E--------------------------------o---------------------------------------E------------------oo------------------------------------------------------[]--------------------------------------------------------------------------------------------oo---------------E----------------------X----------------------------------------------SSSS------X--ooooSS-----------------------------E-----------XX---X-ooo------ooo--------------------------------------------------------------------oo----------------------XXS-S---------------------------------------ES-----[]----------SSSSSS---------------------------------------------------------------------------------------------------------------------E-EE-E-XXX---------------------------S----------------------XXX-------oo--------------------------E------------------------XX---------------------------------oo------------------XX------------------------XXXXX--------------------------E--------E-------------------------S-------------------XX--S-----------------------------X
o--<>--------------------XXX---S?S----<>-----------S----E--<>-----E-------------E?S----E----<>-------X--XX------Qo-------------------SQS-------------S-----SS-----SSSSSS-XX---S----SS--<>------<>-------------------------XX-XXX??S?Q------------------Q------------------------XXXXXXX----E?-Q-?SSS-----E--------------------E--------<>-----ES-S--------E-------------S----------<>-------E--<>--[]---------S-------<>--------------------------------------SS----------<>-------------------E-------------E------<>---Q-----------------------XXX---------------------------X-----E-------<>-----E---------------------XXXX--XXX------------------------------------SS[]--Q--QQQQ--QQQQ------E?QQQ--QQQ--Q--QQ---------------XXXX--------------------QQ-----------------------XS----<>----------S---------XXX-------------E-QQQQ?-QQQQ----------------------------------SSSSSS-S-----QQQ-------S-------SSS<>-----------XX-XXX---------------------S?SQSSS------XXXXXXX---------------------------------------------------------------XXXX-SSS----------------------------SSSSSSSSSSSSSE--[]--------E-----------XXX---------------Q-----SS---------------------------------------------------------S-----XX---XXX--------------------XX-XXX---------------------<>---------------------------------------------------------E------<>--Q---S?SSS------------XXX--------S?X-------------<>------------------------XXXXX----------XXX----------XXXXXX-------QQQ---Q----E------<>--E----<>------QQ----S-----------------------S----X--XXX-SSSS--------------E-----------XX
---[]-------------------EXXX----------[]----------------X--[]----<>-------------------<>----[]-------X--XX-------------------------------------------S-S---SSSSX--------XX------E------[]------[]----------------------E-XXX-XXX------------------------------------------------------------------------<>----------------E--<>--------[]----<>-----E----<>-X----------------------[]---E--<>--[]--[]-----------------[]-----------S--------------------------E-----------[]------E-----------<>-----E------<>------[]--------------------------XXXX---------------------X---XXX----<>-------[]----<>-----------E---------------------EX---------------------------------[]--------------------------------------------E--------------------------------------------------------XXX----[]-------------------EXXX------------<>-------------------------------------------------------------------------------[]----------XXX-XXXX---------------------------------------------------------XXXXXXXX-?-----------------------------------XXXXX-SSS------------------------E---SSSSSSSSSSSSSSS-[]-------------------------E----SS-------------------------------------------------------E-----------E-------------------------X-----------XX-XXX---------------------[]--E---------X-------------------------------------------<>------[]----------------------XXXX------------------E-----[]-----------------------XXXXXX----------------------XXXXXXX-----------------<>---E--[]-<>----[]-----------------------------------------Q-XXXX--SSS-------------<>----------XXX
---[]----<>-----------EXXXXX----------[]----------------X--[]----[]--------<>----X----[]----[]-------X--XXX----------------X-----------------------S-S-S---SSSS---------XXX------------[]------[]--X-------------------XXXXX-XXX------------------------------------------------------------------------[]---------------<>--[]--------[]----[]-Q--<>----[]-X----------------------[]--<>--[]--[]--[]--X--------------[]-----------S--------------------------------------[]-----<>-----------[]----<>------[]------[]-------------------------XXXXX--------------------XX---XXX----[]-------[]----[]-E--------<>--------------------<>X-----------------------------------------------------<>-----------------------<>-------------------------------------------------------XXXX----[]-----------------EXXXXX------------[]-------------------------------------------------------------------------------[]--------XXXXX-XXXX-----------------------------------------<>----------------------------------------------------------XXXXXX-SSS-----------------------<>---SSSSSSSSSSSSSSS-[]------------------------<>----SS------------------------------------------------------<>----------<>-------------------------X-----------X--XXX---------------------[]-<>-----------------------------------------------------[]------[]---------------------XXXXX-----------------<>-----[]---------------------XXXXXXXX---------------------XXXXXXXX-----------------[]--<>--[]-[]----[]-----------------------------------------XXXXXX--SSSE------------[]---------XXXX
E--[]----[]E----------XXXXXX----------[]---------EE-EEE-X--[]----[]--------[]----X----[]----[]-E-EE--X--XXX-----E----------E-E-----E------XX------------o-ESSSS------E--XXX--------E---[]--E---[]--X---------E-E-E-E-E-XXXX--XXX------------------------------------------------------------------------[]------------E--[]--[]--------[]----[]----[]----[]-X--------EE---XX-------[]--[]--[]--[]--[]--X---E-------E--[]-----------S---E-EE----E----------------------E-E-[]-----[]---E-E-----[]----[]-E-E--[]---E--[]-------------E----------XXXXXX--------EE-----------X---XXX----[]-------[]----[][]--------[]--------------------[]X------E-E-------E-------E-E-----X-------E---E-E------[]-----------------------[]------------------------------------------------------XXXXX-E--[]-E-EE-E--EE------XXXXXX-E----------[]-------E-----------------------------------------------E-----E-EE-E---E-EE-----[]----E---XXXXX--XXX-----------------------------------------[]----------------------------------------E-E--EE-E-----EE-XXXXXXX-SSSE-----------------E----[]---SSSSSSSSSSSSS---[]------------------------[]----SS------E-----------------------------------------------[]-E-EE-----[]----------------------E--X--------------XXX------X--------------[]-[]-----------------------------------------------E-----[]------[]--E-----------------XXXXXX-----------------[]-----[]-E-EE----------------XXXXXXXX--------------------XXXXXXXXX-------E---------[]--[]--[]-[]---E[]----E-EE------------E-----------EE-E--E--XXXXXX--SSS------E-EE---[]--------XXXXX
XXXXXXXXXXXXXXXXXXXXXXXXXXXXXXXXXXXXXXXXXXXXXXXXXXXXXXXXXX-XXXXXXXXXXXXXXXXXXXXXXXXXXXXXXXXXXXXXXXXXXX--XXXXXXXXXXXXXXXXXXXXXXXXXXXXXXXXXXXXXXX-------XXXXXXXXX--XXXXXXXXXXXXXXXXXXXXXXXXXXXXXXXXX-XX-XXXXXXXXXXXXXXXXXXXXX--XXXXXXXXXXXXXXXX-XXXXXXXXXXX---XXX--XXXX-------------------XXXXXXXXXXXXXXXXXXXXXXXXXXXXXXXXXXXXXXXXXXXXXXXXXXXXXXXXXXXXXXXXXXXXXXXXXXXXXXXXXXXXXXXXXXXXXXXXXXXXXX-XX--XXXXXXXXXXXXXXXXXXXXXXXXXXXXXXX-XXXXXXXXXXXXXXXXXXXXXXXXXXXXXXXXXXXXXXXXXXXXXXXXXXXXXXXXXXXXXXXXXXXXXXXXXXXXXXXXXXXXXXXXXXXXXXXXXXXXXXXXXXXXXXXXX----XX-XXXXXXXXXXXXXXXXXXXXXXXXXXXXXXXXXXXXXXXXXXXXXXX--XXXXXXXXXXXXXX--------XXXXXXXXXXXXXXXXXXXXXXXXXXXXXXXXXXXXXXXXXXXXXXXXXXXXXXXXXXXXXXXXXXXXXXXXXXXXXXXXXXXXXXXXXXXXXX---XXXXXX---XX-------X-XXXXXXXXXXXXXXXXXXXXXXXXXXXXXXXXXXXXXXXXXXXXXXXXXXXXXXXXXXXXXXXXXXXXXXXXXXXXXXXXXXXXXXXXXXXXXXX-XXXXXX-----------XXXXXXXXXXXXXXXXXXXXXXXXXXXXXXXXXXXXXXXXXXXXXXXXXXX--XXXXXXXXXXXX----XXXXXX--XXXXXXXXXXXXXXXXXX-XXXXX---XXXX-XXX------------XX-X--XXXXXX----XXXXXXXXXXXXXXXXXXXXXXX--SSXXXXXXXXXX--XXXXXXXXXX--XXXXXXXXXXXXXXXXXXXX-XXX---XXXXXXXXXX-XX-XX--XXXXXX--XX--XXXXXXXXXXXXXXXXXX---XXXXXXXXXXXXXX-XXXXXXXX--XXXXXXXXXXXXXX-XXXXXXXXX------------------XXXX--XXXXX---XX--XXXXXXXXXXXXXXXXXXXXXXXXXXXXXXXXXXXX-------XXXX---XXXX------------XXXXXXXX--XXXXXXXXXXXXXXXXXXXXXXXXXXXXXXX--XXXXXXXXXXXXXXXXX-XXXXXXXXXXXXXXXXXXXXXXX----XX---XXXXXXXXXXXXXXXXXXXXXXXX----XXXXXXXXXXXXXXXXXXXXXXXXXXXXXXXXXXX-XXXXXXXXXXXXXXXXXXXXXXXXXXXXXXXXXXXXXXXXXXXXXXXXXXXXXXXXXXXXXX--SSXXXXXXXXXXXXXXXXXXXXXXXXXXXXX