------------------------------------------------------------------------------------------------------------------------------------------------------------------------------------------------------------------------------------------------------------------------------------------------------------------------------------------------------------------------------------------------------------------------------------------------------------------------------------------------------------------------------------------------------------------------------------------------------------------------------------------------------------------------------------------------------------------------------------------------------------------------------------------------------------------------------------------------------------------------------------------------------------------------------------------------------------------------------------------------------------------------------------------------------------------------------------------------------------------------------------------------------------------------------------------------------------------------------------------------------------------------------------------------------------------------------------------------------------------------------------------------------------------------------------------------------------------------------------------------------------------------------------------------------------------------
------------------------------------------------------------------------------------------------------------------------------------------------------------------------------------------------------------------------------------------------------------------------------------------------------------------------------------------------------------------------------------------------------------------------------------------------------------------------------------------------------------------------------------------------------------------------------------------------------------------------------------------------------------------------------------------------------------------------------------------------------------------------------------------------------------------------------------------------------------------------------------------------------------------------------------------------------------------------------------------------------------------------------------------------------------------------------------------------------------------------------------------------------------------------------------------------------------------------------------------------------------------------------------------------------------------------------------------------------------------------------------------------------------------------------------------------------------------------------------------------------------------------------------------------------------------------
---------------------------------------------------------------------------------------------------------------------------------oo---------------------------ooo-------------------------------------------------------------------------------------------SSSSSSSSSSSSSSSSSSSSSSSSSSSS-------------------------------------------------------------SS-----------------------------------------------------------------------------------------------------------------------------------------------------------------------------------------------------------------------------------------------------SSSSSSSSSSSSSSSSSSSSSSSSSSSS------------------------------------------------------------------------------------------------------------------------------------------------oo----------------------------------------------------------------------------------------------------------oo-----------------------------------------------------------------------------------------------------------------------------------------------------------------------------------------------------------------------------------------------------------------------------------------------------------------------------------------------------------------------------------------------------------------------------------------------------oo-----------------------------------------------------------------------------------------------------------------------------------------ooo---------------------------------------------------------------
---------------------------------------------------------------------------------------------------------------------------------------------------o----------XXXX------------------------------------------------------------------------------------------------S--SSSSSSSSSSSSSSSSSSS------------------------------------------------------------------------------------------------------------------------------------------------------------------------------------------------------------------E--------------------------------------------------------------------------E----------------------SSSS----------------------------------------------------------------------------------------------------------------------------------------------------------------------------E--E--------------------------------------------------------------------------------------------------------E---------------------------------------------------------------------------------------------------------------------------------------------------------------------------------------o---------SSS---------------------------------------------------------------------------------------------------------------------------------------------------------------------------------------------------------------------------------------------XXXX----------------------------------------------------------------------------------------------------------------------------------------XXXX--------------------------------------o-----------------------
------------------------------------------------------------------------------------------------------------------------o?---------------------------o---------------oooE--------------------------------------------------------------------------------------------SSSSSSSSSSSSSSSSSSS---------------------------------------E---------------------??--------EE----------------------E--------------------------------------------------------------------------------oo------------------oo--------------X-----------------------------------------------------------------------E-----------------------SSSS-----------------------------------XXX-------------------------------------------------------------------------------------------------------------------------------------XXXXXXX-----------------------------------------------------------------------------------------------------XXXXX----------------------------------------------------------------------------------------------------------------------------------------------------------------------------------------------SSS--E----------------------------------------------------------------------------------------------------------------oo--oo--------------E------------------------------------------------------------------------------------------------------------------------------------------------------------------------------------------------------------------------------------------------------------------------------E------------------------------------
------------------E----------------------------------------------------------------------------QQQQQ--------------------XXX-------------------------XXXX-------------XXXSS--SSS----------------SSSSS-SSS--------------------------------------------------So----------SSSSSSSSSSSSSSSSSS--------------------------------------SQS--SSS-------------SSSS?-----SSSSS---Q----------------SQS---SSS-------------------QQQQ--------------SSSSS----------SSSS----SSSSS-------XXXX-----------------XXX-------------------------SSSSS-----------SS---SSSSS-------------E---------?---------SQS------------------------SS---SS---S----o---------------------------------------------SQ--------------------------------------------------------------------------------------SS----------------------------------------------------SSS-----------------------------------------------SSQS---------------SSSSSS-------------------------------?-----------------------S-----------------------------------E--------------------SSSS--------XXX---------------------XXX-----------------QQQ--------------SSSS---------SS---SS---S-QSSSSS--------------------------E------SQ----?--------------SSSSSS----SS---SSS--------------------oo--------------------------S---SQS-----------------SS----------------------------------------------SS----------o---S-------XX------------------------------------------------------------------X-XXS----------------SSSSS----------------------------------SSS---------XXoo---------------------XXX------XXX----------SS-----------------------
-----------------<>---------------------------------------------------------------------------------------------------------XXXX--------------XX----------------------------------------------------------------------------------------------------------------------------------------------------------------------------------------------E----------------------------------------------------------------------------------------------------------------------------------------------------------------------oo---------------------------------------<>----------------------------------------------SS---SS------------------------------------ooo-----------------------------------------------------------------------------------------------------------------------------------------ooo------------------------------------------------------------------------------------------------------oo-------------------------------------------X----------------------------------<>----------------------XXX---------------------XX-------------------S--------------------------------------SS---SS--------------------------------------------XX-----------------------------E--------------------------------------------oo------------------------------------------------------------------------------------------------------------SSSS------------E-------------------------------------------------XXX-------------------------------------------------------------------------------XXX-------------------XXXX-----------------------------------
-----------------[]-------------------------------------------------------------------------------------------------------------------------------------------------------------------------------------E-----------------------------------------------XXSS---------------------------------------------------------------------------------<>-S-------------------------------------------------------------------------------------------------------------------------------------------------------------------------------------------------------------[]----------------------------------------------SS-?-S----S-S---------------------E----------------------------E-----------XX---------------------------------------------------------------------------------------------------------------------------------------------------------------------------------------------------------------------------------------------------------------XX----------------------------------[]-------------------------------------------------------------o---XSS-----------o-------------------------------SS------------------------------------------o-------------------------------------------------------------------------------------------------------------------------------------------------------------------------------------------------------XXXXXXXXXX-------------------------------------------XXXS-------------------------o-------------------------X------------------------------------------------XXXXX-----------------------------------
-----------------XX---------------S-----------------------------------------------------------------------------------------------XXXX----------------------------------E-------------E---------------------------------------XX-----------------------XXX------XXS-S----?----------------------------------------------------------------E--[]------------E-------------------E------------------------------------------------------------------E--------------S-SQ------------------------------XXXXXX-----------------------------------------------------------------------------------------------------SS---So---SoS---o----------S------S------------------------------------------------------------------------------------------------------------------------------------S-----------------------------E-------------E----------------------------E------------------------------SSSSSSS-----------------------------S-----------------------XXX-------------------------------E--XXX-------------------Q--------------------------------------------SS----------------------------------------oo?-SS----oo-------------------------------------------------------------------XX----------------------------XX--oo---------E--S-SSSSSSS-E-------------E------------X---------------------E-------S-S-----------E------------SS-SSS-------------------------------o------------------------ooo--------------XXXXX---------ooo--------------------------------------XXSSoo----------------------------------------E--XXXXXX-------SSSSSSSS--------------------
-----------------XX---------------------------------------------------------------SS-----------ESQQQ----------------XXX---------------------------S---------------------XS--S?S------<>--------------SSS---------------------XXX----------------------XXX-X----XXXX-S----??SSSSSSSSSSS---------Q--QQQQ-------------------------<>--------<>--[]--SSSSSSSSSSSSSSSS--SSSSSSS----<>---QQQQQQ---S?----------S------QQ?SSQQQ-----------------------E--<>------SS--------------------XXX---------XXXX----------------XXXX----------------X---------------X----------QXS--------S?S---QS---S---S------S---------E--X--SS--SSS--SSS-------------------S?S------E---------------QQ--S?S-----------o----------------------------------------S-SS-S----E---------Q----Q-Q-------------------------------------E--------------<>------S-----<>---------------------------<>-------XX----S?S---------------------S------------------------------------------S---------XXX------------------------------<>------S-------------------------X-----XXXXX---------------S---SSS----XX-X-------SSSS---------------------------SSS-SS---SSSSSS-----Q-------------------------SS-----oooo-------X-------------XXXQS--SSSS-------S---------E-----o--o-------<>------------QS--S?S------<>-----------XX--------------------<>--------------------<>-------------------------------------------------------------------E----E-----------------XXXXX----------------XXXX--SS--------------------------XXX--------------XXXX--XXXX------------------------XXXX------------------------------------
-----------------XX-SSS-------------------------------------------------------E---------------------------------------------------------------------------------------o--------------[]-----------------------X-------------XXXX---------------------XXXX-XX--XXXXX-X----------------------------------------------------------[]--------[]--[]--SSSSSSSSSSSSSSS--------------[]------------------------X------------------------------------<>--[]---------------------------XXXX-------EEX--------------------------------------XX---X----------XX----------------------------------------------------<>--X-----------------------------------------<>----------------------------------------------------------E-----------------E------<>----------------------E------------------------------<>--------------[]------------[]---------------------E-----[]-------------------------------------------------E---------------------------------------XXXX-------------E----------------[]---------------------------------------------------------------------XX-XX----------------------------------------------------------------------------------------------------XXX-XX--------XXXX------------------------<>----------------[]-------------------------[]--X-------EXX--------------------[]--------------------[]-------------------------------------------------------------XXXXXXX---<>----------------XXXXXX----------------------------X---E----------------XXXX------------------------------E---------------XXXXXX------------------------------------
-------------X---XX----------------------------------------------------------<>--------------------------------------------------------------------------------XX----XXX-------------[]----------------------X-X---X-------XXXXX--------------------XXXXX--X-XXXXXX---SS-------------------------------------------------------[]--------[]--[]-oSSSSSSSSSSSSSSS--------------[]------------------------X------------------------------------[]--[]------------X-------------XXXXX--------XX----XXXX------------------------------XX----X--------XXX----------------------------------------------------[]--X-----------------------------------------[]---------------------------------------------------------<>-----------------S------[]---------------------<>-----X------------------------[]--------------[]------------[]---------------------------[]------------------------------------------------<>--------------------------------------XXXXX----------------<>------------[]------------------------------------------XXXX----o----------------XXXX-XXX--------------------------------------------------------------------------------------------------XXX---XX------XXXXX------------------------[]----------------[]-------------------------[]--X-------XXX--------------------[]--------------<>----[]-------------------------------X-X--------------------------XXX--------[]---------------XXXXXXX------------------------E--XX-------------------XXXXX-----------------------------<>--------------XXXXXXX------------------------------------
-------------X---XX-----E-E-------------------E-E------------E-E-------E-----[]-----------------------------E-EEooo-----------------------------------------------------E--E---------[]---------------------X--E---X-E----XXXXXX-------EE------EE--XXXXXX---XXXXXXX-------o-o-----------------------------------EE-E-----E-EE--[]-E-EEE--[]--[]-SSSSSSSSSSSSSSSSS-------------[]----E-------E-----------S-------E----------E-----------E-----[]--[]-------E----X--------EE---XXXXX-------XXX----------------------------E--------XXEE-X---------XXXX-E-----------------------------E-E----------------E-[]--X----E-E----------E-E---------------------[]-------------------------E-------------------------------[]------------------------[]---------------------[]-----X----E-E-E------------E--[]--------------[]------------[]-------EE---------------E--[]------------------E-E---------------------------[]------------------EE-E--E-E--EE------XXXXXX----------------[]------------[]-------------E-------------------------------------------------------XX?XXXX?-----------------------------------EE-E------------E----------------------------------X--------XXXX--XXXX----XXXXXXE--------------E-E------[]----------------[]---------------E---------[]--X-----XXXXX--------------------[]-------E-EE---[]-E--[]-------------------------------SS--------------------------XXXX-----E--[]-----------E--XXXXXXXX--------------------------XXX---------------E--XXXXXX-----------------------------[]-----------------XXXX-------X----------------------------
XXXXXXXXXXXXXXXXXXXXXXXXXXXXXXXXXXXXX---XXXXXXXXXXXXXXXXXXXXXXXXXXXXXXXXXXXXXXXXXXXXXX-X--XXXXXXXXXXXXXXXXXXXXXXXXXX-------------------------XXXXX--X-XXXXX-------------XXXXXXXXXXX--XXXXXXXXXXXXXXXXXXXXXXXXXXXXXXXXXXXXXXXXXXX--XXXXXXXXXXXXXXXXXXXXXX----XXXXXX---SX-XXXXXXXXXXXXXXXXXX-XXXXXXXXXXXXXXXXXXXXXXXXXXXXXXXXXXXXXXXXXXXXXXXX--XXXXXXXXXXXXXXXXXXXXXXXXXXXXXXXXXXXXXXXXXXXXXXXXXXXXXXXX---X-XXXXXXXXXXXXXXXXXXXX-XXXXXXXXXXXXXXXXXXXX--XXXXXXXXXXXXXXXXXXXXXXXXXXXXXXXXXXXXXXX---------------------------XXXXXXXXXXXXXXXXXXXXXXXXXXXXXXXXXXXXXXXXXXX--XXXXXXXXXXXXXXXXXXXXXXXXXXXXXXXXXXXXXXXX--XXXXXXXXXXXXXXXXXXXXXXXXXXXXXXXXXXXXXXXXXXXXXXXXXXXXXX----XXXXXXXXXX---X-XXXXXXXXXXXXXXXXXXXXXXXXXXXXXXXXXX---XXXXXXXXXXXXXXXXXXXXXXXXXXXXXXXXXXXXXXXXXXXXXXXXXXXXXXXXXXXXXXXXXXXXXXXXXXXXXXXX---XXXXXXXXXXXXXXXXXXXXXXXXXXXXXXXXXX---XXXXXXXXXXXXXXXXXX-XXXXXXXXXXXXXXXX--XXXXXXXXXXX-XXXXXXXXXXXXXXXXXX---XXXX--XXXXXXXXXXXXXXXXXXXXXXXXXXXX----XXXXXXXXXXXXXXX-X-XX----XXXXXXXXXXXXXXXXXXXXX--XXXX-XXXXXXX------X-X------------XXXXXXXXXXXXXXXXXX--XXXXXXXXXXXXXXXXXXXXX--XXXXXXXXX----XXXXXXXXXXXXXXXXXXXXXXXXXXXXX----XXXXXXXXX---XXXXXXXXXXXXXXXXXXXXXXXXXXXXXXXXXXXXXXXXXXXXXXXXXXXXXXXXXXXXXXXXXXXXXXXXXXXXXXXXXXXXXXXX---XXXXXXXXXXXXXXXXXXXXXXXXXXXXXXXXXXXXXXXXXXXX--XXXXXXXXXXXXXXXXXXXXXXXXXXXXXXXXXXXXXXXXXXXXXXXXXXXX--XXXXX-------S--XXXXXXXXX---XXXXXXXXXXXX-----XXXXXX----X-XX-XXXXXXXXXXXXXXXXXXXXXXXXXXXX------XXXXXXXX---XX-X-X-XX----XXXXXX----------------------------XXXXXXX-X--XXXXXXXXXXXXXXXXXXXXXXXXXXXXXXXX--XX----------XXXX