------------------------------------------------------------------------------------------------------------------------------------------------------------------------------------------------------------------------------------------------------------------------------------------------------------------------------------------------------------------------------------------------------------------------------------------------------------------------------------------------------------------------------------------------------------------------------------------------------------------------------------------------------------------------------------------------------------------------------------------------------------------------------------------------------------------------------------------------------------------------------------------------------------------------------------------------------------------------------------------------------------------------------------------------------------------------------------------------------------------------------------------------------------------------------------------------------------------------------------------------------------------------------------------------------------------------------------------------------------------------------------------------------------------------------------------------------------------------------------------------------------------------------------------------------------------------
------------------------------------------------------------------------------------------------------------------------------------------------------------------------------------------------------------------------------------------------------------------------------------------------------------------------------------------------------------------------------------------------------------------------------------------------------------------------------------------------------------------------------------------------------------------------------------------------------------------------------------------------------------------------------------------------------------------------------------------------------------------------------------------------------------------------------------------------------------------------------------------------------------------------------------------------------------------------------------------------------------------------------------------------------------------------------------------------------------------------------------------------------------------------------------------------------------------------------------------------------------------------------------------------------------------------------------------------------------------------------------------------------------------------------------------------------------------------------------------------------------------------------------------------------------------------
----------------------------SSSSSSSSSSSSSSSSS--------------------------------------------------------------------------------------------------------------------------------------------------------------------------------------S----------------------------oo-------------------------------------------------------------------------------------------------------------ooo----------------------------------------------------------------------------------------------------------SSS--SSSS-------------------------------------------------------------------------------------------------------------------------------------------------------------------------------------------SSSSSSSSSSSSSSSSSS---SSSSSSSSSSSSSSSSSSSSSSSSSSSSSSSSSSS----------------------------------------------------------------------------------------------------------------------------------------------------------------------------------------------------------------------------------------------------------------------------------------------------------------------ESSSSSSSSSSSSSSSSSSSSSSSSS----------------------------------------------------------------------------------------------------------------------------------------------------------------------------------------------------------------------------------------------------------------------------------------------------------------------------------------------------------------------------------------------------------------------------------------------------------------
------------------------------SSSS----------SS?--S-----S--------------------------------------------------------------------------------------------------------------------------------------------------------------------------SS-----Q----------------oS--------E--E-------------------------------------------------------------------------------------------------------XXXX---------------------------------------------------------------------------------------------------------S---------------------------------------------------------------------------------o------------------------------------------------------------------------------------------------------------------------------------------------------------------------------------------------------------------------------------------------------------------------------------------------------------------------------------------------------------------------------------------------------------------------------------------------------------------------------------------------SSSSSSSSSSSSSS---------------------------------------------------------------------------------------------------------------------------------------------------------------------------------------------------------------------------------------------------------------------------------------------------------------------------------------------------------------------------------------------------------------------------------------------------------------------------
------------------------------SSSS--E-------SS--E------S----------------------------------------------------------------------------------------------------------------------------------ooo-------------------------------------SS-------------S--------ES-------XXXXXXX------------------------------------------------------------------------------------------------------------------------------------------------------------------------------------------------------------------S-----?--------E----------------------------------------E-----------------------------------------------------------------------------------------------------------------------------------------------------------------------------------------------------------------------------------------------------------X---E-------------------------------------------------------------------------------------------------Eooo--------------------------------------------------------------------------------------------------------------------------------------------------X--SSSSSSSSSSSSSS--------------------------------------------------------------------------------------------------------------------------------------------------------------------------E------------------------------------------------------------------------------------------------------------------------------------------------------------------------------------------------------------------------------------------------------------------------------------------------
-o---------------------------------SS?----------SS----S------------------------------?SSS---?----------------------------------------SSS--------SQS----SSS---------SSSSS---------------------------------------SSS---SSSSSSSSSSS------SSS--------S------SSSS---?-----------------SSS----------------------SSSS----------------------------------SSSS--------------S?S-----------------------SS----SSS--S------------------S?SSS---------------------SS---------S----------------------------S---SS??------SSSSSSSQQSQ-------------------------------SS---SS-----SS---S----SS---S-----------SSSS-----------------------------------------SSSSS---------------------------SQS------------SS---SSSS------------------------------------------------------So--SSS---?--SS------------------------------SSSSSSS---SSS---SQSSS--------------------------S----SSSS--SS---------------------------SS--------------------------XXXXX----------------------------SS--------------QQQQQ--------------------E---------------------SSS----------SSSS--SSS----SSSS---------------------------SS--SSSSSSSSS-----?--------------------SSSSSSS------S------S---------SS---------S--------SS------------------Q?SSS---?SSSS---------------SSSS------------------------SSSS---------------E--E---------------------------------SSS-------X-XXooo----oo----------------------------------------QQQ-----------------------------------------------SSS---------------------------------------------------------S------SSSSSS-----------Q----------------SSSSS-----SSSS---Q-Q------------------
--------------XXX------oo----------SS-----------SS----S----------------------------------------------------XXX-------------------o----------------------------------------------------------------------------------------------------SS----------------SS-------------------oo---------------------------------------------------------------------------------------------------------------------------o----------------------------------------------------X------------------------------------------------------------------------------------SS--------------------------------------------------------------------------------------------------------o------------------------SS------------------------------------------------------------------------------------------------------------------------------------------------------------------------------------------------------------------------------------------------------------------------------------------------------<>------------------o-------------------------------------------------XXX-------S-----------------------------------------------------------------------------------------------------------------------------E-----------------------------------------------------------XXXXXX----------------------------------------------------XXX-----------------------------------------------------------------------------------------------------------------------------------------------------------------------------------------------------------------------oo---------
----------------------------------SSS-----------SS----SS--------------E------------------------------------------------------------E--------------------------------------------------------------------------------------------------SS----------S-----SS------------------------------------------------------------------------E-------------------------------------------------------------------------E-------------------------------------------------XX--------------------------------------------------------------------------------------------------------------------------------------------------------------------X--------------------------------------------------SS---S----------------------------------o---------------------XSS--------------------------------------------------------------------------------------------------------------------XS---o-------------------------------------------------------------------------------------------------------------[]----------------------------------------------------------------------------SSS----------------------------------------------------------------------------------------------------------------------------<>----------------------------------------------------------------------------------------------------------------------------------------o-------XXS--------------------------E----------------------------------------------------------------------------------------------------------------------------------------------------------------------------
------------------------------oooooSS-----oooo?-SS--Q-SS-------------<>--------------SSSSS-------------------SSS---------------E--<>----------------------------------------SSSSSS------------------------------------------------ooooSS-----o----S-----SS---SQSQ----------E----------------------------------ooo-------------E--<>------------------------------------------S-------------E---------------------------------------------------------------X-XXX-----E---------------E----------------------------------------------E---------------S--------------------------X-SSS--------------------------------oo-------------XXS------------------XXX-X---------------------o--?-SS---Qoo----------------------------X------------S-----------XXXS--------------E--o-------------------------------------X-----------------------------------------------------------XX---------------------------------------------------S--------E--S--------------------------------------------------[]---------------E--------------------------------------------------------------So??--S-------------------------------------------------------------E--------------E-------------------------S---------------[]------SSSS--------------SS-SS-------------------------------------------------------------------------------------------------SSS--------------XXX--------------------------<>-----S-----------------------------------------------------------------------------------------------------------------------------------------------------------------E--o-
--XXXXX----------------XXX-----SSSSSS-S------Q--SS--S?SS----------E--[]------------------Q--Q--S---XXXX-----------------------<>--[]----------ESSSS----XXX-X-------------------------------------------Q-------XX--X---------------SSSSSS-S------SS-----SSSS--------------<>------------------------------E----------S----E--<>--[]---------ESSS-------------------------------------E----<>----------XX-QQQ----------------------------------------S-----XX-XXX----<>--------------<>-------?SSSSSSSSSSSSSSSSS---QQ---------------<>-------------------SSS----XX--X----------XX--------------X-X----------XS---------------------XXX-----XXX-----XXXXX-----------------SSS----E--------S--SSSS---SS---------------------XXXSSS--------------------XXXX----Q-Q--Q----<>-----E--S--------------------SS--------XXS--S?S------SSS---------------QQ--QQQQ-----E--------------XXX--S------------------?--------------------XX-QQQ------E----<>-----E--S------------------E-SQQQQ------------------SXXX-------------<>-------SS----------QQ?--QQ-----E-----QQ-----Q--------------X--SSS--SS--SQ-Q--Q--Q----QQ--------------SSSSSS------SS-----SS---S---<>----------SSS<>---------------E---E---------SE----------[]------------------------------------------------XXX--XXXX-------------------Q-------------------------XXXXXX----XXX--XXXX---------------------XXXX----E-QQQ--S?S---------E--[]----------------S----X---------------XXXX--o-------XX--------------------------S----XX-----SSS---Q--Q--QQQQ---------QQQQQ-----------------QQQ-----QQ--S?SS------------<>----
-----------------------------------------------------------------<>--[]-------------------------------------------------------[]--[]----<>------------XXXX-XX--------------E----------------------------------XXX--XX-------------------------------------SS--------------[]-----------X-----------E-----<>--------------<>--[]--XX--------E-------E------E-------------------------<>----[]---------XXX--------------------------------------------------XX-XXX----[]--------E---E-[]--------SSSSSSSSSSSSS--SS--------------------[]------------<>-----------XXX--XX--------XXX-------------XX-XX--------XX---------------------XXXX-----------------------------------------<>----------EE-------------XXX--XX--------EXXX----------------------XXXXX--------------[]----<>----------------E---------------XXX-S-------S--S-----------------------------<>----------XX-XXXX---------------------------------XX------------------<>----[]----<>----------------X-------------------------E--------------------[]----------------------------------------------E--------------------E-------------------------------------------------------------[]-------------[]--------------<>--<>----------------------------------------------XX------------X-------------------------------E-------------------------------------------------------E------E--------XXXXX----X-----------------<>--[]-------------------E-X--XX------------------o------XX-------------------------------XX--------------------------------------------------------------------------------[]----
---------------------XX------------------------------------------[]--[]-------------------------------------------------------[]--[]----[]-----------XXXXX-XXX---------X-------------------------------------XXXX--XXX-----------------------------------SSS--------------[]-----------X----------<>-----[]--------------[]--[]-----------------------------------------------------[]----[]--------XXXX-----------------------E------------------------XXXX-XXX----[]-------<>--<>-[]--------SSSSSSSSSSSSS--SS--------------------[]------------[]----------XXXX--XXXX-----XXXX-------------E--XX-------XXX--------------------XXXXX-----------------------------------------[]------------------------XXXXX----------XXXXX---------------------XXXXXX--------------[]----[]---------------<>--------------XXXX-----------SS-----------------------------[]---------XXX-XXXX-----------------------------------------------------[]----[]----[]----------------X------------------------<>--------------------[]-X------------X------------------------------------------------------------------------------------------------------------------[]-----SS------[]--------------[]--[]---------------------------------------------XXX-----------XX--<>--------------------------<>------------------------------------------------------<>--------------XXXXXX----X-----------------[]--[]------------------<>-X--EXXX------------XXXXXX-----XXX------------------------------XX-----------------------------X--------------------------------------------------[]----
-o---------------------------E-----------------E--E--------E-----[]--[]--------E---------------------------------E---------E--[]--[]----[]---E-E----XXXXXX-XXXX--EE-E-XX-------------------------------E----XXXXX--XXXX-----E-XX--EE-E---------E-E-------E-----------E-E--[]-----------X--------E-[]-----[]---------E-E--[]--[]--------------------X-------------------------E-EE-E-[]----[]-------XXXXX----------------------------------E--------EE--XXXX--XXX----[]-----E-[]--[]-[]----E-ooSSSSSSSSSSSSSooSS--------------E-EE--[]----E-E-----[]--E-E----XXXXX--XXXX----XXXXX----------------XX------XXXX-------------------XXXXXX----------------------------------E-EE---[]-----------------------XXXXXE----X-----XXXXX---------------------XXXXXX--------------[]----[]-E-E-E----EE-E-[]-E--E--------XXXXX-----------SS--------EE-E---------EE------[]------X--XXXXXXXX-------E-EE--E---------------------------------------[]----[]----[]------------E---X-----E-----E-E-----E-E--[]--------------EE----[]-X--E-E-------X-E-----E-E---------------------------------E----------E-----------E-E------------EE------------------E-EE---------[]-------------[]----E---------[]--[]-E-E----------------------EE-E-E------------XXXX--SS------XXX--[]--------------------------[]--------------------------------oo--------------------[]-------------XXXXXXX----X-----EE-------EE-[]--[]-----------E------[]-XE-XXXX----E------------------XXX--EE----------E-------E--E----XX-----------------------EE-E--X----EE-------------------------------------E------[]----
XXX-------------------------XXXXXXXXXXXXXXXXXXXXXXXXXXXXXXXXXXXXXXXXXXXX--XXXXXXXXXXXXXXXXXXXXXX-----------XXXXXXXXXXXXXXXXXXXXXX-XXXXXXXXXXXXXXXXXXXXXXX-oXXXXXXXXXXXXXXXXXXXXX--XXXXX-----XXXX--XXXXXXXXXXXXXXX--XXXXXXXXXXXXXXXXXXXXXXXXXXXXXXXXXXXXXXXXXXXXXXXXXXXXXXXXXXXXXXXXXX--XX---XXXXXXXXXXXXXXXXXXXXXXX-XXXXXXXXXXXXXXXXXXXXXXXXXXXXXXXXXXXX-X-XX-XXXXXXXXXXXXXXXXXXXXXXXXXXXXXXXXXXXXXXXXXXXXXX--XXXXXXXXXXXXXXXXXXX-----XXXXXXXXXXXXXXXXXXXXX-XXXXXXXXXXXXXXXXXXXXXXXXXXXXXXXXXXXXXXXXXXXXXXXXXXX--XXXXXXXXXXXXXXXXXXXXXXXXXXXXXXXXXXXXXXXXXXXXXXXXXXXXXXXXXXXXXXX--XXXXXXXXX-XX--XXXXXXXXXXXXXXXXXX------XX-XXXXXXXXX----------XXXX------------------XXXXXXXXXXXXXXXXXXXXXXXXXXXXXXXXXXXXXXXXXXXXXXXXXXXXXXXXXXXXXXXXXXXXXXXXXXXXXXXXXX-XXXXXXXXXXXXXXXXXXXXXXXXXXXXXXXXXXXXXXXXXXXXXXXXXXXXXXXXXXXXXXXXXXXXXXXXXXXXXXXXXXXXX-XXXXXXXXXXXXXXXXXXXXXXXXXXXXXXXXXXXXXXXXXXXXXXXXXXXXXXX-----XX-------XXXXX---XXXX--XXXXXXXXXXXXXXXXXXXXXXXXXXXXX-XXXXXXXXXXXXXXXXXXXXXXXXXXXXXXXXX-XXXXXXXXXXXXXXXXXXXXXXXXXXXXXXXXXXXXXXXXXXXXXXXXXXXXXXXXXXXXX---XXXX-XXXXXXX--XXXXXXXXXXXXXXXXXXXXXXXXXXX-XXXXXXXXXXXXXXXXXXXXXXXXXXXXXXXXXXXXXXXXXXXXXXXXXXXXXXXXXXXXXXXXXXXXXXXXXXXXXXXXXXXXXXXXXXXXXXXX--XXXXXXXXXXXXXXXXXXXXXXXXXX----X--XXXXXXXXXXXXXXXXXXX--------XXXXXXXXXXXXXXXXXXXXXXXX----XXXXXXXX--------XX------------------XXXXXXXX-X-XX-X-XXXXXXX----X--XXXXXXXXXXXX-XXXXXXXXXXXXXXXXXXXXXXXXXXXXXXXXXXXXXXXXXXXXXX--------------XXXXXXXXXXXXXXXXXXXXXXXXXXXXXXXXXXX-XXXXXXXXXXXXXXXXXXXXXXXXXXXXXXXXXXXXXXXXXX-XXXXXXXXXXX---XXXXXXXXXXXXXXXXXXXXXXXX--XX