------------------------------------------------------------------------------------------------------------------------------------------------------------------------------------------------------------------------------------------------------------------------------------------------------------------------------------------------------------------------------------------------------------------------------------------------------------------------------------------------------------------------------------------------------------------------------------------------------------------------------------------------------------------------------------------------------------------------------------------------------------------------------------------------------------------------------------------------------------------------------------------------------------------------------------------------------------------------------------------------------------------------------------------------------------------------------------------------------------------------------------------------------------------------------------------------------------------------------------------------------------------------------------------------------------------------------------------------------------------------------------------------------------------------------------------------------------------------------------------------------------------------------------------------------------------------
---------------------------------------------------------------------------------------------------------------------------------------------------------------------------------------------------------------------------------------------------------------------------------------------------------------------------------------------------------------------------------------------------------------------------------------------------------------------------------------------------------------------------------------------------------------------------------------------------------------------------------------------------------------------------------------------------------------------------------------------------------------------------------------------------------------------------------------------------------------------------------------------------------------------------------------------------------------------------------------------------------------------------------------------------------------------------------------------------------------------------------------------------------------------------------------------------------------------------------------------------------------------------------------------------------------------------------------------------------------------------XXX------X-----------------------------------------------------------------------------------------------------------------------------------------------------------------------------------
------------------------------------------------------------------------------------------------------------------------------------------------------------------------------------------------------------------------------------------------------------------------------------------------------------------------------------------------------------------------------------------------------------------------------------oo-----------------------------------------------------------------------------------------------------------------------------------------------------------------------------------------------------------------------------------------------------------------------------------------------------------------------------------o------------------------------------------------------------------SSSSSSSSSSSSSSSSSSSSSSSSSSSSSSSSSSSSSSSSSSSSSSSSSSSSSSSS----------------------------------------------------------------------------------------------------------------------------------------------------------------------------------------------------SSSSSSSSSS----------------------------------------------SSSSSSSSSSSSSSSSSSSSSS---S--------------------------------------------------------------------------------------------------------------------------------------------------------------------------SSSSSS-----SSSS--------SSSSS--------------------------------------------------------------------------oo------------------------------------oo------------------------------------------------------
---------------------------------------------------------------------------------------------------------------------------------------------------------------------------------------------------------------------------------------------------------------------------------------o-----------------------------------------------XXX-------------------------------------------------------------------------------------------------E------------------------------------------------------------------------------------------------------------------------------------------------------------------------------------------------------------------------------------------------------------------------------------------------------------------------------------------------------------------------------------------------------------SSSSSSSSSSSSSSSS--------------------------------------------------------------------------------------------------------------------------------------------------------------------------------------------------------------------------------------------------------------------------------------------------------------------------------------------------------------------------------------------------------------------------------------------------------------------------------------------------------------------------------------------------------------------------------------------------------------------------------------------E--E------------------------------------------------
----------------------------XX-----------------------------------------------------------------------------------------------------------------------------------------------------------------------------------------------------------------------------------------E----E------------------------------------------------E----------------------------------------------E---------------------------------------------------------------oo---o-----------oo-------------------oooo-------------------------------------------------------------------------E------------------------------------------------------------------------X---------------------------------------------------------------------------------------------------------------E------oooo-------------------------------------------------------------------------------------SSSSSSSSSSSSSSSS--------------------------------------------------------E----E---------------------------------------------------------------------o----------------------------------------------------------------XX----------------------------------------------------------------------------------------------------------------------------------------------------------------------X--------------------------------------------------------------------------------------------------------------------------------XX--------------------------------------------------------------------------oo------------------------------------------------XXX--oo---o------------oo----------------------------
------SSSS----------------------SSSS-----SSS--------Q--------------------------------------------------------------------------SSSSSSS---------------------SSSS---------------E--------SSS---------S--------------------------------------QQQQ-----------------------------SQS-------SSS--?S-----------------SSSS------------E--EE----------------------------------------------SQS---?-SS--------------SSSS--------------------SSSSS---------------------------------------------XXXX---------------------------------S------------S----SSSSS------------------S--SSSSS------SS-----------------------SS-------------SSS---SSSS-----SSS---SSS---------SQS---?---SSS---------QQQQQ--------------SSSSS---?---------S-----SSSS------------SSSSSSSSSS------SS-----XXXX--------------------------------------------------------------SSSSSSSS--------------SSSSSSSSSSSSSSSSS--SQ--------------------------------------------------------SQS--??------XX-----SSS------------------S--SSS-----------------------XXSX---SS-----E---SSSSS---------------SS---SS---------------SSS------SSSSS----SSSSSSS--------------------------S---?------------------------E---------------------------------------------------------------------------------SSS-------XX---S?SQS---SS-------------------------------------------SS----------------------SSSS---------QSQS-----------------------------------------------------------------Q-Q--------------XXX-----oXX-----o-----o--XXXX--------------------------------------------oo-----------------------XXX--SSS-------XXo-----oo------
----------------------------------------------------------------ooooo--------------------------------------------------------------------------------------------------------<>------------------------------------------------------------------------------------------------------------------------------------------------XXXXXX---------------------------------------E---------------XSS------------------------------------------------------------------------------------------------------------------------------------------------------------------------------------------------------------------------------------------------------------------------------------------------------------------------------------------------------------------------------------------------------XX---------------------------------------------------------------------------------------------------oo-o----------------------------------XXX--------------------------------------------------------------------------------------------------------------------------------------------------------------------------------------------------<>------------------------------------------------------------------------------------------XXX------------------------------------------------------E----------------------------------------------------------------E--------------------------------------------------------------------------XX---XXX------------------------------------------------------------o---------------------------------------------
------------------X-X-----------------------------------------------------------------------------------------------------------------------------------------E--------S-----[]-------------------------------------------------------------------------------------------------------E----------------------------------------------------------------------------------------------------XXX-------------------------------------------------------------------------------------------------------------------------o-------------------------------------------------------------------------------------------------------------------S----------------------------------------------X----------------------------E---------------------------------------------------o-------------------------XX----------------------------------------------------------------------------------------------------------------------------------------XXXX-----------------------------------------------------------------XX-----------o-----------------------------------------X-----E-------------------------------------------------------------------[]-----------------------------------------------------------------------------------------XXXX---S--------------------------------------------------E------------------------------------------------------------XXXXXX------------------------------------------------------------------------oo---------------------------------------------------------------------------------------------------------------o-
--------------------------------------------------------------X-S------------------------------------------------------------------------------------------------------------[]-------------------------------------------------------------------------------------------E-------E----X---------------------SSSSS-------------------------------------E----------------------------------XXXX--S------------------------------------XX-----------------------------------------------o--------------------------XX----E----------------------------------------E----------------------------------------S---------------------------------S----------------------------------------------XX----------------------------------------------------------------------------------ooo---SSSSSSSS------XXXXS--------------------------------E-----------------??---------------------------------------------------------------------S-------------XXXXX----------S-------------------------X----E--S--------------------S---------------------------E--------------E----------XX------------------------------------------------------------------------->-------------------------------E--------E------------------------------------------------XXXXX----------------------------------------E---------E--<>-----------------------E------------------------------E-----------------X----o------o--------------------------------------oo----------------Q-----------------XXS-------S---------------------SSSSSSXXXX-----------------o----------------------------------
-----XXX----------XX--------XX----S-----SS----------Q-----<>---------------S----XX------------<>--------<>--ESQ-----X-------Q--SS---------XX---E------------S?S----XXXX-----------------SS--------SS-Q-QQ--QQ------------------E-------QQ-S?QQQ----------------E---------<>------<>---QX------------E----------------------XXX---------------------E--<>-----E--XXX---------Q---S?S-----XXXXXX---------X----------E----------SS--------------XXX-------------------------------------------------------------X--XXX--------------------XXXX-SSS----------------<>--SS---------XX---E---------------------------------QQQ----QQQ---QS-------SSS----------QQQ--QQ----Q---Q---SSSSQQQQ-----XXXX-------------Q--Q--QQQ---S?S---------------E----------------SS---S----------------o------------------XXXXXX--------------------E-------SSSSSSS---------------??SSSSSSSSSSSSS---SS--------------------QQQ---------------S------------S---S?S------XXXXXX-----------------------------------XX---<>-----E---------SSS---------Q-Q--SSSSS----X--X------QS--SSS-------<>---------XXX----?S---------S----------------------------QQQ--QQQ----------------------------------------------------<>-------<>-----------------E-----------------------S-----XXXXX-S--SSS--S------------------------------<>-------E<>--[]-XS------------E------<>---Q---S----QQSSQS-----------<>---------------------------o-------Q---S-S----E-----Q-Q--Q--X------------XXXXXXXXXX--------------------XXXX----------E------QQ-------------------------XXXX----E--------------------------XXXX--XXX---
--XX--------------XX--------XX------E---------------------[]--------------------XX------------[]--------[]-------E--X--------------------XXX--<>-------------------XXXXX---------E----------------------------------------------------------------------------<>---------[]------[]--XXX----------------------------------------------------------<>--[]-----E-------------------------XXXXXXX--------XX---------<>--------------------------------E------------------------------------------------------------XXXX-------------------------------------------[]------------XXX--<>---E-------------X----------------------------------------------------------------------------------XXXX------------------------------------------<>----------E----------------------X----------------------XXXXXXX-------------------<>---------------------X--XX----------------------------------------------------------------E------XX-------------XXXXXXX-SSS------------------------------XXX---[]----<>----------------X---------E-------XX--XX-------------------[]--------XXXX-----------------------------------------------------------------------------XX-------------------------[]--E----[]----------------<>----------------------------XXX-XXX-SSSSS---------------------------------[]------<>[]--[]--------------<>------[]-----------------------------[]----------------?----------------------------<>-------------------------------------------------------XXXXX-SSSS----<>----------------------------------------<>--------------------------------------
--XX--------------XXX-------XX----------------------------[]--------------------XXX-----------[]--------[]----------X-------------------XXXX--[]------------------XXXXXX--------<>-----------<>---------------------------------------------------------------[]---------[]------[]--XXX---------------------------------------XXXX---XXXX--------[]--[]------------------------------XXXXXXXX-------XXX---------[]-----X-------------------------<>----------------------------------------X-------------------XXXX----------------------------oooo-----------[]-----------XXXX--[]----------------X----------------------------------------------------------------------------------XXXXX------------------------------------------[]---------------------------------X---------------------XXXXXXXX--------X----------[]---------------------XX--XX--------------------------------------------------------------<>-----XXXX-----------XXXXXXXX---------------------------------XXXXX--[]----[]---------------XX--X----------E--XXX--XXXX-----------------[]-------XXXXX-----------------------------------------------------------------------------X--------------------------[]-<>----[]----------------[]---------------------------XXXX-XXXSSSSSS---------------------------------[]------[][]--[]--------------[]------[]-----------------------------[]-------XXXX----------------------------------[]------------------------------------------------------XXXXXX---------[]----------------------------------------[]----------------------------XXXXX---oo
--XX----------E---XXX---EE-EXX-----E----E-----------------[]----------------E---XXX-----------[]--------[]------E---X----EE-E-----E----XXXXX--[]--E-E------EE----XXXXXXX--------[]-----------[]----------E-EE------EE--E------------------E-----EE-EE---------[]--E------[]------[]--XXXE-------------------------------------X-------------------[]--[]----------------------E-----XXXXXXXXXX-------XXX---------[]-----------E-E---------------E-[]----------------------------------------X----E--EE----EE-X--XXX---SX--------------------------XX------E-E--[]----------XXXXX--[]-----E-E--E-E--X-------------------E---------EE-E------------------------------X---------------E--XXXXXX-------E--------E-E------------X---------E[]-E-------------------------------X----------------------XXXXXXX-------XX------E---[]-E-------------------XX-------------------------------------------------------E-EE----EE-[]-----XXXX----------X--XXXXXX-----E-----------EE-EE--X-------XXXXXS--[]----[]--------------XXX---------------XXXXE-XXXX-E--E-E-------E--[]------XXXXXX----------------------E------E-EE-E------------E-EE-------------E--X---------X--E-----------------------[]-[]-EE-[]--E-E-----------[]---E-E------EE-E------EE-XXXXXS-XXX---S-----------------EE-E--X-----------[]------[][]--[]-EE-EE--------[]-EE---[]-------------E---------------[]-S-------------------------------------------[]--------------------X---oXo-----------------o----X---XXXXXXX-SSSSS---[]----------------------E-------ooo-------[]-------------------XXXXXX----------XXX
XXX-------XXXXXXX-XXXXXXXXXXXXXXXXXXXXXXXXXXXXXXXXXXXXX-XXXXXXXXX-X-XXXXXXXXXXXXXX--XXXXXXXXXXXXXXXXXXXXXXXXXXXXXXXXXXXXXXXXXXXXXXXXXXXXXXXXXXXXXXXXXXXXXXXXXXXXXXXXXXXXXXXXXXXXXXXXXXXXXXXXXXXXXXXXXXXXXXXXXXXXXXXXXXXXXXXXXXXXXX-XXXXXXXXXXXXXXXXXXX-XXXXXXXXXXXXXXXXXXXXXXXXXXXXX-XXXXXXXXXXXXXXXXXXXX--X-XXXXXXXXX-X-XX---------------------X-XXXXXXXXXXXXXX------------XXXXXXXXXXXXXXXXXXXXXXXXXXXXXXXXXXXXXXXXXX--XXXXXXXXXXXX-XXXXXXXXXXXXXXXXXXXXX------XXXXXXX---XXXX--XXX------XXXXXXXXXXXXXXXXXXXXXXXXXXoXXSXXXXXXXXXXXXX---------XXXXXXXXXXXXXXXXXXXXXXXXXXXXXXXXXXXXXXXXXXXXXXXXXXXXXXXXXX-----XXXXXXXXXXXXXXXXXXXXXXXXXXX-XXXXXXXXXXXXXXXXXXXXXXXXXXXXXXXXXXXXXXXXXXX-XXXXXXX--XXXXXXXXXXXXXXXXXXXXXXXXXXXXXXXX---XXXXXXXXXXXXXXXXXXXXXXX-XXXXXXXXXXXXXXXX-XXXXXXXXXXXXXXXXXXXXXXXXXXXXXXXXXXXXXXXXXXXXXXXXXXXXXXXXXXXXXXXXX-XXXXXXXXXX---XXXXXXXXXXXXXXXXXXXXXXXXXX--XXXXXXXXXXXXXXXXXXXXXXXXXXXXXXXXXXXXXXXXXXXXXXXXXXXXXXXXXXXXXXXXX-XXXXXXX-X-XXXXXXXXXXXXXXXXXXXXXXXXX--XXXXXXXXXXXX---XXXXXXXXXX-XX-XXXXXXXXXXXXXXXXXXXXXXXXXXXXXXXXXXXXXXXXXXXXXXXXXXXXX-XXXXXXXXXXXXXXXXXXXXXXXXXXXXXXXXXXXXXXXXXXXXXXXXXXXXXXX---XXXXXXXXXXXXXXXXXXXXXXXXXXXXXXXXXXXXXXXXXXXXXXXXXXXXXXXXXXXXXXXXXXXXXXXXXXXXXXXX-XXXXXXXXXXXXXXXXXXXXXXX--XXXXXXXXXXXXXXX---XXXXXXXXXXXXXXXXXXXXXXXXXXXXXXXXXXXX-XXXXXXXXXXXXXXXXXXXXXXXXXXXXXXXXXXXXXXXXXXXXXXXXXXXXXXXXXXX--------------XXXXX---XXXXXXXXXXXXXXXXXXXXXXXXXXXXXXXX--XXX--XXXXX-------------XXXXXX--XXX--XXXXXXXXXXXXXXX---XXXXXXXXXXXXXXXX--XXXXXXXXXXXXXXX---XXX-XXXXXXXXX--XXXXXX-XXXXXXXXXX------------------