------------------------------------------------------------------------------------------------------------------------------------------------------------------------------------------------------------------------------------------------------------------------------------------------------------------------------------------------------------------------------------------------------------------------------------------------------------------------------------------------------------------------------------------------------------------------------------------------------------------------------------------------------------------------------------------------------------------------------------------------------------------------------------------------------------------------------------------------------------------------------------------------------------------------------------------------------------------------------------------------------------------------------------------------------------------------------------------------------------------------------------------------------------------------------------------------------------------------------------------------------------------------------------------------------------------------------------------------------------------------------------------------------------------------------------------------------------------------------------------------------------------------------------------------------------------------
------------------------------------------------------------------------------------------------------------------------------------------------------------------------------------------------------------------------------------------------------------------------------------------------------------------------------------------------------------------------------------------------------------------------------------------------------------------------------------------------------------------------------------------------------------------------------------------------------------------------------------------------------------------------------------------------------------------------------------------------------------------------------------------------------------------------------------------------------------------------------------------------------------------------------------------------------------------------------------------------------------------------------------------------------------------------------------------------------------------------------------------------------------------------------------------------------------------------------------------------------------------------------------------------------------------------------------------------------------------------------------------------------------------------------------------------------------------------------------------------------------------------------------------------------------------------
S---------------------------------------------------------------------------------------------------------------------------------------------------------------------------------------------------------------------------------------------------------------------------------------------------------------------------------------------------------------------------------------------------------------------------------------------------------------------------------------------------------------------------------------------------------------------------------------------------------------------------------------------------------------------------------------------------------------------------SSSSSSSSSSSSSSSSSSSSSSSSSSSS-----------------------------------------------------------------------------------------------------oooo-----------------------------------------------------------------------------------------------------------------------SSSSSSSSSSSSSSSSSSSSSSSSSSSS------------------------------------------------------------------------------------------------------------------------------------------------------------------------------------------------------------------------------------------------------------------------------------------------------------------------------------------------------------------------------------------------------------oo--------------------------------------------------------------------------------------------------------------------------------------
----------------------------------------------X----------------------------XXX------------------------------------------------------------------------------------------------------------------------------------------------------------------------------------------------------------------------------------------Q----------------------------------------------------------------------------------------------------------------------------------------------------------------------------------------------------------------------------------------------------------------------------------------------------------------------------------------------------------------------------oo-------------------------------------------------------------------------------------------------------------------------------------------------------XXXX------------------------------------------------------------------------------------------------------------------------------------------------S-----------------------------------------------------------------------------------------------------------------------------------------------------------------------------------------------------------------------------------------------------------------------------------------------------------------------------------------------------------------------------------------------------------------E--E--------------------------------------------------------------------------------------------------------------------------------
-----------------------------------------------------------------------------------------------oo---o--oo-------------------E----------------------------------------------------------------------------------------------------------------------------------------------------E-------------------------------------------------------------------------------------------------------------------------------------------------E-----------------------------------------------------------------------------------------------------------------------------------------------------------------oo----------------------------------------------------------------------------------------------------------------------------------------------------------------------------------------------------------------------------------------------?--------------Eooo--------------------------------------------------------------------------------------------------------------------------------------------------------------------------------------------------------------------------------------------------------------------------------------------------------------------------------------E------------------------------------------------------------------------------------------------------------------------------------------------------------------ooo-oo--o------X----------------------------------XXXXXXX-------------------------------------------------------------------------------------------------E----------------------------
-----QS----------------------XXoo-----XXX-----oo-------oSSSSS---?---XXoo----?----------------------------------E--SSS-----?SSS----XX---------------------------------------------------------------------------------------------------------------------------------------------XXX-----S----S-----SS--SSSSSSS-------------XXX-----------------QQSS---QQQ-----------------------------------------------------------------------SSS-----------S----------Q-Q-Q-----------------SQS---SSS-------------------------------------------------------------------------------------XX-----------------------------------------------------------S---SSSS-----------------------------------------------------XXX------------------------------oooooo---------------------------XXX-----------------------------------------?------Xoo---?S?S---------S-S-S?S-------------XXXX-----------------------SSSS----------------SSSS----QQ----SSS-------------------SSSS-------------------------SSSS------------------------SSoo-----------------------------------------------------------S---Q-Q-----------------------S-SSQQQQQ------------------------------------------SS--------------------SSSS---SSS-------------S?SSSSS----------------SSQSSSSSS------------------------------------------------------------------------------------------X----E-----SSSS-----------------X-oo--XXXX----------X------SSSSS-------SSS----?-------------------------------------?--------------SSSSS------------------------------------------------SSS-------SSS---------SSS----------------
------------------------------------------E-----------XX----------------------XXXXX----------------XXX----------------------------XX-------------------------------------ooo------------------------------------------------------------------------------------------------------------------------------------------XXXX----------------------------------------------------------------------------------------------------------------------------------------------------------------------------------------------XXX--------------------------------------------------XXX--------------X-------------------------------------X-------------------------------------oooo-----------------------------------SSS--------------------------------------------------------------------------------------------XXX------------------------X--------------------------------------------------------------------------------------------------------------------------------------------------------------------SS----------------------------E-------------------------------------------------------------------------------------------------------------------------------------------------------------------------------------------------------------------------------------------------------------------------------------------------------------------------------------------------------------------------------------------------------------------------------------------------------------------------------------------------------------------------
-----------------------------------------<>----------oo------------------------------------------------------X-X----------------XXXX---------------------------------------------------------------------------------------------------------------------------------------------------X------------------------------------------------------------------------------------------------------------------------------------------------------------------------------------------------------------------------------------------------------------------------------------XXXX----------------------------------------------------XX--------------------------------------------------------------------------X------------------------SSSSSS------------------------------------------------------------X------------------------------o-------------------------------------------------------------------------------------------------------------------------------------------------------------------S-SS--------------E------------<>-------------------------------------------------------------------------------------------------------------------------------------------------------------------------X------------------------------------------------------------------------------------------------------------X--XX-----------o------------------------------------------------------o--------------------------------------E----------------------o---------------------------------------------------------------------------------------------
----o----------------S-------------------[]--------------------------------------------------------------------------------EEEE-X-XX--------------------------------------------------------S-----------------------------------------------------------------------------------------XX---------------------------X--------------------------------------------------------------------E-----------------------------------E-----------------------E---E-------S--------E-------------E-----S-------------------------X-----------------------------So--------------------XXXXXoo--------------------------------------------E-----XX---------------------------------------------------------XSSSSSS----------XSS-SQ-------------------SSSSSS-------------E-------------------------------------------------------------------------------------------------------SSSS-------E------------------------------------------------XXXX--------------------------------------E-------------------------------SS--SoSX-------------<>------------[]----------------------E--------------------------------------------------------------------------------------------------------E------SSSSSS-----------------------------SX---------------------------S-SQQ--------------SQ-------------------------------E--------E----------------E----S------------------------------------------------------------------E-EE--------------------------------E--<>-------------------------------------------------------------------------------------------E--------------------SSSS
---SSSS----------------------XXXXXX------XXX--XXXXXXX-------------XXXX--XXXX--------------XXXXXXX-------------------QQQ---SS----X-XX---------------------------------------------------------------------------------------------------------------------E---------------------------XXXQQQS--S-------------------XX----------S-S---------------QQQQQ--QQQ-----QQ----------------------<>---S------------------------------<>----ES?------S----S---<>--<>---QQQQ---E----<>------SSS---<>-------------------S----------XX--------------------------------------------------XXX-XX-------XXXXX-----------------S---------------<>---E-XX-------XXX------------E----------------------S----------XX---------------XXX---------XSSS----XX---------------X---o---E---------XXX-------SS--------ooo-----------------------------------XXXX--XXX-------S?SQS-------------------------<>-------E--QQQQ--Q-------------------------QQQQ-------------------------------------------<>-----E--S------SS-------XX-----SX--SSSS-?-----<>----[]-------E--o-XX------Q--Q--------E--<>-------QQQ---S?S-------------------------QQ?SSQSQ-----------------------Q?Q---------------S---------E--<>--------------ooo------EX--X------------XSX-QQ-------?SQS------X--------------------XXX---------X---------QQQ------------<>-------<>---------------<>-XX-X---------SSSS---------------------XXXXXXXXX------------SSSSSSSSSSSSSSSSS----SSS------Q------------E--<>--[]-------------------XXX--------XX-----------------E-------E-------------------------QQQQQ--<>-----QQQ----------------
-----------X---X---------------------------------------------------------------------------------------------------------------XXXXX-------------XXXX?-----------------------------XX---------------------------------------------------------E---------<>--------------------------XXXX-------------------E-----XXX-------------------------------------------------------------------[]----------------------------------[]----------------------[]--[]---------<>----[]------------[]-----------------------------XXX-------------------------------------------------XXXX-XX----------------------o--XXX-----------------[]--<>-XX---------------------<>------------------E------E------XXX--------------XXXX--------XX------XXX--------------XXX------E-------------------------------------------SS--------------------------------------------------------------------[]-----------------------------------------------------------------------------------------[]----<>----------------XXXX--X---X-------------[]----[]------<>-----------------------<>--[]----------------------------------------------------------E----------------------------------------<>--[]----------------------XXX--XX---E-------XSX-----------------E--X-------------------EXXX--------XX---------------E--------[]-------[]---------------[]-XX-S--------EE---------------------------------------------SSSSSSSSSSSSSSSSS----------X--------------<>--[]--[]------------------XXXX-------EXX----------------<>------<>--------------------------------[]------------------------
-----------X---XXX------------------------------------o------------------------------------------------XXX------------------E--XXXXX-------X---------------------------------------XXX-------------------------------------------------------<>---------[]-------------------------XXXXX-----------------------EXXXX-------------E---------------------------------------E-------------[]----------------------------------[]----------------------[]--[]---------[]----[]-----------------------------------<>-----XXXX------------------------------------------------XXXXX-XX---------------------------------------------[]--[]-XX---------------------[]------X----------<>-----<>-----XXXX-------------XXXXX-------XXX-----XXXX-------------XXXX--Q--<>------------------------------------------ESS-----------XXX------------------o-----------------------------------[]-----------------------------------------------------------------------------------------[]----[]---------------XXXXX--X---X-------------[]----[]------[]-----------------------[]--[]---------------------------------------------------------<>----------------------------------------[]--[]---------------------XXXX--XXXX-----EXX-XSX--------------------X------------------XXXXX-------XXX--------------<>--------[]-------[]---------------[]-XXXS-------------------------------------------------------SSSSSSSSSSSSSSSSS----------X--------------[]--[]--[]-----------------XXXXX------XXXX----------------[]------[]--------------------------------[]------------------------
--E------X-XX--XXXX-----------------------------------XX-------ooo-------------------------------------------------------------XXXXX------XX--------------------------------------XXX----S-SSS------E------------------------------E-EE------[]-------E-[]------------------------XXXXXX--E----------E---------XXXXX-------------------------------------------------------------E-EE--[]----E--------------EE-E-----------[]--------------E-------[]--[]---------[]----[]----E----------------E--E-EE-E--EE-[]----XXXXXX------------------------------------E--------XXXXXXX-XX---------------------------------------------[]--[]-XX--------------E-EE---[]------X----E-E-E-[]-----[]----XXXXX------------XXXXXX-SS?S?XXXX----XXXXX------------XXXXX-----[]----------------SS------------------------SSS-E-----------------ooo---------XXX------------------------------E---[]---------------E-E----------------------------------------------------EE-E-----EE-E------[]----[]-E----X--E----XXXXXX--X--XX----EE----E--[]-E--[]------[]-E---------------EE-E--[]--[]--E-E-------EE-------------------------------------E-----[]-E------------------------------E--E----[]--[]-------------E------XXXXX--XXXX-----XXX-XS-----------E-----EE--X--------------E--XXXXXX------XXXX-----EE-EE----[]-----E--[]-E--EE-[]-E------EE-E---[]-XXXS-----------------------E---XXXXX-----------------------SSSSSSSSSSSSSSSSS----------X------E-----E-[]--[]--[]------------EE-XXXXXXX-----XXXXX-----E-EE-EE-E--[]------[]--------------------------------[]-------------------E-EE-
XXXXXXXXXXXXXXXXXXXXXXXXXXXX-------------------------------X-X-XXX-------------XXXXX---XXXX-------XXX-----------XXXXXXXXXXXXX---XXXXXXXXXXXXXXXX-----XXXXX-XXXXXXXXXX---XXXX--XXXXXXXX-------XXXXXXXXXXXXXXXXXXXX--X-----XX--XXXXXXXXXXXXXXXXXXXXXXXXXXXXXXXXXXXXXXXXXXXXXXXX-XXXXXXXXX-XXXXXXXXXXXXX--XXXXXXXXXXXXXX--XXXXXXXXXX----------XXXXXXXXXXXXXXXXXX--XXXXXXXXXXXXXXXXXXXXXXXXXXXXXXXXXXXXXXXXXXXXXXXXXXXXXXXXXXXXXXXXXXXXXXXXXXXXXXXXXXXXXXX-XXXXXXXXXXXXXXXXXXXXXXXXXXXXXXXXXXXXXXXXXXXXXXXXXXXXXXXXXXXXXXXXXXXXXXXXXXXXXXXX--XXXXXXXXXX-----XX-XXXXXXX--XXXXXXXX--XX--XXXX-------XXXX-----------XXXXXXXXXXXXXXXXXXXXXXXXXXXXXXXXXXX-XXXXXXXXXXXXXXXXXXXXXXXXXXXXXXXXXXXXXXXXXXXXXXXXXXXXXXXXXXXXXXXXX---Q--XXXXXXXXXXXXXX------XXXXXXXX-XXXXXXXXXXXXXXXXXXX----------XXXXXXXXXXXXXXXXXXXX--XSX--XXXX-------------XXX-------XX---XXXXXXXXXXXXXXX-XXXXXXXXXXXXXXXXXXXXXXXXXXXXXXXXXXXXXXXXXXXXXXXXXX--XXXXXXXXXXXXXXXXXXXXXXXXXXXXXXX--XXXXXXXXXXXXXXXXXXXXXXXXXXXXXXXXXXXXXXXXXXXXXXXXXXXoXXXXXXXXXXXXXXXXXXXXXXXXXXXXXXXXXXXXXXXXXXXXXXXXXXXXXXXXXXXXXXXXXXXXXXXXXXXXXXXXXXXX----XXXXXXX----XXXXXXXXXXXXXXXXXXXXXXXXXXXXXXXXXXXXXXXXXXXXXXXXX--XXX--XXXXXXXXXXXXXXXXXXXXXXXXXXXXXXXXXXXXXXXXXXXXXXXXXXXXXX-XX---XXXXXXXXXXXXXXXXXXXXXXXXXXXXXXXXXXXXXXXXX----XXXXXXXXXXXXXXXXXXXXXXXXXXXXXXXXXXXXXXXXXXXXXXXXXXXXXXXXXXXXXXXS---XXXXXXXXXX--XXXXXXXXXXXX----------------------------XXXXXXXXXXXXXXXXXXX-XXXXXXXXXXXXXXXXXXXXXXXXX-XX--XXXXXXXXXXXXXXXXXXXXXXXSX-XXXXXXXX-XXXXXXXXXXXXXXXXXXXXXXXXXXXXXXXXXXXXXXXXXXXXXXXXXXXXXXXXXXXXXXXXXXX-----XXXXXXXXXXX