------------------------------------------------------------------------------------------------------------------------------------------------------------------------------------------------------------------------------------------------------------------------------------------------------------------------------------------------------------------------------------------------------------------------------------------------------------------------------------------------------------------------------------------------------------------------------------------------------------------------------------------------------------------------------------------------------------------------------------------------------------------------------------------------------------------------------------------------------------------------------------------------------------------------------------------------------------------------------------------------------------------------------------------------------------------------------------------------------------------------------------------------------------------------------------------------------------------------------------------------------------------------------------------------------------------------------------------------------------------------------------------------------------------------------------------------------------------------------------------------------------------------------------------------------------------------
-------------------------------------------------------------------------------------------------------------------------------------------------------------------------------------------------------------------------------------------------------------------------------------------------------------------------------------------------------------------------------------------------------------------------------------------------------------------------------------------------------------------------------------------------------------------------------------------------------------------------------------------------------------------------------------------------------------------------------------------------------------------------------------------XX---------------------------------------------------------------------------------------------------------------------------------------------------------------------------------------------------------------------------------------------------------------------------------------------------------------------------------------------------------------------------------------------------------------------------------------------------------------------------------------------------------------------------------------------------------------------------------------------------------------------------------------------------------------------------------------------------------------------------------------------------------------------------
--------------------------------------------------------SSSSSSSSSSSSSSSSS-------SS------------------------------------------------------------------------------------------------------------------SSSSSSSSSSSSSSSSSSSSSSSSSSSS--------------------------------------------------------------------------------------------------------------------------------------------------------------------------------------------------------------------------------------------------------------------------------------------------------------------SSSSSSSSS----SSSSSSSSSSSSSSS----------------------------------------------------------------------------------------oo----------------------------------------------------------------------------------------------------------SSSSSS------SSSSSSSSSSSSSSSS-------------------------------------------------------S-------------------------------ooo----------------------SSSSSSSSSSSSSSSSSSS----SSSSS--------------------------------------------------------------------------------------ESSSSSSSSSSSSSSSSSSSSSSSSS-----------------------------------------------------------------------------------------------------------------------------------------------------------------------------------------------------------------------oo---------------------------------------------------------------------------------------------------------------------------------------------------------------------------------------------------------------------------------------SSSSSSSSSS------------------
-------------------------------------------------------------------------------------------------------------------------------------------------------------------------------------------------------S-------?oS--SSS-SS----oS--------------------------------------------------------------------------------------------o--------------------------------------------------------------------------------------------------------------------------------------------------------------------------------------------------------------------------------------SSSS------------------------------------------------------------------------------------------------XXXX-------------------------------------------------------------------------------------------------------------------------------------------------------------------------------------------oS-------------------------------XXXX---------------------SSSSS----Q------SS--------oS--------------------------------------------------------------------------------------SSSSSSSSSSSSSSSSSSSSSSSSSS----------------------------------------------------------------------------------------------------------------------------------------------------------------------------------------------------------------------XXXX---------------------------------------o-----------------?--------------------------------------------------------------------------------------------------------------------------------------------------------------------------------------------------------
------oo--------------------------------------------------------------------------------------------------------------------------------------------oo--oo-------oooo----------------------------------SS-------SS--SSS-SS----SS----------------------------X---------------------------------------------------------------------------------------------------------------------------------------------------------------------------------------------------------------------E------------------------------------------------E-------------------------------SSSS---------------------------------------------------------------------------------------------------------------------------------------------------------------------------------------------------------------------XX------------------------------------------------------------------------ES--------oo----------------------------------------------SSSSS-EE---------S---------S-------------------------------------------------------S----------------------------X-SSSSSSSSSSSSSSSSSSSSSSSSSS-----------XXX-----------------------------------------------------------------------------------------------------------------oo-----------------------------------------------------------------------------------------------------------------------------------------ooooooooo-------------------------------------------------------------------------oooooo--------------------------------------------------------------------------------------------------------------------------
----------------------------------------------------------SQQQ---------------SSS-------------------------?-E-----------------------------------------------------XXXX--------------------------------S-QS---------------SS-----S------------------------------SSSS---------QQQQ--?------------------SSSSSSS-------SS----------XXXX----E--------------------------------------SSS------------------------------------XX---------------------SSS------------------------------SS--SSSSSSSS----SSS-----------------?-----------------SQS----S-----------------------SSSSSSSSSQS---------------SSS---S---------------------------SSSSS------------------SS--SSSSSS---SS-----------------SS---------S-----------SS--SSS-------SSS--S---SS??--S-------------S-----------------------------o----------oo-------------S-SSSS-------------SSSSS--------------------------S---SS----------XX---------------------------------------------S--S---SS-------o-S----S-SSSS----------------------XXX---------E-------------SS--------S-QS---------------SSS-SSS---SSS-SSSSSSSSSSSSSSSSSSSSS---------------------------------------XXXX-----------------------------SSSSS-----QQ----------------------------SS------XXX------------------S-?--------------SSSSSS-----S--------------------------S?SSS---SQX-----------------------------------------------------XXXX----------------SSSSS---?------------?--------SS---S---------------E---S-----Xo---------------XXX-----------------------------------------------SSSSSS--------------------------------------------------------------
------------------------------------------------oo---------------------------SS----------------------------------------E----------------------------------XX-S---------------------------------------S------------------SSS-------------------------------------------------------------------------------------------XXXX-----------------------------------------------------------------------------------------------------------------------------------------------------------------------------------------XXX--------------------------------------------------------------------------XS----------------oooo-------------------------------------------XXX---------------------------------------------------------------S------------------------------------<>----------XX--o---------------------------------------------------------------oo----------SS----------------------------------------------------------------SS--------------S-SS-----------------------------------<>-------------SS-------------------------------------S-----------------------------------------oo------------------------------------------------------------------------------------------------X-----------------------------------------------------------------------------------------------XXX------------XX-S--------------S----------XXX------------------------------------------------------------------------<>----XX--------------------------------oooo------------------------------------------------------------------------------------------------------
------------------------------------------------------------E----------------S----------------------------------X--XXXXX-----------------------------------------------------------------------------S-------------------SS----S------------------------------SS---------------------------------------------------------------------------o--------------------------------------------------------------------------------------------------------------------------------------------------------------------------------------------------------------------------------------------------XX------------------------------------------------------------------------------------------------------------------------------------------------------------------------[]----------XX-XXX-----SS-------------------------------------------------------------------S-------------------------------------------------------------S---SS------SSSSS--SS-SS----------------oo-----------------[]-------------SS-----------------------------------S-S------------------------------------------------------------------------------------------------------------------------------------------------------o-------------------------------------------o-------------------------------------------------------XX--------------XX----------------------------------XX--------------------------------------------------[]------------------------------------------------------------------------------------------------------------------------------------------------
--------------XXX------------------E--S---------------------------------oo-SSSSS-----------------------------------------------------------------------------------------SSSQ-----------------X--oooo---------------oooooSS--ESS------------------------------SS---------------------------------------------------------------------------------SSSS---------------oo---------------------E----------X-S---SSS------------E------------------------------------------------------------------X-X-----------------------S-------------------------------------------------------------------X--------------------------------------oo---SS-SSS------X------------------------E-----------------------------E-------------------ooo-S----------------SS------------------[]------------------------------------o----------SSS--------------------------E-------------S----SSSSSSS----------------SSSS---------------E-----------X-oSoo-SS----So?--SS-----SSSS---------------------o---o-----SS[]-------------SS---------oo-------------?--S---------So----S-------o-oo---ooooS--------E---------E---------QSSSSSS-S------------------------------E--------------------------------E--o------------------------------------------------------------------------------------------------------------------------XXX--------------XXS-------Q------------------XXX-----------------------------------o-----So-------------[]--o------XXXX-----------------------E-----------------ooo--------------E------------------------------------------------------------------------
---EEEE-EE-E----------------------<>-----E--<>-QQQ--------SSS---------------------------------?-----XXXX-------Q--------ooooo------------------------XXX--------------------------------------X-------S----E-XX----SSSSSSS--SSSS-------------------------------SSS--SS-----QQQQ--QQQQ------------------------SS------------------XX------SS---------------XXS----E-----------QQQ--E-------<>---------XXX----------XXXX----<>----------------E------------------X--oS-------XX--X-----S-----X---------S?S-X--XXXXX----------E---QQQQQQ--QQQ--------------X-------SSSSSSSSSSSSSS-Q-----------XXX-XX----------X-----------E--------ooo----------------XXXXXXX--SSS-------------<>------S---------SS----------<>--------------SS--SSSSSSS---------------SS-------E--Q--S----------------S---------------------------SSSS---oo---E------------------------<>-----XX------SSS-------------S--------------------S----S---<>----------XX-SSSS--SS---SSX--SS---X-SSSS-------XXXXXXX------------XX---SS[]SS-----E----------?SS--SSSSE-------------------S----SSS--SS----------SS--SSSS---E----<>-----E--<>---------------------------------------XXX-----<>--------------Q----------------<>----------------XXXXXXXX---------------ooo------------------------QQ-----------------------X--------XXX--XXX---------------XXX-------SSS----XX---------------XXXXXXXXX---------------------S------QXXX---------SSQ---SSS------------[]-----------------------------XXX---<>-------------E-------------------<>----QQ----Q-----------------------E----------Q--------------Q-----------
XXXXXXXXXXXXXXXX--------XXXX------[]----<>--[]----------------------------------E-------------------------------------------E---------------------------------E------o-o--------------------XXX---------X-<>-XX-------------E------------E----------------SS---------------------------------------------------------------------XX--X---------X----------E-----<>------------------------[]--------XXXX------------------[]----------E----<>---------------E--X---------XXXX--XX--E-------X------------------------------<>---------------------E------X---------------------------------XXXX-XX---------XX----------<>----------E---------------XXXX--XX---------o--------[]---------------XS-----------[]------E----------------------------------------------------------------------------------------XXXX-------------E--E-E--E----------------[]-----XX----E----------------------X---X--------------------[]--E------XXX---------XXX--XX--------E-SS--XXX------------------------------------<>-------------------------------------------------SS--------------------<>----[]----<>--[]---------------------------------------XXX-----[]-------------------------------[]------------------------------------------------XX---X------------------------------------XX-------------------------------XXX------E------XXX------------------------------------------------------------------------------------X-[]--X-----------?------E-------------[]------------<>-------------------[]---------------------------E-----<>------E------------------------------
XX---------------------XXX--------[]----[]--[]------------------------------------------E----------------------------------XXX-------------------------XXXXX--XXXX--XXXX--------------------XXX---------X-[]-XXX----------------------<><>-----------------S---------------------------------------------------------------------X---X---------X----------------[]------------------------[]-------XXXXX------------------[]---------<>----[]--------------<>--X--------XXXXX--XXX-----E---X------------------------------[]--------------------<>------X--------------------------------XXXXX-XXX-------XXX----------[]-------------------------XXXXX--XX--------XX--------[]-----------<>-XXX-----------[]-----<>---------------------------------------------------------------------------------------------------------------------E------------[]----XXX-----------------------X---X------------------------[]-<>--<>-XXXX--------XXXX--XXX---------SSXXXXX------------------------------------[]-------------------------------------------------SS--------------------[]----[]----[]--[]--------------------------------------XXXX-----[]---------------X---------------[]-----------------------------------------------XXX---XX-----------------------------------XX--------------------XXXX-------XXX------------XXXX---------------------------XXX-----------------------------------------------------XX-[]--X----o-------------E---E---------[]------------[]-------------------[]--------------------------<>-----[]-----<>------------------------------
------------------------------E---[]-E--[]--[]-------EE--EE------------------------------------------------------------------------X------------XXXXXXXXXX----------------------------------XXX-----E---X-[]-XXX-------E---------EE-E-[][]---------------E---------------------E-EE--------E-----E-E---------EE---XX-------------XX--X---------X----------------[]---------------------E--[]------XXXX-X------------------[]---------[]----[]-----E--------[]--X-------XXXXXX--XXXX--------X-------ooo--------------------[]------------------E-[]------X-------------E------------EE---XXXXXX-XXXX--EE-XXXX------E-E-[]-E----------------------XXXXXX--XX---EE---XX-E-EE-E-[]----E------[]--XXX---EE-E---[]-----[]--EE-E------E--------------------EE------------------------E-EE----------------------------------------------------------E-EE-----[]----XXX-----------------------X---X-----------E-EE------E--[]-[]--[]XXXXX--EE---XXXXXE-XXXE-------E--XXXX---------------------------E-E-------[]-------E------E---------E-E-----E----------------SS-----------EE-------[]----[]----[]--[]------------------------------------X--XXX---E-[]--E----------------------------[]----------------------------------------------XXXX---XXX----------------------------------XX-------------------------------XXX------------XXXX----E------Xo---------------------------------------------------E-EE-E---------EE-XXX-[]--X--------------------------X--E--[]----E-----E-[]------------EE-E-E-[]---------EE---------------[]-----[]-----[]----------------------E-------
----------------------------XXXXXXXXXXXXXXXXXXXXXXXXXXXXXXXXXXXXXXXXXXXXXXXXXXXXXXXXXXXX-------------------XXXXXXXXXXXXXXX-X-------X-XX-X-XXXX--------------------------XXXXXXXXXXXXXXXXXXXXXXXX--XXXXXXXXXXXXXXXXXXXXXXXXXXXXXXXXXXXXXXXXXXXXXXXXXXXXXXXXXXXXXXXXXXXXXXXXXXXXXXXXXXXXXXXXXXXXXXXXXXXXXXXXXXXXXXXXXXXX-XXXX-X-XE-XX--XXXXXXXXXXXXXXX--XXXXXXXXXXXXXXXXXXX---XXXXXXXXXXXXXXXXXXXXXXXXX-X-XXXXXXXXXX---X--XXXX--XXXX---XXXXXXXXXXXXXXXXXXXXXXXXXXX--XXXXXXXXXXX--XXXXXXXXXXX-X------XXXX-------------XXXXXXXXXXXXXXXXXXXXXXXXXXXXXXXXXXXXXXX-XXXXXXXXXXXXXXXXXXXXXXXXXXXXXXXXXX--XXXXXXXXXXXXXXXXXXXXXXXXXXXXXXXXXXXXXXXXXXX---XXXXXXXXX--XXXXXXXXXXXXXXXXXXXXXXXXXXXXXXXXXXXXXXXXXXXXXXXXXXXXXXXXXXXXXXXXXXXXXXXXXXXXXXXXXXXXXXXXXXXXXXXXXXXXXXXXXXXXXXXXXXXXXXXXXXXXXXXXXXXXXXXXXXXXX-XXXX------XXXXXXXXXXXXXXXXXXXXXXXX--XXXXXXXXXXXXX--XXXXXXXXXXXXXXXXXXXXXXXXXXXXXXXXXXXXXXXXXXXXXXXXXXXXXXXXXXXXXXXXXXXXXXXXXXXXXXXXXXXXXXXXXXXXXXXXXXX-----------XXXX-XXXXXXXX----XXXXXXXXXXXXXXXXXXXXXXXXXXXXXXXXXXXXXXXXXXXXXXXXXXXXXXXXXXXXXXXXX--XXXXXXXXXXXXXXXXXXXXXXXXXXXXXXXXXXXXXXXXX--XXXXXXXXXXXXXXXX----XXXXXXXXXXXXXXXXXXXXXXXXXXXXXXXXXXXXXX-------XXXXXXXXXXXX-X-XXXXXX---XXX------XXXXXXXXXXXX--XXXXXXXXXXXXXXXXXXXXXXXXXXX--XXXXXX-X-XXXXXXXXXXX-XXX-XXXX-XXXXXX------X---------------XXX-XXXXXXXXXXXXXXXXXXXXXXX---XXX----------------------XXXXXXXXXXXXXXXXXXX---XXXXXXXXXXXXXXXXXXXXXXXXXX--XXX-XX--------------XXXXXX-X-X----XXXXXX-XXXXXXXXXXXXXXXXXXXXXXXXXXXXXXXXXXXXXXXXXXXXXXXXXXXXXX-Q-XXXXXXXXXXXXXXXXXXXXXXXXXXXXXXXXXXXXXXXXXXXXX-XX