------------------------------------------------------------------------------------------------------------------------------------------------------------------------------------------------------------------------------------------------------------------------------------------------------------------------------------------------------------------------------------------------------------------------------------------------------------------------------------------------------------------------------------------------------------------------------------------------------------------------------------------------------------------------------------------------------------------------------------------------------------------------------------------------------------------------------------------------------------------------------------------------------------------------------------------------------------------------------------------------------------------------------------------------------------------------------------------------------------------------------------------------------------------------------------------------------------------------------------------------------------------------------------------------------------------------------------------------------------------------------------------------------------------------------------------------------------------------------------------------------------------------------------------------------------------------
-------------------------------------------------------------------------------------------------------------------------------------------------------------------------------------------------------------------------------------------------------------------------------------------------------------------------------------------------------------------------------------------------------------------------------------------------------------------------------------------------------------------------------------------------------------------------------------------------------------------------------------------------------------------------------------------------------------------------------------------------------------------------------------------------------------------------------------------------------------------------------------------------------------------------XXX--------------------------------------------------------------------------------------------------------------------------------------------------------------------------------------------------------------------------------------------------------------------------------------------------------------------------------------------------------------------------------------------------------------------------------------------------------------------------------------------------------------------------------------------------------------------------------------------------------------------------------------------
------------------------------------------------------------------------------------SSSSSSSSSSSSSSSSSSSSSSSSSSSS--------------------------------------------------------------------------------------------------------------------------------------------------------------------------------------------------------------------------------------------------------------------------------------------------------------------------------------------------------------------------------------------------------------------------------------------------------------------------------------------------------------------------------------------------------------------------------------------------------------------------------------------------------------------------------------oo--------o---------------------------SSSSSSS-------------------------------------------------SSSSSSS----SSSSSSSS------XSS------------------------------------------------------------------------------------------------------------------------------------------------------------------------------------------------------------------------------------------------------------------------------------------------------------------------------------------------------------------------------------------------------------------------------------------oX--------------------SSSSSSSSSSSSSSSSSSSSSSSSSSSS----------------------------SSSSSSSSSSSSSSSSS---SSSSSSSSSSSSSSSSSSSSSSSSSSS-SSSSSS----------------------------------------------------------
---------------------------------------------------------------------------------------------------------------S--------------------------------------------------------------------------------------------o-----------------------------------------------------------------------------------------------------------------------------------------------------------------------------------------------------------------------------------------------------------------------------------------------------------------------------------------------------------------------------------------------------------------------------------------------------------------------------------------------------------------------------------------------------------------------------oo--------------------------------------------------------------------------------------------------------------------------------------------------------------------------------------------------------------------------------------------------------------------------------------------------------------------------------------------------------------------------------------------------------------------------------------------------------------------------------------------------------------------------------------------------------------------------o----X---------------o-oo-SSSSSSSSSSSSSSSSSSSSSSSSSSSS-------------------------------SSS------------------------SSSS-----?oS--SSS-SS--SSSS--------------------------------------------------------
-----------------------------------------------oooo---------------------------------------------------------------------------------------------------------------------------------------------------------------------------------------------------------------------------------------------------------------------------------------------------------------------------------------------------------------------------------------------------E--------------------------------------------------------------------------------------------------------------------------------------------------------------------------------------------------------------------------------------------------------------------------------------------------------------------------------------oo---------------------XX----------------------X---S-------------------------------oo--oo----------------E--------------------X-X------E---------------------------------------------------------------------------------------------XXX--------------------------------------------------------------------------------------------------------------------------------------oo--oo---------------------------------------------------------------------------------------------------------------------------E----E---?------------------------------------------------S------------------------SSSSSSSSSSSSSSSSSSSSSSSSSSSSS-------------------------------SSS--E---------------------SSSS--E---SS--SSS-SS--SSSS------------------E-------------------------------------
---SSSS--------------------------ooo-----------XXXX----------------------------XXX------------------------------o--------------------------------------------------S----SSS-----?SSS-----E--?-------E-----oo--XXXXoo---o?-------------------------------------------------------------------------------SSSS--------------S---?--S------------------?SSS---SSSS----------------------------------------------------------------------S?S-------------S--SSSSS--S----------SSS-----S?--------------S-----------------------------------------XXX-----------------------------SSSSQ-----------------SSSSS---------------------------------------------------------------------------------------------------------------------S--------------------------------------------------SS-----------XXXX----------------SSS-----E--S---Soo-----oo-----S-Q-----------SS-----S----oo----------------------------E--E-------oooooo------XXX---SSSSS----SSSS-----------S----------------SSS--------------------------E----------E-------E--------oo----------S---------------SS---------SSS--Q---------------SSSS------------------SSS---------S----------QQQ--------------------------------------------------------------XXX-----------------------------------------------------------------------------------------oS---SQS-S??----------------------------S----SS-----------S----SS-------------SSS---SSSSSSSSSSSSSSSSSSSSSSSSSSSSS-------------------------------S-----------------?-S-------S----SS------Q---SS------?SSS-------SSSSSSSQSSSSS--------------------------------
----------------------------XX------------E------------------------------------XX-----------------------------------------------XSS-----------------------------------------------------<>----------X----XX----------------XXX------------------------------------------------------------------oo--------------------------------------------------------------------------------------------------------------------------------------------------------------------------------------------------------------------------------------------------------------------------------------------------------------------------------------------------------------------------------------------------------------------------------------------ooo-------------------------------------XXXX------------SS---------------<>-------------------------------------------------------------------------------XXXXX----------------------------------------------------------------oo-------------------------------------E------<>----------------XXX-----------------------------------------------------------------------------------------------------------------------------------oooo------------------------XXX--------------------------------XX------------------------------------------------------XX----S---------------------------------------------------E-----SS-------------------------------------------------------------------------------S---------------------------S----SS----------SS-----------------------------------------------------X--------
-----------------------------------------<>----------------------------------X-XX----------------------------------------------XXX-----------------------------E------------------------[]---------------------------------------------------------------------------------------------------------------------------------------------------------------------------------------------------------------------------o------------------------------------------------------------------------------E---------------------------------------------S---------------E-----------------------------------------------------------------XX-S----------------------XSS------------------------------------------------------------------------------------------------------------------------------------X-----------------[]---------------------S-E----------------------------------------------------------------SSSSSS--------------------------------------------------------------------------------------E-------------[]--------------------------------------------------------------------------------------------------------------------------------------------------------------------------------X-XX----------------------E----------o------------------------------------------------------XXX--------------------------------------------------------SS----S-----------------<>-------------------------------------------------------------S-------------------------S-S----S-----------SS-----------------------------------------------------oX--XXXX-
-----------oo---oo---SSSSS--------XXXXXX-[]--------------oo------------------X-XX-----E-----------------------------oo-------XXXXS----------S--------E--------<>-----S-S----------------[]------E--o-------------------XXXX---------------------<>---------o-------------------------E------------E---------------XX---------------E----SSSS----------------------------------------------------------------------------------------------------------S------------------------------------------------------------------------------------------XS--------S-----<>----------------------------------------------------------------XXX-S---------------------XXX-------------------------------o---------------------------------------------------E--------------------------------Q---------------XSS--Q-------------[]---------------------S------E------------------XXX-----------------S---------------------SSSSS----------------------------------------------------E--------------------------------<>-------------[]-----------------------------------------------E-------------------------------------------------E-----------------------------E----------E--S------E-----------o---oo---------XXXXX----------SSS--------SS----------------------------------------------------------------XXXXE-------------------------------------------------------------SS----------<>----[]-------------E-EE-------------------------E----------S-------SoS-------------------------So?o---------ooooSS---oo-----------------------EE-------------------XXS----------
--ESSS----------------------XXX----------XXX--XXXXXXX--------------S-------X-X-XX----<>----------------SS--------o-oo-------XXXXX--------------E----<>------SS[]-----E-----------S?S----[]-----<>-------------XXXXXXXXX----------------------E--[]--------SS---------------S--------<>------E----<>--------------XXXQ-Q---S-------<>---------------QQQ-------X--XX-------------------------------------------------SS----------------QSQ-------------SS-------SS---------QQQQ---------------------S?S--------X----------------------------------XXX-----------E--[]--------SSSS--Q------------------------------------------S-----XXXX----------------------XXXX---------------------------------ooo-------X-----------------------Q-Q---Q-Q------<>---S---------E-----S---------------------------XXXX---------------SXXS---------XX----XX---SSS---<>---E-QQQ-------------------XX---<>------------------------------------X------QQQ-----E---S--------------------------<>-----------X--------------------[]-------------XXX---------XXXX-----QS--------------QQ?--QQQ----QS--SSS---E-------------------------------E--S---<>---Q-----------SSS----------<>------E--<>-----E--<>-------------------------XXXXXX--------------------XXXX----S-----X-----------------------------QQ------------E-------XXXXXXS--S?S-------E-------E----------------Q-----------S---------SSS--S----E--[]----[]SS---X--SSSSSSSSSSS--SSSSSSSS---------Q--<>-------E----------SSS-----------Q---Q---------SSS--SSS-----SSSSSSS-SSSS--SS-------XX--X-----SSSS----o------------XXX--XX-------
---------------------------------------------------------------------------X-X-XX----[]---------------------X-X------------XXXXXX----------X--<>----[]--------[]----<>-------------------------[]-------------------------------------------<>--[]----------------------------------[]-----<>----[]-------------XXXX--------------[]-----------------------XXX--XX---------S------------------------------------------------XX--------------------------------SS--------------------------EX--------------E--X--XX-----------------------------XXXX----------<>--[]-----E--------------------------------------------------------EXXXX-X-------------------XXXXX------------------------------------------XX--X-----------------------------------[]------------<>--------E------E----------------XXXXX-SSS--SS-----------------E-------------------[]--<>----------------------------[]--E------XXX----------------------X-X-------------<>------------------------------[]----------XX-------------<>-----[]--------E--------------------------------------------------------------<>----------------X-------------<>------[]----------------------------[]-----<>--[]----<>--[]------------------------XXXXXXX-------------------XXXXX---------XX-------XX-----------------oo-----XXX-?----<>-----EXXXXXX-------------<>------<>-----------------------------------------------<>--[]----<>SS-oXXX-SSSSSSSSSSS----------------------[]------<>------------------------------------------------------------------------XXXX--XX--EEEE------------------XXXX--XX-------
--------------------------------o---------------------o--------------------X-X-XX----[]---------------------X-X-----------XXXXXXX-------o-EX--[]----[]--------[]----[]-------------------------[]--X----------------------------------------[]--[]----------------------------------[]-----[]----[]-----------EXXXXX--------------[]----------------------XXXX--XXX-------------------------------------------------E-------XX--------------------------------SS--------------------------XX-------------E-X-X---X----------------------------XXXXX----------[]--[]----<>--------------------------------------------------------XXXXX--------------------XXXXXX-----------------------------------------XXX--X-----------------------------------[]------------[]--------------<>---------------XXXXXX------------------------<>-------------------[]--[]----------------------------[]-<>------XXX----------------------X-X-------------[]------------------------------[]---------XXX-------------[]-----[]-------<>--------------------------------------------------------------[]----------------X-------------[]------[]-<>-------------------------[]-----[]--[]----[]--[]-----------------------XXXXXXXX------------------XXXXXX--------XXX------XXXXXXXXXX---X-----XXX--------------[]-----XXXXXXX-------------[]------[]-----------------------------------------------[]--[]----[]SSooSXX--SSSSSSSSSS----------------------[]------[]-----------------------------------------------------------------------XXXXX--XX---------------------XXXXXXX--XXX------
-E---------------------E-E-----XXX-------------------XXX----------------E--X-X-XX----[]-----------------EE--X-X----------XXXXXXXXSSSSS---XXX--[]---E[]--------[]----[]-----------------------E-[]--X------oooo-------------------EE-E-------[]--[]---------------EE-E--E--E---------[]--E--[]----[]-----------XXXXXX--------------[]---------------------XXXXX--XX----EE---X-------E--------------E-------------------------XXX-----E-E--------E-E---E-------ESS--------EE---------------XXX-----------------X--XXXX-------------------------XXXXXX----EE-E--[]--[]----[]--------------------------------------------------EE--XXXXXXX----------E-----E--XXXXXXX--SS----------------------------E-------XXXX--X----------------------------EE-E---[]-----E-EE-E-[]-E-----X----E-[]------------X-XXXXXXX--SSS?------------------[]------------EE-----[]--[]----------------------------[]-[]------X----EE-E-E--------E-E-E-X-X-------------[]----------E-E----E---------E--[]----------------E--------[]-----[]-------[]-------------------------E------------------E-E------E--------[]---------------XX----E-E------[]E-----[]-[]--X------EE-E--------E---[]-----[]--[]----[]--[]----------------------XXXXXXXXXX----------------XXXXXXXS------XXXX-E---XXXX----------X---E------------------[]---XXXXXXXXX----E--------[]------[]--------EE-E---------------E-E----E-E-------E--[]-E[]----[]SSXXXXXXX-S--SoSSSS------EE--------E-EE--[]------[]--------------------------E--E------E-----------------E-EE-------E----XXXXXX--XX----------X---------XXXXXX----XXX-EE---
XXXXXXXXXXXXXXXXXXXXXXXXXXXX----------------------------XX--XXXX--XXXX-XXXXXXXXXXXXXXXXXXXXXX---XXXXXXXXXXXXXXXXXXXXXXXXXXXXXXXX-S---XESXXXXXXXXXXXXXXXXXXXXXXXXXXXXXXXX---XXXXXXXXXXXXXXXXXXXXXXXXXXXX---XXXX------------------XXXXXXXXXXXXXXXXXXXXXXXXXXXXXXXXXXXXXXXXXXXXXXXXXXXXXXXXXXXXXXXXXXXXXXXXXXXXXXXXXXXXXXXXXXXXXXXXXXXXXXXXXXXXX---XXXXXXXXXXXXXX--XXXXXXXXXXXXXX-XXXXXXXXXXXXXXXXXXXXXXXXXX---XX-X--XXXXXXXX--XX-XXXXXXXXXXXXXXXXXXXXXXXXXXXXX--XXX---XXXXXXXXXQ--XXXXXXXXXXXXXXXXXXXXXXXXXXXXXXXXXXXXXXXXXXXXXXXX----XX-XXXXXXXXXXX--XXXXXXXXXXXXXXXXXXXXXXXXXXXXXXXX----XXXXX--XXXXXXXXXX---XXX-XX-X-XXXXXXXXXXXXXXXX---XXXXXX--XXXXXXXXXXXXXXX--XSX------XXXXXXXXXXXXX-X-XXXX--XXXXXXXXXXXXXXX-XXXXXXXXXXXXX-XXXXXXXXXXXXXXXXXXXXXXXXXXXXXXXXXXXXXXXXXXXXXXXXXXXXXXXX------X-XXXXXXXXX-----XXXXXXX--XXXX----XXXXXX---------XXXXXXXXXXXXXXXXXXXXXXXXXXXXXXXXXXXXXXXXXXXXXXXXXXXXXXXXXXXXXXXXXXXXXXXXXXXXXXX-XXXXX-XXXXXXXXXXXXXXXXXXXXXXXXXXXXXXXXXXXXXXXXXXXXXXXXXXXXX-XXXXXXXXXXXXXXXXXXXXXXXXXXXXXXXXXXX-------------------X-XXXXXXXXXXXXXXXXXXXXXXXXXXXXXXXXXXXXXXXXXXXXXXXXXXXXXXXXXXXXXXXXXXXXXXXXXXXXXXXXXXXXXXXXXXXXXXXXXXXXXXXXXXXXXXXXX-[]-XXXXXXXXXXXXXX-X-XXXXXXXXXXX---XXXXXXXXXXXXXXXXXXXXXXXXXXXXXXXXXXXXX-----EXXXXXXXXXXXXX-----------X----X-X-XXXX-----XXXXXXXXXXXXXXXXXXXXXXXXXXXXXXXXXXXXXXXXXXXXXXXXXXXXXXXXXXXXXXXXXXXXXXXXXXXXXXXXXXXXXXXXXXXXXXXX-X-XXXXXXXXXX-XXXXSXXXXXXXXXXXXXXXXXXXXXXXXXXXXXXXXXXXXXXXXXXXXXXXXXXXXXXXXXXXXXXXXXXXXXXXXXXXXXXXXXXXXXXXXXXXXXXXXXXXXXXXXXXXXXXXXoXXXXXXXXXXXXXXXXXXXXXXXXXXXXX-----XXX--XXXX