-------------------------------------------------------------------------------------------------------------------------------------------------------------------------------------------------------------------------------------------------------------------------------------------------------------------------------------------------------------------------------------------------------------------E----------------------------------------------------------------------------------------------------------------------------------------------------------------------------------------------------------------------------------------------------------------------------------------------------------------------------------------------------------------------------------------------------------------------------------------------------------------------------------------------------------------------------------------------------------------------------------------------------------------------------------------------------------------------------------------------------------------------------------------------------------------------------------------------------------------------------------------------------------------------------------------------------------------------------------------------------------------------------------------------------------------------------------------------------------------------------------------------------------------------------------------------------
------------------------------------------------------------------------------------------------------------------------------------------------------------------------------------------------------------------------------------------------------------------------------------------------------------------------------------------------------------------------------------------------------------------------------------------------------------------------------------------------------------------------------------------------------------------------------------------------------------------------------------------------------------------------------------------------------------------------------------------------------------------------------------------------------------------------------------------------------------------------------------------------------------------------------------------------------------------------------------------------------------------------------------------------------------------------------------------------------------------------------------------------------------------------------------------------------------------------------------------------------------------------------------------------------------------------------------------------------------------------------------------------------------------------------------------------------------------------------------------------------------------------------------------------------------------------
----------------------------S-------S-------------------SSSSSSSSSSS-------SSSSSSSSSS-----------------------------------------------oo------------------------------------------------------------------------------------------------------------------------------------------------------------------------------------------------------------------------------------------------------------------------------------ooo------------SSSSSSSSSSS--------------------------------------------------------------------------------------------------------------------oo-------------------------ooo---------------------------------------------------------------SSSSSSSSSSSSSSSSSSSSSSSSSSSSSSSSSSSSSSSSSSSSSSSSSS-----------oo------------------------------------------------------------------------------------------------------------------------------------------------------------------------------------------------------------------------------------------------------------------------------------------------------------------------------------------------------------------------------------------------------------------------------------------------------------------------------------------------------------------SSSSSSSSSSSSSSSSSSSSSSSSSS-------------------------------------------------------------------------------------SSSSSSS----------------------------------------------------------------------------------------------------------------------------------------------------------------------oo---------------------
------------X------------------------------------------------------------SSSSSS---------------------------------------------------XXXX--------------------------------------------------------------------------------------------------------------------------------------------------------------------------------------------------------------o-------------------------------------------------------Qooo-----------X------------------------------------------------------------------------------------------------------------------------------------------XXXX------------------------XXXX----------o------------------------------------------------------SSSSSSSSSSSSSSSS-----------------------------------------XXXX----------------------------------------------o--------------------------ooS---------------------------------------------------------------------------------------------------------------------------------------------------E----------------------------------------------------------------------------------------------------------------------------------------------------------------------------------------------------------------------------------------------------------------------------------SSSSSSSSSSSSSSSSS------------------------------------------------------------------------------------------------------------------------------------------------------------------------------------------------------------------------------------------------------------------------------E--E---------------
------oo-----------------------------------------------------------------SSSS-S----------------------------------------------------------------------------------------------------------------------------------------------------------------------------------------------------------------------------------------------------------------------------------------------------------------------------------o--------------------------------------------------------------------------------------------------------------------E--------------------------------------------------------------------------------E-----------------------------------------------SSSSSSSSSSSSSSSS----------------------------------X-----------------------------------------------------------------------------E------ES-----------------------------------------------------------------------------------------------------------------------------------------------XXX---o--oo--o----------------------------------------------------------------oo-------------------------------------------------------------------------------------------------------E---------------------------------------------------------------------------------------------X-SSSSSSSSSSSSSSSSS--------------------------------------------------------------------------------------------------------------------------------------------------------------------------------------------------------------------------------oo-------------------------------------------XXXXXX--------------
--------------------------X----SSQS--------------------------------------SSSSSSSS----------------------------SS?o-----------XXX--------------------------------X-----S------------------SSSSS----SSS?SSSS------SSS----S--------------------------SSSSS------------------S-------SSSSS---------------------------SSSS-----------------------SSSSSS?SSS-------XXX-----X-------SSSS------QQQQQ----------------S----XXXX---------------------------------------------------------------------SQQSSSS-------SSS---SSSSSSS----------------SSSSSSSSSSSSS---o---S-----------------------S---------S-S---------------S?SSS-----SQS----S----------SS-----------------------------SS-SSSSSSSSSSSSS-QQ-----------------------------------S-?-----------------------S--SS---SS-----X--S---------S-------------------SS---SSS----------------------------------------S-----------------S---QS------------------------SS----------------------------------------------QQQQ-oo------------XX------------------------------------------------SSS-------o---XX-------------------------------------------------------------------XXX--------XXX-------SSSS-------------S?--SSS----------------------------------------XXXX--------------------SQS----SSS--XX------SSSS---SS--SSSSSSSSSSSS--QQS----------------------S?SSS--------------SSS--------------------SQS---?SSS----------SSSS---QQS---------------QQSQ---------------------------------SSQQS----------------S---S--------E--S-----------------------------------XXX---SSS-S---QS------------------------------------------------S
--oooo----E------X-------------S------------------------------------S------------------------------------------------------------------------------------oo----XX---ES-----------------------------------------------------------------------------------XXX--------------------------------------------------------------------------------------------------X-------------------------------------------XX--------------E--------------------------------------------------------------XXX-------------------------------------------------------------------------------------------------------------------------------------------------------------------------------------------------------------------------------------------------oooo-----------------------------------------------------SSS---SS--------------------o-------------------------------------ES------------------------------------------------------------------------------------------------------------------------------------------------------XXX----------------------------------------------------------------------------------oo---XXS-----------------------------------------------------------------XX--------------E------------------------XXX-------------S----S-------------------ooo----------------------------------------------------------------------------------------------------------------------------------------------------------------------------<>---------------------------------------------------------------------------------------------o---------
-------XXXXXXXXX-X-----------SSS------------------------------------S----S-S--S-----------------------------XS-------------------------------------------------XX----S----------------------------E----------------------------------------------------o-oo----------------------------X----------------------------------------------------------------------------------------------------------------o------------o---<>------------------------------E-----------------------------o----------------------------------------------------------------------------------------------------------------------------------------------------------------------------------E---------------------------------------------------------------------------------------------------------------------------?SS---SS------X------------------------------------------E---------S----------------------------------------------------------------------------------------------------------------------------------------------------------------------------------------o-------------------------------------------------------XX--------SS------------------------------------------------------------------------X----------------------EXXXX----------SSSS----S----------------------------------------------------------------E---------------------------------------------------------------------------------------------------------------------------------[]---------------E--------------------------------------------------------------o------------------------
--------------------------XX---SoS----------------S----------------------SoS--So??-------------------------XXX--XQ-SSS-----------------------------------------XX---SS------------E---------------E------------------------------------------------------------SQ---------------------XX----E---------E-----------------------------------S-----SSSSSSS------------------------------------------------------------------[]-----------------------------<>--------oo------o--------------------------------------------------------------------E?---XXXSSS--------------------------------------------------S---------------------------------------ooo-------------------------------------------------------------E----------------------E-------------------------------------E---------------------SS---SS-------------------------SSS--------------S-----<>--------SS----S-----------SSSSS?----SSSSSSS------------------E-------------------------------------------------XXX-----------------------------------------------------XXX-------------o----E------------------SSSSS--------------------------oo---------XXX--------?E--------------------------SSSSSSSS-----------------E-------------------XXS--------------------XX-XXX-------------So??-SS-------------------------------------------------E------------<>-------E-----------------------------------------------------E-----------------------------------------------------SS-------E----[]-----E-----E--<>------------oooo------------------------------E----S------------------------------XS---
---XXX-------------------------SSS----------------------------------SSS--SSS--SSS-----E--------------------XXX-E----------------XXX--------------------------X-XX----------------<>--------S-----<>-------SSS-------------------------------XX-XX---SSSS-----------------------------XXX---<>-----E--<>-----E---------------------E-----------------------------XXX----------------QQ?-SQQQQ-----------------XXX--SSS----XXX-------------------------E--[]------------------XX--XX--SSS--------Q--SQ---------Q---S?S---X----Q------------S----SSS-----------------------------------------XXXX-----------------------QQQQ--QQQQ----------S--------E--------------------SS?--SS--S--S--QQQQ---QQQ------S---------E--<>---QQQ?oQ-Q--S-------<>-----------------------------S-------SS------------E-------SS---SS------------------------XX-------------------E--[]------------SSS---------------------------------S-----------<>--E---<>---------------ESQQQQ---------XXXXX---------------------------S--S--------<>------SXS--------------------------------<>---ESS----XX-----------------------------EX-----------------XXX--------SSSS--------E----S-SSSS----X---------------E--------<>-------XXX---SSS--XXXX----------ESSSS----XXX-XXX----------S--SSS--SS-SSS-Q--Q--QQQQ---------------------XX----------<>------------[]------<>--QS--SQS-------------------XX--ESSS------X-------SSSSSS-------------------S-------------SSSE---------QQQ----------<>---SXXS---<>----<>--[]------------------------S?QQQ--QQ--S?S-------<>------QQQ-------------------S-----XXX-XX
-----------------------------------------------------------------XX-------------------XXXXXXXX------------XXXX-----------------------------------------------X--X----------------[]--------------[]----------------------------------------XXX--------------------------------------XXXX---[]----<>--[]----<>--------------------<>-----------------------------------------------------------------E-------------------XXXXXX---S------------------<>--[]-----------------XXX--XX---------X-------------------E-------X-------------------E--E---E-----------------------------------------------------------------------------------------E----<>------------------SSS----SS-SS-----------------------S----------[]---------------------[]-----E---X----------------------------------------<>----------E--E-----E-----------------XXX--XX--------------<>--[]---------------------------------------------------------X--[]--E---[]----E---E-----------------------------------------------------------------[]-------------------X---------------------[]-----------X-----------------------------XX----------------XXXX-----------------XXX-----E-E-------X--------------<>--------[]------------------XXXX------------------XXXX-XXX----------SS--S----S-SS---------------------------------XX----------[]----<>------[]------[]---------------------------EXX----------XXX--XX---------------------------------E----------------------------------[]----------[]----[]--[]---------------------------------------------[]---------------------------------XXXX-XX
X------XXXX--------------------------------------------------X---XXX------------------------------------XXXXXX----------------------------Xo----------E------X--X----------------[]--------------[]----------------------------X----------XXXX-------------X---------------X-------XXXXX---[]----[]--[]----[]------X-------------[]----------------------------------X-----------------------------<>------------------XXXXXX-----------------------[]--[]----------------XXXX--XXX--------X-----------------------E---X---------X-X----------------------------------XXXX-----------------------------------------------------------------<>----[]------------------SSS----SS-SS----------------------------------[]---------------------[]----<>---X----------------------------------------[]---X--------------------------------XXXX------------------[]--[]------------------------------------------------------------[]------[]---<>--<>-------------------------------------------------------------X---[]-------------------X---------------------[]-----------XX---------------------------XXX--------------XXXXXX----------------XXXX-----------E---X--------------[]--------[]---------------E--XXXX-----------------XXXXX-XXX----------S---SS-----SS---------------------------------XXX---------[]----[]------[]------[]--------------------------XXXX---------XXXX---XXX-------------XX---X-X------------------------<>-------------------[]--------<>[]----[]--[]--X------------------------------------------[]--------------------------------XXXXX-XX
XX---------------------------E--------------------EE---------X-E-XXXX-------E------E---------------EE----XXXX-------------------------------E-------E--------X-XX------X---------[]-E--E---------[]---------------------------XX---------XXXXX---S----E---XX-----------E---X------XXXXXX---[]-E--[]--[]----[]-----XX-EE-E-----E--[]-----------------------------------------E---X-----------EEE----[]--E--------------XXXXXXX------------E----EE-E--[]--[]----E----------XXXXX--XXX--------X---------------------------X--------XX-X-E-------------------------------------------------------------------------------------------EE-E---E--[]----[]--------------------------SSSS----------------------E-----------[]-------E---------EE--[]----[]---X-S----E--------E-----------------E------[]-E-X-------------------------------XXXXX------E---------E-[]--[]-------------------E-------E-E------------------------E-----[]-XX---[]---[]--[]-------------------ooo----------------------E----EE-E--EE----X---[]-------------------X---------------------[]----E-EEE-XX---------------------------XXXX--------------XXXXXX----E-----------XXXXE--------------X--------------[]-----E--[]------------------XXXX---EE-----------XXXXXX-XXX---EE---XXS------oSSSSS---------------------------------XXX------X--[]----[]--E---[]------[]-----E-----E-E-----------XXXXX---------XXXX---XXX-------------XX---X-X-E---------------EE-----[]---------E-EE------[]--------[][]----[]--[]--X----------------------------E-------------[]------------------E-E------EE--XXXXXX-XX
----------------------------XXXXXXXXXXXXXXXXXXXXXXXXXXXXXXXXXXXXXXXXXXXXXXXXXXXXXXXX------------XXXXXXXXXXXXX--XXXXXXXXXXX---XXX------E---S-XXXXXXXXXXXXXXXXXXXXXXXXXXXXXXXXXXXXXXXXXXXXXXXXXXXXXXXXXXXXXXXXXXXXXX---XXXXXXXXXXXXXXXXXXXXXXXXX---XXXXXXXXXXXXXXXXXXXXXXXXXXXXXXXXXXXXXXXXXXXXXXXXXXXXXXXXXXXXXXXXXXXXXXXXXXXXXXXXXXXXXXXXXXXXXXXXXXXXXXXXX--XXXX------------XXXXXXXXXXXXXXXXXXXXXXXXXXXXXXXXX---XXXXXXXXXXXXXXXXXXXXXXXXXXXXXXXXXXX-XXXXXXXXXXXX-----XXXXXXXXX--XXXXXXXXXXXXXXXXXXXXXXXXXXXXXXXXXXXXX--XXXXXXXXXXXXXXXXXXXXXXXXXXXXXXXXXXXXXXXXXXXX---------SXSX---XXXXXXX------XXXXXXX-----XXXXXXXXXXXXX---XXXXXXXXXXXXXXXXXXXXXXXXXXXXXXXXXXXXXXXXXXXXXXXXXXXXXXXXXXXXXXXXXXXXXXXXXXXXXXXXXXXXXXXXXXXXXXXXXXXXXXXXXXXXXXXXX-XXXXXXXXXXXXXXXXXXXXXXXXXXXXXXXXXXXXXXXXXXXXXXXXXXXXXXXXXXXXXXXXX-X-XXXXXXXXXXXXXXXXXXXX----XXXXXXXXXXXXXXXXXXXXXXXXXXXXXXXXXXXXXXXXXXXXXXXXXXXXXXXXXXXXXXXXXXXXXXXXXXXXXXXXXXXXXXXXXXXXXXXXXXXXXXXXXXXXXXXXX-------XXX-------------------XXXXXXXXXXXXXXXXXXXXXXXXXXXXXXXX---------X---X-X--------XXXXXX-X-XXXXXXXXXXXXXXXXXXXX---XX--XXXXXX----XXXXXXXXXXXXXXXX--XXXXXXXXXXXXXXXXXXXXXXXXXXXXXXXXXXXXXXXXXXXXXXXXXXXXXXXXXXXXXXXXXXXXXXXXXXXXXX------XXXXXXXXXXXXXXXXXXXXXXXXXXXXXXXXXEoXXXXXXXXXXXXXX-XXXXXXXXXXXXXXXXXXXXXXXXXXXXXXXXXXXXXXXX-X--XXXXXXXXXXXXXXXXXXXXXXXXXXXXXXXXXXXXXXXXXXXXXXXXXXXXXXXXXXXXXXXXXXXXXXXXXXXXXXo-EXXXX--XXXXX--XXXXXXXXXXXXXXXXXXXXXXXXXXXXXXXXXXXXXXXXXXXXXXXXXXXXXXXXXXXXXXXXXXXXXXXXX--XX--XX--XXXXXXXXXXX-XXXXXXXXXXXXXXX--XXXXXXXXXXXXXXXXXXXXXXXXX---XX--XXXXXXXXXXXXXXXXXXXX--X-