------------------------------------------------------------------------------------------------------------------------------------------------------------------------------------------------------------------------------------------------------------------------------------------------------------------------------------------------------------------------------------------------------------------------------------------------------------------------------------------------------------------------------------------------------------------------------------------------------------------------------------------------------------------------------------------------------------------------------------------------------------------------------------------------------------------------------------------------------------------------------------------------------------------------------------------------------------------------------------------------------------------------------------------------------------------------------------------------------------------------------------------------------------------------------------------------------------------------------------------------------------------------------------------------------------------------------------------------------------------------------------------------------------------------------------------------------------------------------------------------------------------------------------------------------------------------
------------------------------------------------------------------------------------------------------------------------------------------------------------------------------------------------------------------------------------------------------------------------------------------------------------------------------------------------------------------------------------------------------------------------------------------------------------------------------------------------------------------------------------------------------------------------------------------------------------------------------------------------------------------------------------------------------------------------------------------------------------------------------------------------------------------------------------------------------------------------------------------------------------------------------------------------------------------------------------------------------------------------------------------------------------------------------------------------------------------------------------------------------------------------------------------------------------------------------------------------------------------------------------------------------------------------------------------------------------------------------------------------------------------------------------------------------------------------------------------------------------------------------------------------------------------------
------------------------------------------------------------------------------------SSSSSSSSSSSSSSSSSSSSSSSSSSSS--------------------------------------------------------------------------------------------------------------------------------------------SSS--SSS--------S-SSSSSSSSS---------------------------------------------------------------------------oo------------------------------------------------------------------------------------------------------------------------------------------------------------------------------------oo--------------------------------------------------------------------------------------------------------------------------------------SSSSSSSSSSSSSSSSSSSSSSSSSSSS-----------------------------------------------------------------------------------------------------------------------------------------------------------------------------------------------------------------------------------------------------------------------------------------------------------------------------------------------------------------------------------------------------------------------------------------------------------------------------------------------------------------------------------------------------------------------------------------------------------------------------------------------------------------------------------------------------------------------------------------------------------S-----------------------------------------------------------------------oo-------
-------------------------------------------------------------------------------------------------S--SSSSSS---SSS---o----------------------------------------------------------------------------------------------------------------------------------------S---------------SSSSSSS---------------------------------------o----------------------------------------------------------------------------------------------------------------------------------------------------------------------------------------------------------------------------XXXX-------------------------------------------------------------------------------------------------------------------------------------S--SSSS---------------------------------------------------------------------------------------------------------------------------------------------------------------------o-------------------------------o---------------------------------------------------------------------------------------------------Q-------------------------------------------------------------------------------------------------------------------------Q-------------------------------------------------------------------------------------------------------------------------------------------------------------------------------------------------------------------------------------------------------------------------------------------------------------------------------------------SS-------------------o---------------------------------------o----------XXXX------
------------------------------------------------------------------------------------------------S?--SSSSSS--SSSS------------------------------------------------------------------------------------------------------------------------------------------------------------SSSSSSS-----------------------Eooo------E----E-----------------------------Eooo-------------------------------------------------------------------------------------------------------------------------------------------------------------------------------------------------------------------------------------------------------------------------------------------------------------------------------------S--SSSS------------------------------------------------------------------------------------------------------------------------------------------------------------------------------E-----------------------oo----------------------------ooooooooooo------o-----------ooooo------------------------oooooo------------------------------------------------------------------------------E----------------------------------------------------------------------------------------------------------------------------------------------o---o-------------------------------------------------------------------------------------------E---------------------------------------------------------------------------------------------------------------------------------------------SS--E----------------------------------------------------------------------------o
---------XXX----------------SS------------oo------------------------------------------------------------SS-----SSSSSS-------------------------SSSQS---------------SSSSSS----------------------SSS--S-------------------------------SQQQ---------------------SSSSSS--------SSSSSSSSSSS---------------------XXXXX---------SQS--X?-------E----------------XXXXX------XXX-----------------------------------------Q--------------S--------------XXX----XXX----------------------------------Q-Q-------------------------XX---S--------------E--------oo--------------------------S------------------S------------------------------------S------------------SSQS-------SSSSS---S------------SSSS----S---------------------------SSSSQS----SSQSS---SSS-----------------------XX---------------------SSSSSSSSS---------------------------------------------XX------oo---XXX-----SS-------SSS--SSSSSSSS------------XXXX--------------------------------------------XX--------------------------E----oo--XXXX------o----------Q?----------------SSS--------------------------------S---o---------E--E-------oo------------------------------S------------XXoo-------------------------------------------------------------------------------XXX----------------------SSS--------------------------------------------SSSS---------SSSSSSS----SSSSSS--SSS----------------SSS--------------------------------------------------SSSSS-------S----------QQ---------------------QQQQQ-------------------SS-?-------S---SSS-----------------------------QQQ----------X-------o---------
---XX---------------------------------------------XXXX--------XXX---------------------------------------SS-----------------------ooo-------------------------------------------------------------------------------------------------------------------------------------------------------------------------------------------------<>-----------XXXX------------XXXS------------------------------------------------------------------------------------------------oooo------------------------------------------XX---------------------XXX------------------------------ES------------------------------------------------------E-----------------------------------------------------------------------------------------------------------------------------------XX-----------------------------------------------------------------X----------------------------------------------------------XXXX-------------------------------------------------------------------XXXX------------X----------------------------------------------------E----------------------------------------XXXXXX-------------------------------------------------------------------------------------------------------------o-o-------------------------------------------------------------------------------------------------------------------------------------------------------------------------------------------------------------------------------------------------------------------------SS--------------------------------------------------XXXX-----------E-------X--
--------------------------------------------------------------o-----------------------------------------SS-------------------------E-------------------------------------------------------------------------------------------------------------------------------------------------------------------------------------------------[]---------------------------XXX----------------------------------------------------------------------------------------------------------------------------------------------XXX-------------------------------------------------------S-------------------------------------------------------S--------------------------------------------------------------------------------------------------------------------------------XXXX----------X-----------------------------------------------------XX--------------------------------------------------------------------------------------------------------------------------------------------------------------------------------------------------------------------------XSS----------------------------------------------------------------------------------------------------------------------------------------------------------------------------------------------------------------------------------------------------------E------------------------------------------------------------------------------------------------------------------------------------------------------SS-------------SS-------------------------------------------------------E-----
---------------------------------------------------------------------------------------------------oooooSS----EX------------------<>----------------------------------------------------------------------------------------oo-----------------------E---------E--E--------------------------------oo---------------E-----------E----XX---------------------------XXX---------------------E----------------------------E----S---------------------------------------E---------------E------------------------------XXX----------------------------XX------------------------SS--------E---------------------------------------------SS-------------------------------------------------------------------------------------------------------------------------------XXXXX----------S-------------------------ES--------------------------XX---------------------------------------------------------S---------------XS-------------------------------------------XXXXX---X---------XXX-Q-----X------------XXXX---------------------------------SS-SQ-------S--------XXS----------------------------XXX------E----------------E---------------------XXXXX--------------------------------------E------------------<>---------------------------------------------------------------------o--------------SS------------------------------E------------------------S--------------------------------------------------------XX---------------------------------------------------E------ooo-SS-------------SS---------E-------ooo--------------------------------XXXXX----
------------------X--X----------------XXXX--XXXX--------XXX---------------------------------------SSSSSSSS--SSSS--S-S--o--------SS[]----------ESQS----------------------------Q----------SS-------SS-------------------------------ES?S-------------<>-------SSSSS-SSSSSSSSSSSSSSSSSSS---QQQ----------------SSSS----XS--S?S-----S----XX--------------------------XXXX--------------------<>-------------------SS------<>------------------------------------S---E--<>-------------E<>---QQQ-------------E----SS---EXXX------------o--------------------------------S--------SSSS-----<>----Q----SS----------QQ----------------------SS------------------SSS---------?QQQQ------------SS----------------------------------oo-E?-QQ--QQQ--QQ-Q-----QQQQ---------------XXXXXX---------XS--Q--Q--Q--Q------------<>S------------------------XXXX-------XXXXXXXX----------XXX-ooo-------XX--X---------------------------XXXX----------------XXXX-X---------------XXX---------------------------------XXXXXXXXX------------QQQ---------------------------E-----------E-----XXX--------XXXXXX-------------------E--<>--------E------<>---------------------------------------------------------------<>---------------E--[]----------XXXX----------------------QQ---SQS--------E--S---------------------------XX---Q?-SQS---Q--Q--Q-----SSS----QS--S?S----------X--X-----------------------QQQ--QQQQ-------------E------S-------XXX---SS----------Q--Q--Q-------------o-ESQQQQ----E--<>---S--SSSSSS--S--------------------<>-----E-------------SSS-----------XXXXXX------------
-----------------XX--XX---------------------------------X-X-------XX-------------------------X-------------EE---E-----------E-----[]------------------------X-------------------------------------SS------------------------------------------E-----[]-------SSSSS--SSSSS---------------------------------------------------------E--XX-SXX---------------------XXXXX--S-----------------[]---------------------------[]------------X------------------------------[]------E-----<>[]------------------<>--------XXXXX-----XS----------E--------------------------------------SS-----[]-----------------------------------------------------------------E-------E-----------------------------------------XXX-?-----------------------------------------------------XXXXXX--------XXX------------------------[]S------------------E----EXXXX--------------------------------------XXX--XX-------------------------XXXXX-SSS-------------------------------o---------------------------------------------------------------------------------------<>----------<>---XXXXX---X------------o-------------------[]-------<>------[]--------------------------------------XXX---XXXX---------XXXX--[]--------------<>--[]------------------------------o--------------------<>----------------------------XXXX--X---------------------------------------------X--XX-------------------------------------------<>-------------XXXX------------------------------<>--------------<>--[]--------------XX------------E---E--[]----<>-------E-E-----------------------------------
----------------XXX--XXXX--------------------------------------------------------------------XX-----------------------------------[]--------------------E---X-------------------------------------SS-----------------------------------------<>-----[]------oSSSSS-SSSSSSS-------------------------------------------------------EXX-XX------------------------XXXXXX--------------------[]---------------------------[]------------X---------------------------X--[]-----<>-----[][]------------------[]--------XXXXX----XXXXXXXXXXX------E-----------------------------------S-----[]----------------------------------------------------------X---------------------------------------------------------------------------------------------------------<>------XXXXXXX-------XXXX------------------------[]------------------<>---XXXXXXXXXXX-------------------------------EXXXX--XXX---------o-------------XXXXXX---------------------------XXXX---XXX----o----------------------------------------XXXX---XoX----------------------------E--[]----------[]--XXXXXX--SS-----------XXXX----XXX----------[]-------[]------[]---------------------------------------------------------------[]--------------[]--[]-------------------------X----XX-------------------[]---------------------------XXXXX------------------------------------------------X--XXX------------------------------------------[]------------XXXXX------------------------------[]--------------[]--[]-------------X-X---X------------E--[]----[]------<><>------------------------o----------
---------------XXXX--XXXX-E------------------------------------------------------------------X---------EE-------------------------[]--------E-E------XX-----X------EE----E-E-------------E--------SS---------------------------E-----------E-[]--E--[]----E-SS-SSSSSSSSSS--------------E---------------------------------------------XX--------X--------------XXXXXXX----------E-EE------[]-------E-------------------[]------------X---------------------------X--[]-----[]-----[][]---------------E--[]-E-EE---XXXXX---XXXX----------------------EE--E----E--E---E---------E-------[]-E------EE-------------------E--EE--X---------------------X---E-E-----------XE-E----------E-----------E-------------------------------------------------------------[]-----XXXXXXXX------XXXXX-----EE-----E----E------[]----EE-E-EE-----E-[]--XXXXXXX-XX--------------------------------XXXXXX--XXXX-------XX------------XXXXXXX--S-SS------ooo-------------------------XXX------------------------XXXXX------------------------------------------------S--[]-----E----[]-EXXXXXX--SS-XX-----------------------------[]--E----[]------[]---------------------------------------------------------------[]------------E-[]--[]---------------------------------------------------[]-----------------------E--XXXXXX---------------E-EE-----------EE------------E---X--XXXX-E---E-EE-E------------E-EE------E--E-E--[]-----------XXXXXX-------------------E-EE------E[]------------E-[]--[]-----E-------X-X-E-X-EX------------[]----[]------[][]--------XXX------------XXX---------
X---XXXXXXXXXXXXXXXXXXXXXXX----XXXXXXX------------------------------XXXX-XX---XXX---XXXXXXXXXXXXXXXXXXXXXXXXXXXXXXXXXXXXXXXXXXXXXXXXXXXXXXXXXXXXXXXXXX--oQo-XXXXXXXXXXXXXXXXXXXXXXXXXXXXXXXXXXX---XXXXXXXXXXXXXXXX--XX--X-XXXXXXXXXXXXXXXXXXXXXXXXXXXXXXXXXXXXXXXXXXXXXXXXXXXXXXXXXXXXXXXXXX---XXX-----XXXXXXXXX----XXXXXXXXXXX--XXXXXXXXX-XXXXXX-------XXXXXXXXXXXXXXXXXXXXXXXXXXXXXXXXXXXXXXXXXXXXXXXXXXXXXXXXXXXXXXXXXXXXXXXX---XXXXXXXXXXXXXXXXXXX-------XXXX--XXXXXXXXXXXXXXXXXXXXXXXX-XXXXXXXXXXXXXXXXXXXXXXXXXXXXXX-X------------X--X-XX-XXXXXXXXXXXXXXXXXXXXXXXXXXXXXXXXXXXXXXXXXXXXXXXXXXXXXXXXX--XXXXXXXXXXXXXXXXXXXXXXXXXXXXX--XXXXXXXXXXXXXXXXXXXXXXXXXXXXXXXXXXXXXXXXXXXXXXXXXXXXXXXXX--XXXX-----XXXXX-XXXXXX--XXXXXXXXXXXXXXQXXXXXXXXX----XXXXXXXXXXXXXXXXXXX--XXXXXXXXXXXXXXXXXXXXXXXXXXXXXXXXXXXXXXXXXXXXXXXXXXXXXXXXXXXXXXX---------------XXXXX-X-XX---X-XXXXXXXXXXX--XXXXXXXXXXXXXXXXXXX--XXXXXXXXXXXX----XXXX---XXX-------XXXX-------------------------------------------------------------------XXXXX-XXXXXXXXXXXXXXXXXX---XXXXXXXXXXXXXXXXXXXXXXXX---SX----------------------------XXXXXXXXXXXXXXXXXXXXXXXXXXXXXXXXXXXXXX---XXX------------XXXX-----X--------XXXX------XXXXXXXXXXXXXXXXXXXXXXXXXXXX---XXXX------XXXX-----------X-XXXXXXXXXX-XXXXXXXXXXXXXXXXXXXXXX-----XXXXXXXXXXXX----XXXXXXXXXXXXXXXXXXXXXXXXXXXXXXXXXXXXXXXXXXXX-XXXXXXXXXXXXXXXXXXXXXXXXXXXXXXXXXXXXXXXXXXXXXXXXXXXXXXXXXXXXXXXXXXX--XXXXXXXXXXXXXXXXXXXXXXXXXXXXXXXXXXXXXXXXXXXXXXXXXXXXXXXXXXXXXXXXXXXXXXXXXXXXXXXXXXXXXXXXXXXXXXXXXXXXXXXXXXXXX-----------------------------