---------------------------------------------------------------------------------------------------------------------------------------------------------------------------------------------------------------------------------------------------------------------------------------------------------------------------------------------------------------------------------------------------------------------------------------------------------------------------------------------------------------------------------------------------------------------------------------------------------------------------------------------------------------------------------------------------------------------------------------------------------------------------------------------------------------------------------------------------------------------------------------------------------------------------------------------------------------------------------------------------------------------------------------------------------------------------------------------------------------------------------------------------------------------------------------------------------------------------------------------------------------------------------------------------------------------------------------------------------------------------------------------------------------------------------------------------------------------------------------------------------------------------------------------X--------------------------
-----------------------------------------------------------------------------------------------------------------------------------------------------------------------------------------------------------------------------------------------------------------------------------------------------------------------------------------------------------------------------------------------------------------------------------------------------------------------------------------------------------------------------------------------------------------------------------------------------------------------------------------------------------------------------------------------------------------------------------------------------------------------------------------------------------------------------------------------------------------------------------------------------------------------------------------------------------------------------------------------------------SXXX------------------------------------------------------------------------------------------------------------------------------------------------------------------------------------------------------------------------------------------------------------------------------------------------------------------------------------------------------------------------------------------------------------------------------------------------------------------------------------------------------------------------------?--------------------------
SSSSSSSSSSSSSSSSSSSSSSSSSSSS--------------------------------------------X-----------------------------------------------------------------------------------------------------------------------------------------------------------------------------------------------------------------------------------------------------------------------------------------------------------------------------------------------------------------------------------------------------------------------------------------------------------------------------------------------------------------------------------------------------------------------------------------------------------------------SSSSSSSSSSSSSSSSSSSSSSSSSSSS------------------------------------------------------------------------------------SSSSSSSSSSSSSSSSSSSSSSSSSS------------------------------------------------------------------------------------------oo--------------------------------------------------SSSSSSSSSSSSSSSSSSSSSS-SSESS--------------------------------------------------------------------------------------------------------------------------------------------------------------------------------------------o---------------------------------------------------------------------------------------------------------------------------------------------------------------------------------------------------------------------------------------------------------------------------------------------------------------------------SSSS--oQ--------SSSSSSSSSSSS
SSSSSSSSSSSSSSSSSSS-------------------------------------------------------------------------------------------------------------------------------------------------------------------------------------------------------------------------------------------------------------------------------------------------------------------------------------------------------------o-------------------------------------------------------------o-------------------------------------------------------------------------------------------------------------------------------------------------------------------------------------------------------------------------------------------------SSSSSSSSSSSSSSSSSSSSSSSSSS------------------------------------------------------------------------------------------------------------------------------------------------------------------------------------------------------------------------------------------------------------------------------S-SSS?-SSSS--------------------------------------------------------------------------------------------------------------------------------------------------------------------------------------------XX---------------------------------------------------------------------------------------------------------------------------------------------------------------------------------------------------------------------------------------------------------------?-----------------------------------------------------------SSSS---XX-------------------
SSSSSSSSSSSSSSSSSSS----------------------------------------------------------XX--------------------------------------------E--------------------------------------------------------------------------------------------------------------------E------------------------------------------------------------------------------------------------------------------------------------------------------------------------------------------------------E-----------------------------------E---------------------------------------------oo-----------------------------------------------------------------------------------------------------------------------------------------------------SSSSSSSSSSSSSSSSSSSSSSSSSS-----------------------------------------------------------------------------------------------------------------------------------------------------------------------------------------------------------------XXX----------------------------------------------------------S-SSS--SSSS-------------------------------------------------------------------------------------------------------------------------------------------------------------------------E----------------------------------------------------------------------------------------------------------------------------------------------------------------------------------------oo--oo-------------------------------------------------------------------------------------------------------------------------------------------------SSSS----XX------------------
SSSSSSSSSSSSSSSSSSS--QQ----------------------------------oo------------oo----------X-----SSS---SQQQQ----------------------SQS---SS----------------E---------------------SSSS--SQQ-------------------SQQSS-----------SQQSSSSS------------------SSSSSS--------SQQS------------------------SSS---------------------Q-------------------------------------------------------------SSS------SSS--SSSSSSS-----QSSS-----E--E------?SSS-----?-----oo----XXoo---E--E-----SSSSS---?-----SSS----QQQQSQS-----------------S---SSS-------S---------------------------------------SSSSSSS----------------QQQQQQ----------------------?SSS----------------------------------------------------------------------SSSSSSSSSSSSSSSSSSSSSSSSSS-----SSS-------------------------S------SSSS--------------Q?SSS---?-SSS-----oo----------Q--------------------------------------------------SSS------------------SSSS------------------------SSSS---------------------------------------------------------------------------------SS---SS----QS-----------------------------------o---------------------------------------SSSQS-------------------------------------------SSSSS-------SSSSS------------------------SS----S----------------------------------------------S--------------------------------------------------------------QQS-----------------SSSS------------XXoo----XXX------------------------------------S---QS--QQQ-Q----------------------------SSS-----------------?SSS------------------SSS-------SSSSS------SSSSS----E-----SSSS----------------------------------------SS
-------------------------------o-------------------------QX?----XXXX-------E---------------------------------------------------------------------<>-----------------------------------------------------------------------------------------------------------------------------------------------------------------------------------------------------------------------XX---------------------------------------XXXXX------------XXX---X--------------XXXXXXX------------------------------------------------------------------------SS--------------------------------------------------------------------------------------------------------------------------------------------------------------------------------------------------------------------------------------------------------------------XX---------------------------------------------------------------oo----------------------------------------------------------------oo--------------------------oo----------------------------SS---SS-----------------------------------------------------------------------------------------------------------------------------------------------S--------------------------S----------------------------------------------------S-------------------------------------------------------------------------------------------------------------------o------------SX----------------------------------------------------------------------------------------------------------------------------------------------------------SS------------------------
------------------------------XXX-ooX------o-----------------------------------------------------------------------------------------------------[]---------------------------------------------------------------------------------------------------------------------------------------------------------------------------------------------------------------------------------------------------------------------------------------------------------------------------------------------------------------------------------------------------------------------------------------------------------------------------------------------------------------------------------------------------------------------------------------------------------------------------------------------------------------------------------------------------------------------------------------E------------o---------------------------------------------------X-----------------------------------------------SS---S--------------------------------------S-S-------------E-----------------------------------------------------------------------------------------S--------------------------S------------------------------------------------------------------------------E------------------------------------------------------------------------------------------------------------------------------------------------------------------------------------------------------------------------------------X-----------------------------SS---S-----------E--------
-------------E-----------------------------------o-------------------XXXXXX-----XXX--------------------------------E---------------------E-----SS[]------------------E---------------------------------------E-------------------------------------------------------SSS----------------------------------------------------------------------------------------------------S------------------------------------------------------------------------------------------------E-E-E------------------------------------------oo---------XX---------------------------------------------------------------E----S--Q-----------XS--S--------------------------------------E---------------------E-----------------------------------------oo-----------------------------------------------------------------------------------------------------------------------------------E-------E--------------------------------------------S------------------------XXSSSSSS-------------------o---------------o---?-SS---So??-----------------------------------SoS------------<>-----------------S-E-------------------------------------oo---------------------------E-----------------------------SS-------------E-------E-----------------------------E------------------------<>---------SSS-----------------E--------------------------------------------------------------------------------------XX--------------------------------------------------------------------------------------------------------------S---------------------------ooSQ---S-------E--<>--------
-?SSSSSSSSSSSSSSSSS--QQ----Qo------------XS----------S-----XXX--------------------------Q--Q-E-?QQQQ--------------<>---QQQQQQ-----------<>-----SS[]-S--E------------<>--QQQ---QQQ------E------------S-S-----<>----E?SQS----S--------------------Q---------ES?SSS----------------------------------Q-------------Q-------X--------------------------------------------S---------------E-----------------XQQQQ--QQQ-----------------------------XXXX-XXXX---------SSSSSSSSSSSSSSSSSSS--SSSQQQ----------------------Q---------o--o--------XX--X------------------------SS----X-------------Q--S?SQS----E--<>---------S--------XXX--------XX------XXXX--------------------<>-------------E------<>-----SSS--SSSSS--SSS---Q---------S-S---------------QQQQ---Q?-QQQ---QQQQ------------E------QQ----XXXXXXXXX---------QQQQ---------------------X---------------------------------<>------<>---S?-------------------------------------E--------------<>---------XXX----------------------------------------?SS----SS---SSS?----E-----------------------??QQQ--SSS---------E--[]---------------XXX--X-----S-SS-----------------E----------------------------S--------<>SSS--SS----------------------S-----SSS-----<>---E--<>----------------------E-----<>---------QQ?-------E----[]-------------------S--------<>-----SSS------X--S-----------------------XX---XXXX--XXXX-----------XXX----XXX---------X--QQ--QS--E-QQQ-----------------------<>---SS-------------------S?S--------------------SS--------S--------SSSS-S---?-QQ?SQQQ---------------SSSS---SSSS---<>--[]------SS
--SSSSSSSSSSSSSSSSSS--------X---------------------------XXXX--XXXXXXXXX-------------------------------------------[]--------------------[]------------<>------------[]---------------E<>--------------------[]------E----------X-------------------------<>------------------------------------------------------------XXX----------------------------------E-----------------------<>----------------XX-------------------------------------------------------E-SSSSSSSSSSSSSSSSSS-------------------XX-----------------------------XXXX--XSS----S-----------------------X------------------------<>--[]-----------------XXXX-------EXX---------------E--------------[]------E-----<>------[]-------------SS-------------------------------------------------------------------<>------------------------------------------------------XX----------------------------EX---[]------[]---------------------------------------XXXX--------------[]--------XXXX--------------------------------------------------E-------XXXXXXXX-?-----E----------------------------<>--[]--------------XXXX-XXX---------------XXXX?----<>-------------------------------------[]-------------------------------------------[]--<>--[]---X-----------E-----<>--XX-[]------------------<>----[]----------------------------[]-------------XX--XX-------------------------------------------------------------------X--------------------------------------[]-----------------------------------------------------------------------------------------------------------------[]--[]--------
--SSSSSSSSSSSSSSSSSS--------XXXX-----------------X------XXX-------------------------------------------------------[]--------------------[]------------[]------------[]--------------<>[]--------------------[]-----------------X-------------------------[]------------------------------------------------------------XXX---------------------------------<>-----------------------[]-----X---------XXX------------------------------------------------------X-SSSSSSSSSSSSSSSSSSS------------------XXX---X----------------------X-XXXXX--XSS----------X-----------------X------------------------[]--[]----------------XXXXX-------XXX--------------<>--------------[]------------[]------[]-------------SS-------------------------------------------------------------------[]-----------------------------------------------------XXX---------------X------------XX---[]------[]-------------------------------------------X-------------[]-------XXXXX------------------------------------------------------------------------<>----------------------------[]--[]-------------XXXXX--XXX-----------------------[]---------------------<>--------------[]-------------------------------------------[]--[]--[]---XE----------------[]-X-X-[]------------------[]----[]----------------------------[]------------XXX--XXX--------------------------------------------------------XXXXX-----X--------------------------------------[]-----------------------------------------------------------------------S-----------------------------------------[]--[]--------
oSSSSSSSSSSSSSSSSSSS--------XX---------------E---X----------------------------------------------------E-----------[]----E------------E--[]-E--E--EE-E-[]----------E-[]--------------[][]-------------E--E--E[]-----------------X---------EE-E------EE----[]------------------------------------------------------------XXX---EE-E-------E-----EE---------E-[]------------------E----[]-E-E-X-----EE-XXXX-----------------------------------ooo---------------XXXSSSSSSSSSSSSSSSSSSS----------E-E--E-XXXX-E-X---E-EE--------------XXXXXX----XSS-EE-X-----X----EE-EE----EE--X-----------------E------[]--[]---------------XXXXXX------XXXX--------------[]--------------[]--------EE--[]------[]------------E----------------E-EE-----------------------------------------------E-[]----------------------------------------------------XXXX-----------E-E-X------------XXE--[]-E--E-[]-------------------------------------------X-----EE-E----[]------XXXXXX------------------------------------------------------------------------[]-------------------------E--[]--[]------------XXXXXX--XXX----EE-----------------[]---------------E-E---[]----E--E------[]-E------XX----------------E--E----------E--[]--[]--[]---X------E-E--X--EE-[]-X-X-[]-------E-E--------[]----[]------------EE-E--EE--------[]---E-E-----XXXX--XXXX--EE-E----------------ooo----------------XXXXXXXXXXX-------------X------------------------EE---------E--[]---------------------------------E-----E--Q---E-E--------E-------------S-----------------------------EE----------[]--[]--------
XXXXXXXXXXXXXXXXXXXX-XXXXXXXX--------XXXXXXXXXXXXXXXX-------------------------------XXXXXXXXXXXXXXXXXXXXXXXXXXXXXXXXXXXXXXXXXXX-XXXXXXXXXXXXXXXXXXXXXXXXXXXXXXXXXXXXXXXXXXXXXXXXXXXXXXXXXXX-XXXXXXXXXXXXXXXXXXXXXXXXXXXXXXXXX--XXXXXXXXXXXXXXXXXXXXXXXXXXXXXXXXXXXXXXXXXXXXXX-XXXXXXX--XXXXXXXXXXX--XXXXXXXXXXXXXXXXXXXXXXXXXXXXXXXXXXXXXXXXXXXX-XXXXXXXXXXXXXXXXXXXXXXXXXXXXXXXXXXXXXXXXXXXXXXXXXXXXXXXXXXXXXXXXXXXXX-XXXXXXXXX---X-------XXX-------------XXXXXXXXXXXXXXXXXXXXXXXX-XXXXXXXXXXXXXXXXXXXXXXXXXXXXXXXXXXXXXXXX--XXXXXXXX-----XSX--XXXXXXXXXXXXXXXXXXXXXXXXXXXXXXXXXXXXXXXXXXXXXXXXXXXXXXXXXXXXXXXXXXXXXXXXXXXXX---XXXXXXXX--XXXX------XXXXXXXXXX------XXXXXXXXXXXXXXXXXXXXXXXXXXXXXXXXXXXXXXXXXXXXXXXXXXXXXXXXXXXXXXXXXXXXXXXXXXXXXXXXXXXXXXXXXXXXXXXXXXXXXXXXXXXXXXX-X---XXXXXXXX---------XXXXX--XXXXXXXXXXX----XXXXXXXXXXXX-X-XXXXXXXXXXXXXX-XXXXXXXXXXXXXXXXXXXXXXXXXXXXXXXXXXXXXX-XXXXXXXXXXXXXX-XXXXXXXX-------XXXXXXXXXXXXXXXXXXXXXXXXX-XXXXXXXXXXXXXXXXXXX-----EX-XXXXXXXXXXXX-XXXXXXXXXXXXXXXX-----------XXXXXXXX-XXXX-XXXXXXXXXXXXXXXXXXXX-XXXXXXXXXXXXXXXXXXXXXXXXoXXXXXXXXXXXXXXXX------XXXXXXXXXXXXXXX---XXXXXXXXXXXXXXXXXXXXXXXXXXXXXXXXXXXXXXXXXXXXXXXXXXXXXXXXXXXXXXXXXXXXXXXXXXXXXX-XXXXXXXXXXXXXXXXXXXXXXXXXXXXXXXXXXXXXXXXXXXXXXXXXXXXXXXXXXXXXXXXXXXXXXXXXXXXXXXXXXXXXXXXXXXXXXXXXXXXXXXXXXXXXXXXXXXXXXXXX---XXX----XXX------------XX------S-------------------X-XXXXXXXXXXXXXXXXXXXXXXXXXXXXXXXXXXXXXXXXXXXXXXXXXXXXX-XXXXXXXXXXXXXXXXXXXXXXXXXXXXXXXXXXXXXXXXXXXXXXXXXXXXXXXXXXXXXXXXXXXX-----XXXXXXXXX--XXXXXXXXXXXXXXXX--XXXXXXXXXX