------------------------------------------------------------------------------------------------------------------------------------------------------------------------------------------------------------------------------------------------------------------------------------------------------------------------------------------------------------------------------------------------------------------------------------------------------------------------------------------------------------------------------------------------------------------------------------------------------------------------------------------------------------------------------------------------------------------------------------------------------------------------------------------------------------------------------------------------------------------------------------------------------------------------------------------------------------------------------------------------------------------------------------------------------------------------------------------------------------------------------------------------------------------------------------------------------------------------------------------------------------------------------------------------------------------------------------------------------------------------------------------------------------------------------------------------------------------------------------------------------------------------------------------------------------------------
------------------------------------------------------------------------------------------------------------------------------------------------------------------------------------------------------------------------------------------------------------------------------------------------------------------------------------------------------------------------------------------------------------------------------------------------------------------------------------------------------------------------------------------------------------------------------------------------------------------------------------------------------------------------------------------------------------------------------------------------------------------------------------------------------------------------------------------------------------------------------------------------------------------------------------------------------------------------------------------------------------------------------------------------------------------------------------------------------------------------------------------------------------------------------------------------------------------------------------------------------------------------------------------------------------------------------------------------------------------------------------------------------------------------------------------------------------------------------------------------------------------------------------------------------------------------
------------------------------------------------------------------------------------SSSSSSSSSSSSSSSSSSSSSSSSSSSS--------------------------------------------------------------------------------------------------------------------------------------------SSSSSSSSSSSSSSSSSSSSSSSSSSSS----------------------------------------------------------------------------------------------------------------SSSSSSSSSSSSSSSSSSSSSSSSSSSS--------------------------------------------------------------------------------------------------------------o----------------------------------oo---------------------------------------------------------------------------------------------------------SSSSSSSSSSSSSSSSSSSSSSSSSSS---------------------------------------------------------o---------------------------SSSSSSSSSS---------SSSSSSSSS----------------------------------------------------------------------------------------------------------------------------------------------------------------------------------------------------------------------------------------------------------------------------------------------------------------------------------------------------------------------------------------------------------------------------------------oo--------------------------------------------------SSSSSSSSSSSSSSSSSSSSSSSSSSSS----------------------------------------------------------------------------------------------------------------------------------------------------------------------------------------------------
---------------------------------------------------------------------------------------------------------------------------------------------------------------------------------------------------------------------o-----------------------------------------------------------------------------------------------------------------------------------------------------------------------------------SSSS------------------------------------------------------------------------------------------------------------------------------------XX----------------------------------XXX------------------------------------------------------------------------------------------------------------------------------------------------------------------------------------------------------------------------------------------------------------------------------------------------------------------------------------------------------------------------------------------------------------------------------------------------------------------------------------------------------------------------------------------------------------------------------------------------------------------------------------------------------------------------------------------------E--E-------------------oo-----------------------------------------------------------------------------------------------------------------------------------------------o-------------------------------------------------------------------------------------------------------
-----------------------------------------------------------------------------oooo-------------------------------------------------------------------------------------------------------------------------------------------------------------------------------------------------------------------------------------------------E----------------------------------------------------------------------SSSS--E---------------------E----E--------------------------------------------------------------------------------------------------XXX-XS------------------------------------------------------------------------------------------------------------------------------------------------------------------------------------------------------------------------------------------------------------------------------o-------------------------------------------------oo--oo-----------------------------------------------------------------------------------------------------------------------------------------------------------------------------------------------------------------------------------------------------------------------E----------------------------------------------------------------------------------------------------------------------XXXXXXX--------------------------------------------------------------------------------------------------------------------------------------oo---o----------------------------------------oo-----------------------------------------oooooooo-----------------------------------
------------------------Q--------------SSS--SSSSSS-------------------------XXXXX---------------------------------SS---SS----------------------------------------------------------X--------------------------------SSS------------------------------------------------------------------SSSSS---?-------------------------------SSSSSSSSSSSSSSSS-----------------SSSSS-----------------Q------------------S----SS--oo-------------S------SQS------------------------------------------------SSSSS-----------------SSSSS--------------------------SSo---------------------------------------------S---------S------------------------SSS-SS----S------------------------------------------SSS-----------------------------------------XX---------------------SSS---?SSS--------------?-----oo----XXoo-----Xo---------------------SSSSSS------------------------------------------------------------------------SSSS-----------------------SSS----------------------------------------------------------------------------------X--------------------------------------------------------------SSSSS--SSSS--SSS-------------S----?SSSS---------------SQS---------SSS--SSS-------------S---------------------------------------------?SS---------------------o-------------------------------------------------S?SSS-------SS------------------------------------------------S---------------------QQ----------------SSSSQ---S----------------------SSSSSS----------E-XX-----oo----------SS?SSS----SSS-------------------oo--XXX------o------------------------------------
----------------------------------------------------------------------------------------------------------------E----------------------------------------------------------XX-------------------------------------------------o-----------------------------------------------------------------------------------------------------------------------oooo------------------------------------------------S----SS-------------------------------------------------------------------------------------------------------------------oooo----X--------------------------------------------------------------X-----------------------------------------------------------------------------------------------------------------------------XX-----------------------------------------XXX------------------------------------------------------------------------------------------------------oooo---------------------------------------------------------------------------------------------------------SSS---------------------------------------------------------------------------------------------------------------------------------------------------S-------------------S---------------------------------------------------------------XXX-----E----XX------------------------------ooo-------------------------oo----------------------------------------------------------------------------------------------------------------------------XXX-------XX-----------------------------------------XX---X--------------------------------------------------
-----------------------------------------------------------------------------------------------------------------------------------------------------------------------------------------------------------------------------------------------------X----------------------------------------------------------------------------------------------------------------------XX----------------------------S-S--S--------------------------------------------E------------------------------------------------------------------------------XX--------------------------------------------------------------X------------------------------------------------------------------------------------------------------------------------------------------------------------------------------------------------------------------------------------------------------------------------------------------------------------------------------------------------------------E------------<>------------------XX---------------------------------------------------o---------------------------------------------------------------------------------------------------------------------S----------------------------------------------------------------------<>---------------------------E------------------------------------------------o-----------------------------------------------------------------------------------------------------------------------------------------------E-----E--------------------------------------------------------------------X---
---------oo-------------------------------------------Eooo-------------------------------------------------------------------------------------------------E-----------X-----XXX-------------------------------------------------------------------------oo--------------------------------------------------------------------XXS------------------E-------E---------------XX--------------------------?-SoS?-SS----S----------------E--S----------E---E--<>--------------------------E------------------------------------------E-----S--XX-----------E---------E--------------SQ------------------------X-S-SSSS-------E-XX--------------------------------E--------------------------S-----------------------E----------------------------------------------------------E-------------XXX-----------------------------------------------------------------------------------------------------------------------------E---------S----------------------------------<>------------[]-QSSSSS---------EXXS----------------------------S-------------------------------------------------------------------S-----E-EE------------------------E------------------S--------------------------------------------------oo----------------------------E---------[]--------------------S--------------------------SSSSSS--------------------------------------SSSS---------------------------------------------oo-----------------XX-------------------S-------------------------XXX----------------------------------------XX-----------XXXX---------------------------XXX---
----------------------QQQ------QQQ----------S--S-----<>X-------------------------------------X--------------SS--------SSS---------------------------------<>----------XX------------X--------------------------E---S---------<>SS--------------------X-------S-------EEE--------------------S?QQQ-------XXX--SSS--------------EXX--X---------------<>------<>---SS--------EXXX-Q-------Q-S-----------E----SSS--SSSS--------E------S--<>---S----S---<>--<>--[]-------Q-oQoQQQQQQ-------<>----------------------Q------------------<>-------XXX-------o--<>--------<>-----E--?-------------E------S-----XXXXXX-------------<>-XX---S-----XQS----S--------S-----<>-------------------------------XX----S-----------<>----------------XXX---S------------------QQQ--QQ---------<>-------XXX--------XXX--XXXXXXXXXX-----------------------SSSS?SS-----------------------------X------------------------------QQQ----QS--S-----<>---Q---------QQQQ---------------------------[]-------E----[]----------------XXXX--------X---------------------------------------------------E-----------------------SS--------------------XX-XXX------------E----<>---E--?-----------SS--SSS--------S----------------------<>----------o--------Q-Q--Q-S-------------<>---------XXX------------------------S?S------E------------------E---------------------SS------X-EX---------------S------S?S---S-----S---------QQQ--------------------QQ--------------------------------------XXXX--XXX---------------S?S-----S------------------------XXXXXXXXX----------------------------SS---XXX---
-----------------------------------------------E-----[]X-----XXX----------o-----o--E----XXX--X---------------------------------------------X--------------[]---------XXX-----------------E------E--------------E-------------[]----E---E------------XX--------------XXXXXXXX----E----XX?-------------------------------------XXXX--XX-----E--------[]------[]----------XX<>XXX----------------------<>--------------------<>---------[]-----E------[]--[]--[]-------------------------[]-----------------------------------------[]-------XXX----------[]--------[]----<>------X--------<>-----------XXXXXXX-------------[]-XX--------XX---------------------[]------------------------------XXX----------------[]---------------------------------------------------------[]---------------------------------------E-------E--------------------------------------------------------------------------------------------[]--------------------------------------------[]------<>----[]--------------XXXXXX-S-----EX-----------------X---XX-------------------------------------------------------E------------------XX-XXX-----------<>----[]--<>------------------------XXX-------------------------[]------E---E-----------------------------[]--------------------------E-----------------<>---------------------------------------X-------XXX-XXXX?---------------------------E-----------------------------------------------E-------------------------------------------------------------S--------------------------------------------------------------X-XXX---
----------------------------------------------------X[]X-----------XXXX--XXX---XXXXX---XXXXX-XXX-------------------------------------------X--------------[]-------XXXXX----------------<>-----<>-------------<>-------------[]---<>--<>-------------X----------------------------------------------------------------------XXXXX--XX--------------[]------[]---------XXX[]XXX----------------------[]--------------------[]--<>-----[]------------[]--[]--[]-------------------------[]----------<>-----------------------------[]-------XXX----------<>--------[]----[]------X--------[]----------XXXXXXXX-------------[]--X-------XXX---------------------[]--------------------XX-------XXXX----------------[]---------------------------------------------------------[]-----------o--------------------------<>------<>------------------------------------<>------------------------------------------------------[]-<>-----------------------------------------[]------[]----[]--------------XXXXXX-------XX----------------XXX--XXXX------------------------------------------------------------------------XX-XXX-----------[]----[]--[]------------------------XX---X----------------------[]-----<>--<>-----------------------------[]-----------------<>------<>-----------------[]-----------E---------------------------X------XXXX--------------------------------<>-----------E----------------------------------<>--------------------------------------------------------------S------------------------------XXX----------------------------X-XXX---
-------------------------------------E--EE---------XX[]X-----------XX------------------XXXXX-X-X----------EE-E--E----------------------X---X---EE------E--[]-------XXXXX----------------[]-----[]---------E-E-[]-------------[]---[]--[]------------XXX--------------------------------------------------------------------XXXXXX--XX--------------[]--E-E-[]--------XXXX[]XX--------------------E--[]-E-EE---------------[]--[]-----[]------------[]--[]--[]-------------------E-E---[]-----E----[]-----E--------EEE-E---EE-E---[]---E----XX----------[]----E---[]----[]------X----E---[]---------XXXXXXXXX---E-----E---XX-XX------XXXXE--------------E-E---[]--------EE-E----E-E-XXXX----XXXXX----------E-----[]--------EE---------------------------------E-------------[]----------XXX-------------------XXX---[]--E---[]------EE----------------------------[]------------------------------------------------------[]-[]--------------------------E-E------E-E---[]------[]----[]-------------XXXXXXX-----XXXX---------------X-XXE-XXXX-------------------------X--------------EE-E-EE-------------------------X--XXX----EE-----[]----[]--[]--------------E--E----X-XXX--XXX-------------E--E-E-[]-----[]--[]--------E--------E-----------[]--------o--------[]------[]--------------E--[]-E---------X-----------E----------E-XXXX-----XXXX----------------E----------------[]------------------------------E-EE-------E----[]------------------------------------------------------------------------------------o-----------------------------------------XXX---
XXXXXXXXXX--XXXXXXX---XXXXXX--XXXXXXXXXXXXXXXXXXXXXXXXXXXXXX------------------------XXXXXXX---XXXXXXX-XXXXXXXXXXXXXXXXXXXXXXX--XXXXXXXXXXX-XXXXXXXXXXXXXXXXXXXXXXXXXXXXXX----XXXXXXX----XXXXXX-XXXXXXXXXXXXXXXXXXXXXXXXXXXXXXXXXXXXXXXXXXXXXXXXXX--XXXXX----XXXXXXXX-----------XXXX----XXXXXXXXXXXXXXX-------XXXXXXX-XXXXXXXXXXXo--XXXXXXXXXXXXXXXXXXXXXXXXXX--XXXXXXXXX-XXXS--XXXXXXXXXXQQ-XXXXXXXXXXXXXXXXXXXXXXXXXXXXX-XXXXXXXXXXXXXXXXXXXXXXXXXXX--XX--XXX--XXXXXXXXXXXXXXXXXXXXXXXXXXXXXXXXXXXXXXXXXXXXXXXXXXXXXXXXXXXXXXXXXXXXXXXXXXXXXXXXXXXXXX-XXXXXXXXXXXXXXXXXXX-XXXXXXXXXXXXXXXXXXXXXXXXXXXXXXXXXXXXXXXXXXXX-XXX-XXXXXXXXXXXXXXXXXXXXXXXXXXXXXXXXXXXXXXXXXXXXXXXXXXXXXXXXXXXXXXXXXXXXXXXXXXXXXXXXXXXXXXX---XXXXXX-XXXXXX-X-XXX---XXXXX---XX--XXXXXXXXXXXX--XXXXXXXXXXXX------------------------------XXXXXXXXXXXXXXXXXXXXXXXXXXXXX--XXXXXXXXXX--XXXXXXXXXXXXX-----XXXXX--XXXXXX-------X-XX---XXXXXXXXXXXXXXXXXXXXXXXXXXXXXXXXXXXXXXXXXXXXXXXXXXXXXXXXXXXXXXXXXXXXXXXXXXXXXXXXXXXXXXXXXXXXXXXXXXXXXXXXXXXX--XXXXXXX-XXXXXXXXXXXXXXXXXXX---X----XXXXX--XXXXXXXXXXXXXXX-XXXXXXXXXXXXXXXXXXXXXXXXXXXXXXXXXX---X--XXXXXXXXXXXXXXXXXXXXXXXXXXXXXXXXXXXXXXXXXXXXXXXXXXXXXXXXXXXXXXXXXXX-XXXXXXXXXXXXXXXXXXXXXXXXXXXXXXXXXXXXXXXXXXXXXXXXXXXXXXXX----XXX-X----XXXXXXXXXXXXXXX-XXXXXXXXXXXXXXXXXXX-XXXX--XXXXXXXXXXXXXXXXXXXXXXXXXXXXXXXXXXXXXX------XXXXXXXX-XXXXXXXXXXXXXXXXXXXXXXXXXXXXXXXXXXXXXXX----XXXXXXXXXXXXXXXXXXXXXXXXXXXXXXXXXX-XXXXXXX-------X-X---------------------XXXXXXXXXXXXX--------XXXXXXX------XXX-------------------XXXXXX---XXX---XXXXXXXX-XXXX