------------------------------------------------------------------------------------------------------------------------------------------------------------------------------------------------------------------------------------------------------------------------------------------------------------------------------------------------------------------------------------------------------------------------------------------------------------------------------------------------------------------------------------------------------------------------------------------------------------------------------------------------------------------------------------------------------------------------------------------------------------------------------------------------------------------------------------------------------------------------------------------------------------------------------------------------------------------------------------------------------------------------------------------------------------------------------------------------------------------------------------------------------------------------------------------------------------------------------------------------------------------------------------------------------------------------------------------------------------------------------------------------------------------------------------------------------------------------------------------------------------------------------------------------------------------------
------------------------------------------------------------------------------------------------------------------------------------------------------------------------------------------------------------------------------------------------------------------------------------------------------------------------------------------------------------------------------------------------------------------------------------------------------------------------------------------------------------------------------------------------------------------------------------------------------------------------------------------------------------------------------------------------------------------------------------------------------------------------------------------------------------------------------------------------------------------------------------------------------------------------------------------------------------------------------------------------------------------------------------------------------------------------------------------------------------------------------------------------------------------------------------------------------------------------------------------------------------------------------------------------------------------------------------------------------------------------------------------------------------------------------------------------------------------------------------------------------------------------------------------------------------------------
----oo------------------------------------------------------------------------------oo----------------------------------------------------------------------------------SSSSSSSSSSSSSSSSSSSSSSSSSSSS----------------------------------------------oo---------------------------------------------------------------------------------oo-----------------------------------------------------------------------------------------------------------------------------------------------------------------------o-------------o----------------------------------------------------------------------------------------------------------------------oo-------------E-----------------------------------------------------------------------------------------------------------------------------------------------------------------------------------------------------------------------------------------------------------------------------------------------------------------------------------------------------------------------------------------------------------------------------------------ooo-----------------------------------------------------oo------------------------------------------------------oo---------------------------------------------------------------------------------------------------------------------------------------------------------------------------------------------------------------------------------------S---?-------?SS------------------------------------------------------------------------------------
--------E--E----------------------------------------------------------------------------E--E---------------------------------------------------o------------------------------------------------------------------------------------Q-o-------?---------Q-----------------------------------------------------------------------------X-----------------------------------------------------------------------------------------------------------------------------------------------------------------------------------------------------------------------------------------o------------------------------XXXX------------------------------------E--E------------S-----------------------------------------------------------------------------------------------------------------------------------------------------------------------------------------------------------------------------------------------------------------------------------------------------o-----------------X----EE--------------------------------------------------o---------------------------------------------------XXXX---------------------------------------------------XXXX----------o----------------------------------------------E--E------------------------------------------------------------------------------------------------------------------------------------------------------------------------------------------------------------------------------------------------------------------------------------------------------------------------------------
-------XXXXXXXXX-----------------------------------------------------------------------XXX-Xoo--ooooo----------------------oo--oo--o-----------------------------------------------------------------------------------------------S-----------------------------------------------------------------------------------------oo-----------------------------------------------------------------------------Eooo------------------------------------------------X---------------------------------------------------------------o---oo----------------------------------------------------------------------------------------------------------------XXXXXXX----------S---------------------------------------oo-------------------------------------------------------------------------------------------------------------------------------------------------------------------------------------------------------------------------------------------------------------------------------XX-XXX-X------------E----------------------------------------------------------------------------------------------------------------------------------------------------------------------------------------------------------XXXXXXX-------------------------------------------------------------------------------------------------------------------------------------------------------------------------------------------------------------------------------------------------------------------------------------------------------------------oo--oo--oo-----
-----------------------------SSSS-------------XXX-----------------------SS---SSSSSSSoo-----------XXX------------SSS-------------------------SSSS--------------------------------------------------------------------SSS------SSS----o---XXXX-------X-------------------------------E---S---S?SSS---SS------------------oo--XXXXX-----------------------------------XXX--------SSS------SSS----------SSSS----XXXXX---------------------------------------------------SSQSSS------------------S?SSS------XX-----XXX--------------------------XX-----------------------------SSS---Q-------------------------------------------------------------------------------------S-Q--S---------S---SSS-------------QQQ------------------------------------ooQQQ-----SQQQS--?-------S---SSS----------------------------SS---------SS-----------------------------------------------------------------------------------------------------------------------SSSS-----------------------SSS---------S----------------------------SS---SS--------------SSS---S------oo--XXX--------------------------------------------SS------------------------S------------------------SSSS---------------SSSS--------S-----QS---------------SSSS-----------------------------------S-----SSSS-----------------------------------------------S---?-----------------S--------SSSS----E-------------------------------------SSSSSS-------SSSSSSSSS?SSS---SS---QS----------------SSSSS----------------oo--------o-Q--SS-S-SS?SSS----------------XXoo------------------o-----XXXoo---------------------
-----------------oo--o-----------------------XXXX-------------------------------------------------------------------------------------XXX--------------------oo-------------------------------------------------------------------XXX--------------XX-----------------------------<>-------------------------------------------------------------------------------XXX----------------------------------------------------------oo--o-------------------------------------------------------------------------XXX--------------------------XX-------------------------------------------------------------------------------------------------------------------oo----S-------------------------------------------------------------------------------------------------------------------------------------ES------------------------------------------------------------------------------------------------------------------------oooo-------------------------------------------------------------XXX----------S---------------------------X-XXXXX-----------------------XX------------------------E--------------------------------------------------------------------------------------------------------------------------------ooooo----------------------------------------------------------------------------------------------------------<>----------------------------------------------------------------------------------------------------------------------------------------------------------------------XXXXX---------------------------------XX
--------------------------------------------XXXXX-----------------------------------------------------------------------------------------XX-----------------------------------------------------------------------------------------------------XXXX-----------------------------[]-------------o-oo------------------------------------------------------------X-XXX--------------------------------------------------------------------------------------X-----------------------------------------------XXXXX--------------------------oo--X----------------------------------------------------------------------------------------------------------------------S--------------------------------------------------------------------------------------------------------------------------------------S--------------------------------------------------------X----------------------------------------------------XXXXX--------------------------------------------------------------------------------------------------------------------------------------------XXXX--------o---------------------------------------------------------------------------------------------------------------------------------------------------------------------------------------------------------------------------------------------------------------[]-------------------------------------X-------------------------------------------------------------------------SS------------------------------------------------XXX--o---------------------------------------
-------------------------------------------XXXXXX-----------------E--o--------------XX----------------------XXXX----------------------------SSSSSS------------------------------------------------------------------------------Q---------------XXXXX-----------------------------[]--o---??------E---------o-----------------------------------S---------------XX-XXX----------------------------------------------XX-------------------------------------XXS----E--S-----------------------SSSS---------E-XXXXX--------------------------------------------------------SSSSSSS---------SS--------------------------------E----------------------XXXX----------------SoS---S--------------------------------------------o-------------oo------------------------------------SS--X--------------------------SS----E--S--------------E-----------------------------------------------------------------------------------------------E----------------------X--------------E------------X----------------------------SS-------------E----SSS----------------------------------XXX-------------------------S---------------------S-----------------o---------------------------------------------------------------SSSSS-------------------------------------------------------E-------------------------E-----------------------------E------------------[--o-----E----------------------------XX----------------------------E--------------------------------------------SS----------------------------------S----------------------------XX----------------------------
--------------<>---E------------S?S-------XXXXXXX----------------<>------------SSSSSS-------------------------------------XXXX-XXXX------------------------------------X------------------------SS------------<>--------------S?------XX-------XXXXXX-------QQQQ-----------E------[]---ESS???SSSSS?S-SS-----------o------XXX----------X--X------------SSS------XXX-XXX----------SS-----------------------------X------------XX----------------------------XXX--E-<>-----E--S--------E------X----------------X-XXX--------o------------XX-----------------------------Q----------SSS----------Q--------------QQQ-----------<>----------XX------------------------------SSS--SS-------SQ----------------Q??SSQS-------------------SS-----------XXX--QQQ-----SSSSS----------------------o----------------------SS---<>--------SSS-----<>----E?S-----------EX-----------------------------S---------E----------------------------------<>-------X--X----------XX-------------<>-----------XX-------X--------------------S---SSSS------<>-----------X------------------------------XX------SSSS---------------S---SSS--------------XX-XXX----------E-------------------------------ESS----------S----SSS------------------------------------------------X---QQQQ--Q-Q------------<>--Q---------------------<>----------SSS------E--------<>--S--QQQ--QS?S----X-------<>---S-------<>--------------XXX-SSSS------X----------------XS--S?S--------------------------------------S---------SQ---S?SQS---S---------------------XXXX------------------XX-----XXXX--XXX------------
---E---E------[]--<>--------------------XXXXXXXXX----------------[]-----------EE-------------------------------------------------------------------------------------XXX--------------------E-----------------[]------------------------------XXXXXXXX---S----------------<>----X-[]-XX-S----SSSS----SS---------------XX-------------XX--XX-------------------XXXX-XXX--------------------------------------------------E---------------XXXXXX-?---------XXXXXXX-[]----<>----------<>------X--------------XXXXXXX--------------E-----XXXX--X-----------------E------------------------------------------------------------[]--------XXXX-----o----------------------------------------------------------------------------------SSSS-----SS---SS--------------------------------E-------------X------------------[]----------------[]-----------------XXX--------------------------------------<>-----------------------------XX---[]------XX--XX--------XXX-------------[]-------E--XXX----------------------XXXXXX--------------[]--------E--X-----------------E-----------XXX-----------------------X---------------------XXX-XXX---------<>------------------------------<>----------XXX-----------------------------------------------------XXX------------------------[]--------------E---------[]------------------<>--------[]-----------------<>-------[]-----------[]-------------XXXX----------XXX--X---------------------<>-------E------------------XX--------E--E------------------------------------XXXX-------------------------------------------------
--<>--<>------[]--[]----------------EXXXXXXXXXXXX----------------[]----------------------------XXXX-----XXX------------------------XXXX-----------------------------XXXX------XXXX----------------------------[]-----------------------------XXXXXXXXX--------------------[]---XX-[]--XXS---SSSSS---SSSS-------------XXX------------XXX--XXXX----------------XXXXX-XXX----------------------------------------------------------------------------------XXXXX----[]----[]----------[]------X-------------XX-XXXXX-------------<>----XXXXX-------------------<>------------------------------------------------------------[]-------XXXXX----XXXXX-------------------------------------------------------------------------------SSSS---E-SS---SS-------------------X---X---------------------XX------X-----------[]----------------[]----------------XXXX-------------XX---X-------------------[]----------------------------XXX---[]-----XXX--XXX------XXXX-------------[]------<>-XXXX------------------XXXXX-------------------[]-----------X----------------<>-----------XXX-----------------------X--------------------XXXX-SXX---------[]----------------X-------------[]---------XXXX---------------X------------------------------------XXXX---------------X--------[]-------------<>---------[]------------------[]--------[]--S--------------[]-------[]-----------[]------------XXXXX---------XXXX--XX--------------------[]----------<>-------------XXXX--------------------------------------------XXXXX-------------------XXXX-----------------XXX--------
--[]--[]------[]--[]--------E-E-----XXXXXXXXXXXXX------X---E-EE--[]----------------------XXXX--------------------------ooo-----------------------------------------XXXXX-------------------------------EE-E---[]---------EE-E------o------X-XXXXXXXXXX--?--------------E--[]--XXX-[]--ES--oooSS--ooooSS--------------XXX-----------XXXX--XXXX---------------XXXXXX-XXX-------E-E-----------------EE-E--X-----------------------------------------------XXXXXX----[]----[]-----E----[]------X--------XXX-------XXX--EE--XEE----[]---XXXXXX--X---------E-EE---[]-E----------E-E-------------------E-E---------------E-------[]-------XXXXX-------------------------oo------------E-E---------------------------------------------------oo-----o-SS---------EE--------X-E-X-E------------------XXX--E---X-----------[]---------E-E----[]---------------XXXX----------E--XXXE--X------EE-----E-E---[]-E--------------------------XXX---[]----EXXX--XXXX----XXXXX---EE--------[]------[]XXXXX-----------------------------E-E-------E--[]-----------X----------------[]-----------XXX----------E--------EE--X-----------E---E-E-XXXXX-SSX---EE-E--[]---------------XX----E-E-EE---[]E-------XXXXX-E-E-------E-E-X-----------------------------------XXXXX---------------X--------[]--E---E-E----[]--E------[]---X--------------[]--------[]-S------------E--[]-------[]--E--------[]------E----XXXXXX--------XXXXXE-X-----------XE--------[]----------[]-------EE---XXXXXX---------------------------------------E--EXXXX-------------------------XXXX-----XXXX--------------
XXXXXXXXXXXXXXXXXXXXXXXX---XXXXXXXXXXXXXXXXXXXXXXXXXXXXXXXXXXXXXXXXXXXXXXXXXXXXXXXXXXX---------------------------------XXX------------------XXXXXXXXXXXXXXX---XXXXXXXXXXXXXX--------XXXXXX---XX-XXXXXXXXXXXXXXXXXXXXXXXXXXXXXXXX---XXX--X-XXXXXXXXXXXXXXXXXXXXXXXXXXXXXXXXXXXXXXX-XX--XXXXXXXXXXXXXXXXXXXXXX--XXXX---XX------XXXXXXXXXX--XXXXXXXXXXXXXXXXXXXXXXXX--XXXXXXXXXXXXXXXXXXXXXXXXXXXXXXXXXXXXXXX--XXX--------XXXX------XXXXXXX--------XX-X-XXXXXXX-----XXXXXXXXXXXXXXXXXXXXXXXXXXXXXXX--XXXXX-X--X-XXXXXXXXXXXXXXXXXXXXXXXXXXX---XXXXXXXXXXXXXXXXXXXXXXXXXXXXXXXXXXXXXXXXXXXXXX-XXXXXXXXXXXXXXXXXXXXXXXXXXXXXXXXXXXXXXXXXXXXX--------------------------XXX--XXXXXXXXXXXXXXXXXXXXXXXXXXXXXXXXXXXXXXXX-XXXXXXXXX---X---XXXXXXXXX--X---XX-XXXX---XXXXXXXXXXXXXXXXXXXXXXXXXXXXXXXXXXXXXXXXXXXX-XXXXXXXXXXX-XXXXXXXXXXXXXXXXXXXXXXXXXXXXXXXXXXXXXXXX----XXXXXXXXXXXXXXXX-XXXXXXXXXXXXXXXXXXXXXX----XXXXXXXXX------XXXXXXXXXXXXXXXXXXXXXX--XXXXXXXXXXXXXXXXXXXXXXXXXXXXXXXXXXXXXXXXXXXXXXX------------------E---XXXXXXXXXXXXXXXXXXXXXXXXXX-X-----X--XXX---XXXXXXX--XXXXX-XX--XXXXXXXXXXXXXXXXXXXXXXXXXXXXXXXXXXXXXXXXXXXXXX--SSXXXXXXXXXXXXXXXXXXXXXXXXXXXXXXXXXXXXXXXXXXXXXXXXXXXXXXXXXXXXXXXXXXXXXXXXXXXXXXXXXXXXXXXXXXXXXXXXXXXXXXXXXXXXXXXXXXXXXXXXXXXXXXXXXXXXXXXXXXXX-XXXXXXXXXXXXXXXXXXXXXXXXXXXXXXXXXXXXXXXXXXXXXXXXXXXXXXXXS-XXXXXXXXXXXXXXXXXXXXXXXXXXXXXXXXXXXXXXXXXXXXXXXXXXXXX-XXXXXXXXXXXXXXXXXXXXXXXXXXXXXXXXXXXXXXXXXXXXXXXXXXXXXXXX-XXXXXXXXXXXXXXXXXXXXXXXXXXXXXXXXXXXXXXXXX---XXXXXXXXXXX--------------------------------------------------------