------------------------------------------------------------------------------------------------------------------------------------------------------------------------------------------------------------------------------------------------------------------------------------------------------------------------------------------------------------------------------------------------------------------------------------------------------------------------------------------------------------------------------------------------------------------------------------------------------------------------------------------------------------------------------------------------------------------------------------------------------------------------------------------------------------------------------------------------------------------------------------------------------------------------------------------------------------------------------------------------------------------------------------------------------------------------------------------------------------------------------------------------------------------------------------------------------------------------------------------------------------------------------------------------------------------------------------------------------------------------------------------------------------------------------------------------------------------------------------------------------------------------------------------------------------------------
---------------------------------------------------------------------------------------------------------------------------------------------?-S------------------------------------------------------------------------------------------------------------------------------------------------------------------------------------------------------------------------------------------------------------------------------------------------------------------------------------------------------------------------------------------------------------------------------------------------------------------------------------------------------------------------------------------------------------------------------------------------------------------------------------------------------------------------------------------------------------------------------------------------------------------------------------------------------------------------------------------------------------------------------------------------------------------------------------------------------------------------------------------------------------------------------------------------------------------------------------------------------------------------------------------------------------------------------------------------------------------------------------------------------------------------------------------------------------------------------------------------------------------------------------------------------------------------
--------------------------------------------------------SSSSSSSSSSSSSSSSSSSSSSSSSSSS---------------------SSSSSSS-----------------------------SSS-----------------------------------------------------------------------------------------------------------------------------------------------------------------SS----------------------------------oo-----------------------------------------------------------------------------oo---------------------------------------------------------------------oo-----------------------------------------------------------------------------------------------------------------------------------------------------------------------------------------------------------------------------------------------------------------------------------------------------------------------------------------------------------------------------------------------------------------------oo----------------------------------------------------------------------------------------------------------------------------------------------------------------------------------------------------------------------------------------------------------------------------------------------------------------------------------------------------------------------------------------------------------------------------------------------------------------------------------------------------------------------------------------------------------------------------------------------------------------------------------
--------------------------------------------------------S-SSSSS------SSSS---------------------------------------------------------------------oS-------------------o--------------------------------------------------------------------------------------------------------------------------------------------------------------------------------XXXX--------------------------------------------------------------------------------E--E---------------------------------------------------------------XX-----------------------------------?---------------------------------------------------------------------------------------------------------------------------------------------------------------------------------------------------------------------------------------------------------------------------------------------------------------------------------------------------------------------------------------E--E-------------------------------------------------------------------------------------------------------------------------------------------------------------------------------------------------------------------------------------------------------------------------------o--------------------------------------------------------------------------------------------------------------------------------------------------------------------------------------------------------------------------------------------------------------------------------------------------------------------------------------------
--------------------------------------------------------S--SSSS--E--XSSSS---------------------------------------------------------------------SS--E------------------------------------------------------------------------------------------------------------------------------------------------------------------------------------------------------------------------------------------------------------------------------------XXXXXX---------------------------------------------------------------------------------------------------------------------------------------------------------------------E--------------------------------------------------------------------------------------------------------------------------------------------------------------------------------------------------------------------------E--------------E--------------------------------------------------------------------------XXXXXXX---------------------------------------------------------------------------------------------------------------------------------------------------------------------------------------------------------------------------------------------------------------------------------------------------------------------------------------------------------------------------------------------------E-----------------o----------------------------------------------------------------------------------------------------------------------------------------------------------------------------------------------------
------------------------------------SS--------------SSS-SS-XSS---SS--------------------------------------------------------SS----------------SSS--SS----o----S---SSS---S----------QQQQ---------------------------------?SSS------------------------SS-------S?SSS---XXX----------------------------------SS---------------------------------------------------------------------------------SSS----------------------------------SS------------------------------------------------------------oo--XXXX-----------------S----SS----S-----E--?----------------------------------------------Q--------------------ES?--QQQQQ--------------S?SSS---?SSSSS----oo--------SSSSS-------------E-?-----------SSS---?SSS------SSS-----------------------------------------------------------------SQSSSS-------------SSSSS----------QQQQQ----------------SSSSS------SSQSSS-------------------SSSS--------------------------------------------------------------------S------------------------------------?SSS-------------------------------------SS-----SSSS--S----------S---SSS--------------------SSSSSS--SSSS-------------------------------------------------SS--------S---SQ-----o-----------S---------------------------S-SSQS-----------------------------------------------E--------Q------------------------SSSSS------------SSSSQS-SS----------E--E-----oo----X----SS---SSS-------------SSSS-----------------------------------------SS---SSSSSS---SSQ-----S-----SSS---SSSSSSS---------------SS------------------?-----------------------S--SSQ--QQQ------------------
-----------------------------------------------------------------SS----------------------------------------------------------------------------S--SS-----------------------------------------------------------------------------------------------SS---------XXX---------------X----E--------------------------------------------------------------------------------------------------------------------------------------------------------------------------------------------------------------------------------------------------<>------------------------------------------------------------------------------------------------------------------------XX-----------------------XXXXX-------------------------------------------------------------------------o-------------------------------------------------------------------------------------------------------------------------------------------------------------------------E-oooo--------------------------------------------------------------------------SSS----------E-----------------------------------------------------------------------------------------------------------------------------------------------------------------------S-------------------------------------------------<>-----------------------------------------------------------------------XXXX----------------------------------------------------------------------------------------------XXX-------------------XX-------------------------------------E-----------------------------------------------------
------------------------------------------E-----------E----------SS---------------------------------------------------------------------------SS--SS------S----------------------------------------------------------------------------------------SS-------------------------XXX--XXXXX------------------------------------------------------------------------------------------------------------------------------------------------------------------------------------------------------------------------------------------------[]---------------------------------------------------oo-----------------------------------------------------------------o-o------------------------o-------------------------------------------------------------------------------------------------------------------------------------------XX----------------E----------------------------------------------------------------------------------------<>--------------------------------X----------------------------------------------XX----------------------------------------------------------------------------------------------------------------------------------S-S----S-----------------------------------------S---------------------------------------------E---[]-----------------------------------------------------------------------------------------------------------------------------------------------------------------------------------------------XX-------------------------------------------------------------------------------------------
-----------------------------------------<>--o----E-------------SSS-------------------------------------------------------------------------ooSQ---So?--SoS------------------------------E--------------SSS-----S----------------------------------SS---E----------------------XX----------------------------------------------------E---------------E-------------------E-----E---------------------------------------------------------E---------E----S---------------------------------EX--------------------------------------------[]----------SSSSSSSS----------------------------------------------------------------------------------------------------------SSSS------------------------------------------SS------------------------<>-----------------------E----SS--------------------------------------------------------XXX------------------------------------------------------------------------------------E-----------E--S-----[]--------------------E-----------X------------------------------------o--------XXSS--------------------------------------------------ooo------------------------------------------------------------------S---------SoS---o---------E--------E--------------------------------S-SS-------------------------------------XX-------------------------------------------oo---------------------------------XXX------------------------------S-------------------E----S-----------------------------------------------XE-----XX--------S-SQ----------E-----------X-SQSQ----------------------E----------------------------
-----------------------------------------[]-----E<>----------------SS--SSS-----------------------Q-S---------------------Q-Q---S------------?SSS---SSS--SSS--S---------XS------QQ?SSSS--<>-------------------------E--S--------------------E-----------SSSS-------XX-------XX-XX------------X--------S-SSS-----------------------E--<>-QQQ----------<>------------------<>-S--<>--------------------------------------------ooo---------<>--------<>------QQQ----------------------------<>X-----XXX--SS------X--X-----------S---S?S----[]---------o--------------------------------------SSS--------X------S------QQ?SSQSQ-----------------SQQQ?SSQ--XXXX---S--------------QS?S---------SS--------QSQS-----X--X---------------------------E--[]----------------------<>----------------SQS------X--XX-------------QQ--SSE?QQQQ------XXXX-----------SSSS---QQQQ--QQQ-------QQQQ-------------------XX------------------E-----<>----------<>-----E--[]-----E-------------<>----------XXXX----Q-Q---S-S-------------E---ooo---------XXXX----------X-----SS----XX-XX----------------E-----E---------S----SS----E------XXXX---------------ooo------XXX-XX---------S--E?QQQ--SSS------------<>---S---<>------E-----------QQS--SSS-----------------------E------------------?S---XX---E---?S---------------------------S-------------?--SSSSS--------X---------------------Q---S?SSS------------XX-------------------<>-----------X----QQQ--------------S---------SQQ-----XX--XX-XXX---------------------<>----------XX-----------------SS-----------QQQ--QQQ------------------
-----------------------------------------[]----<>[]----------------SS--------------------<>-------------------------------------------------------------------------E--XX---------------[]-------------E----------<>----------------------<>--------E-EE---------------------XXX---------E--XX-----------------------------E--------[]--------------[]------------------[]-S--[]-----------------------X--------------------------------[]--------[]-------------------------------------[]X--XXX------------XX--XX---------------------[]-------------------------E---------------------E-----------X------X-----------------------E----------------------------------------------------------------------XX--XX-------------------------<>--[]----------------------[]--E---------------------XX--XX--E-------S-------------------XXXXX----E--------------------------------------X------------XXX-----------------<>-----[]----------[]----<>--[]----<>-------------[]--------XXXXXX-------------------------<>--------------XXXXX---------XX----------XX--XXX--------------<>----<>---------------E---<>---------------------------------XXXX-XXX-------E-------------------------[]-------[]-----<>-----------------------XE---------------XXXX--------------------XXXX------------------------------------------------------------------------------------------------------------XXX----X--------------[]--E-------XX--------------------------------------XXX--XX-XX----------------------[]---------XXX---------------------------S----------------------------
-----------------------------------------[]----[][]----------------SS--------------------[]-----------------------------------------------------------------------EX---XX---------------[]------------<>----------[]----------------------[]----------------------------------XXX-----------XX---X------------------------<>--------[]--------------[]------------------[]----[]-----------------------X--------------------------------[]--------[]------------------------------------X[]X-XXX------------XXX--XXX--------------------[]------------------------<>---------------------------------X------X----------------------------------------------------------------------------------X---------XXXX--XXX------------------------[]--[]----------------------[]-<>--------------------XXX--XXX<>--------------------------XXXXXX--------------SS---------------------------X-----------XXXX-----------------[]-----[]----------[]----[]--[]----[]-------------[]-------XXXXXX--------------------------[]-------------XXXXXX--------XXX---------XXXX--XXX-------------[]----[]-------------------[]--------------------------------XXXXX--XXX--------------------------------[]----E--[]-----[]----------------------XXX--------------------------------------XXXXX-----------------------------------------------------------------------------------------------------------XXXX----X--------------[]-<>------XXX------------------------------------EXXXX--XXXXXX---------------------[]--------XXXX---------------------------S----------------------------
------------------E-------------------E--[]----[][]---------------E---------EE-----------[]-----------E-EE-E--EE--------EE-E----------E-E-E---EE------------------XX---XX----E----------[]------E-E---[]----------[]----------------EE-E--[]-E--------------------------------XXX--EE--X----X-----------------------------[]----E---[]-----E-EE-----[]--EE-----E-E---E--[]-S--[]-----E-EE--------E-EE--X---E----EE-E-EE-----------------[]--------[]---------------------E-------------XX[]X-XXX-----------XXXX--XXXXX------------------[]------------------------[]-------------------E---------E---X------X----------------E-EE--E-----------------------------------------------------------X--------XXXXX--XXXX---------------------E-[]--[]----------------------[]-[]-------------------XXXX--XXX[]--E-------------------EE-XXXXXXX-------------------------------------------X----------XXXXX-----E-----------[]-----[]---EE-----[]--E-[]--[]----[]-E--------E--[]-E-EE-XXXXXXX-------E----EE-----E------[]------------XXXXXXXS-SS-S-XXXXEE------XXXX--XXXXX--------X---[]-E--[]-------------------[]-------------------E--E-E-E----XXXXXX--XXXX------------------------EE-E---[]-------[]-----[]--------E------------XXXX-------------------------E-EE-E--E---XXXXXX---------------------------E-E----------------------------------------------------------E-E----------------XXXX----X----E---------[]-[]-----XXXX-------E--E-------------------E----XXXXXX--XXXXXX------X---E-------E--[]-------XXXXX---------E-E--E-----------SS----------------------E-EE--
XXX--XXXX-----XXXXXXXXXXXXXXXXXXXXXXXXXXXXXXXXXXXXXXXXXXXXXXXXXXX-XXXXXXXXXXXXXXXXXXXXXXXXXXXXX-XXXXXXXXXXXXXXXXX-X-XXXXXXXXXXXXXXXXXXXXXXXXXXXXXXXXXXXXXXXXXXXXXXXXXXXXX-XXXXXXXXXXXXXXXXXXXXXXXXXXXXXXXXXXXXXXXXXXXXXXXXXXX---XXXXXXXXXXXXXXXXXXXXXXXXXXX--XXXX-----XXXX---XXXXXXXXXXXXXXXX-XXXXXXXXXXXXXXXXXXXXXXXXXXXXXXXXXXXXXXXXXXXXXXXXXXXXXXXXXXXXXXXXXXXXXXXXXXXXXXXXXXXXXXXXXXXXXXXXXXXXXXXXXXXXX-XXXXXXXXXXXXXXXXXXXXXXXXXXXXXXXXXXXXXXXXXXXXXXXXX-------XX--XXXXXXX---XXXXXXXXXXXXX-------XXXXXXXXX--XXXXXXX--XXXXXXXXXXXXXXXXXXXXXXXXXXXXXXXXXXXXXXXXXXXXXXXXXXX--X---XXXXXXXXXXXXXXXXXXXXXXXXXXXXXXXXXXXXXXXXXXXXXXXXXXXXXXXXXXXXXXXXXX--------XXXXXXX--XXXXXXXX-------XXXXXXXXXXXXXXXXXXXXXXXXE-XXXXXXXXXXX-XXXXXXXXXXXXXXXXXXXXXXXXXXXXXXXXXXXXXXXXXXXXXXXXXXXXXXX-XXXXXXXXXXXXXXX--XXXXXXXXXXXXX--XXXXXXXXXXXXXXXXXXXXX-XXXXXXXXXXXXXXXXXXXXXXXXXXXXXXXXXXXXXXXXXXXX---XXXXXXXXXXXXXXXXXXXXXXXXXXXXXXXXXXXXXXXXXXXXXXXXXXXXXXXX--XXX-XXXXXXX-X-XX-XXXXXXXXXXXXXXXXXX--XXXXXXXXXXXXXXXXXXXXXXXXXXXXXXXXXXXXXXXXXXXXXXS---XXXXXXXXXXXXXXXXXXXXXXXXXXXXXXXXXXXXXXXXXXXXXXXXXXXXXXXXXXXXXXXXXXXXXXXXXXXX----XXXXXXXXXXXXXXXXXXXXXXXXXXXXXXXXXXXXXXXXXXXXXXXXXXXXXXXXXXXXXXXXXXXXXXXXXXXXXXXXXXXXXXXXXXXXX--XXXXXXXXXXXXXXXX---XXX-----XXXXXXXXXXXXXXXXXXXXXX-XXXXXXXXXXXXXXXXX-XXXX---XXXXXXXXXXXXXXXXXXX-XXXXXXXX--XXXXXXXXXX--XXXXX------------------XXXXXXXXXXXXXX-XXXXXXXX--XXXXXXXXXXXXXXXXXXXXXXXXXXXXXXXX--XXXXXXXXX---XXXXXXXXXXXXXXXXXXXXXXXXXX--XXXXXXXXXXXXXXXXXXXXXXXXXXXXXXXXXXXXXXXXXX-XXXXXXXXXXXXXXXXXXXXXXX-SXXXXXXXXXXXXXXXXXXXXXXXXXXXXX