------------------------------------------------------------------------------------------------------------------------------------------------------------------------------------------------------------------------------------------------------------------------------------------------------------------------------------------------------------------------------------------------------------------------------------------------------------------------------------------------------------------------------------------------------------------------------------------------------------------------------------------------------------------------------------------------------------------------------------------------------------------------------------------------------------------------------------------------------------------------------------------------------------------------------------------------------------------------------------------------------------------------------------------------------------------------------------------------------------------------------------------------------------------------------------------------------------------------------------------------------------------------------------------------------------------------------------------------------------------------------------------------------------------------------------------------------------------------------------------------------------------------------------------------------------------------
---------------------------------------------------------------------------------------------------------------------------------------------------------------------------------------------------------------------------------------------------------------------------------------------------------------------------------------------------------------------------------------------------------------------------------------------------------------------------------------------------------------------------------------------------------------------------------------------------------------------------------------------------------------------------------------------------------------------------------------------------------------------------------------------------------------------------------------------------------------------------------------------------------------------------------------------------------------------------------------------------------------------------------------------------------------------------------------------------------------------------------------------------------------------------------------------------------------------------------------------------------------------------------------------------------------------------------------------------------------------------XXX------X------X----------------------------------------------------------------------------------------------------------------------------------------------------------------------------
--------------------------------------------------------------------------------------------------------------------------------------------SSSSSSSSSSSSSSSSSSSSS------------------------------------------------------------------------------------------------------------------------------------------------------------------------------------------------------------------------------------------------------------------------------------------------------------------------------------------------------------------------------------------------------------------ooo---------------------------------------------------------------------------------ooo----------------------SSSSSSSSSS-------------------------------------------------------------------------------------------------------------------------------------------------------------------------------------------------------------------------ooo-------------------------------------------------------------------------------------------------------------ooo--------------------------------------------------------------------------------------------------------------------------------------------------------------------------------------------------------------------------SSSSSSSSSSSSSSSSSSSSSSSSSSSS-------------------------------ooo----------------------SSSSSS------SSS-----------oo------------------------------------------------------------------------------------------------------------------------------------------------------------------------
----------------------------------------------------------------------------------------------------------------------------------------------------------------------------------------------------------------------------------------------------------------------------------------------------------------------------------------------------------------------------------Q------------------------------oo------------?---------------------------------------------------------------------------------------------------------------------------------------------------XXXX--------------------------------------------------------------------------------XXXX--------------------------------------------------------------------------------------------------------------------------------------------------------------------------------------------------------------------------------------------------------XXXX---------------------------------------------------------?--------------------------------------------------XXXX-------------------------------------------------------------------------------------------------------------------------------------------------------------------------------------------------------------------------SSSSSSSSSSSSSSSSSSSSSSSSSSS--------------------------------XXXX-------------------------------------------------------------------------------------------------------------------------------------------------------------------------------------------------------------------------
-------------------E----------------------------------------------------------------XXX-------------------E--------------------------------------------------------XXX-----------------------------------------------------------------------------------------------------------------------------------------------------------------------------Eooo--------------oooo-----------------------------------------------ooo-----------------------------------------------------------------------------------------------------------------------------------------------------------------------------------------------------------------------------------------------------------------------------------------------------------------------------E-------------------------------------------------------X--------------------------E-----------------------------------------------------------------------------------------------------------------------------------------------------?------------------------------------------------------------------------------------------------------------------------------------------------------------------------------------------------------------------------------oo--oo------------------------------------------SS-SSSSSSSSSSSSSSSSSSSSSSSS----------------oo-------------------------------------------------------------------E----E---?--------------------------------------------------------------------------------------------------------------------------------------------------------------
-------------------E---------S----------------------SS----------------------------------------------------E-------------------------------------------------------------SS------------------------------ESSSSS---------------?-------------------S---SSSSSSS-----------------------------?SSS------SSS----oo-------o----------------SSSSSS---------XXXXX-------------XXXXX-----------XX-----------------o----------XXXX------------------------------------------------------------------------------------------------S------o---X------oo---------SSSS---------------------------?------------------SS---S--------------------------------------------SSS------------------------------------S--QQS----------------SSS-------------------------SSSSS--SS--SQS----------------SSSSS-------------------------------SS-----------------Q--SSS---S-----SS----------------------------------S--------XX------------------------------------------------------------------------------------------S-S??----------------------------------------------------------------------------------------------------------------SSS----------------------------------------------SQ-------------------------?------------------------oo------------------------------------QQQQ--------------S-SSSSSSSSSSSSSSSSSSSSSSSSS-S------------------------------------------------------S-------------oooo---------S-S---SQS--??------XXX----SSS------------S----SSS--------------------SSS----XXX---------------------------------QQ-----------------------SSSSS----------------------------
--------------------XXXXX-X----------------------------------------------------------------------------------XX----------------------------------------------------------------ooo--------------------------------------------------------------------------------oooo--------------------XXX--------------------XXX------------------------------------------X------------------------------oS-------------------------SSSS---------------o-------------------------------------------------------------------------XXX----XXX-E---------------XX------------------------XXX---------------------o------------------------------------------------------------------------------------------------------------------SS---------------------------------S---S-------------------E-----------------------------X-------------------------------XXX------------------------------------------------XXX----------------------------------------------------------------------------------------------------------------------------------------------E--------------------------------------------------------------------------------------------------------------------------------------------------------------------------------------SSSS-------------------------------------------------------------------------------------------------------------------------------------------------------------------XXXX--------------------------------------XX--------------XXX-------------------------------------------------------------------------------------------
---------------------------X------------------------------------------------------------------------------------------------------------------------------------------------------------------------XX-----------------------------------------------------X---------------------------------------------------o--o------------------------------------------------------------------------------------------------------------------------------------------------------------X-----------------------------------XXXXX-------<>------------------------------------------------------------------------------------------------------------------------------------------------------------------------------------SS-------------------------------------S--------------------S--------------------------XXXS--------------------------------------------------------------------------------XXXX--------------------------------------------------------------------------------------------------------------------------------------------------------------------------------------------------------------------------------------------------------------------------------------------------------------X---------------------XX---------------------------------------------------------------------------------------------------------------------------------------SSSSS------------------------EXXXX------------------------------------------------------XXXX-------------------------------------------------------------------------------------------
---------o----------------------------------XX-------------------------------------------------------------------oo----o----------------------------------------E-----------E--S--------------------SX----------------------------------------------------XX-----------------------------------------E-----------------------------------------X----------------------------SSSSSS----------XSS-SQ------------------------S-SQ----------E----------------------------------XXXXX-----o-------S--------------------XX-XXX-------[]------------------------------------------------SQSQ-------S--E----------XX------------------------SSSS-----------------------E-------------E--S------------------------------------SS--------------E-----------SSSSSSSS---SoS-----------------SS-------------------------XXXXX--------------------E--------------------------------S-S-S---------------------XXXXX-XXX------------------------X---oo--------------------------------------------E--------------------------------------------------------------S-------------E-------------XXX--------------SSSSSSSSS------------E-------------------------------------------------------E-----------------S-SQS---------------XX--o--XXX------------EXX---------------------------E--------------?--------------------------E------------------------------------ooo--------------------------SSSSS----------E-------------XXXXX------------------E-----E---------------------E-EE---XXXXX-------E---E------o-----------------------------------------------------------------------S
----------o---XXXX-----------S-------------XXX-------------------------XXX----------------SSSSSS--------X-------------------------------E---E-----------E-----------E---o--<>-----E------------------XX-Q-Q-----S-----X--X----------------------Qo-------XXX--------------------ooo---------Q---------XXXX------------------------------------XX-----XXXXXXX-------------------------------XXX-------------------------XX--------------<>-----<>-------------------EE-E-------------XX---------------------------XXX-XXX-------XXX--XXX------------X-------o-------XXXX-----------------------<>---------XXX-------ooQ-Q-------------------------------E-SS---<>-------E----<>-----E--S-----------S-------------S-------------------<>------------------XS--S?S--------S--------SS------------------------XXXXX------S-------------<>---QQQ?----------SQS-------------------------------S------XXXXX----------------E-----Q--------o--o------------------------------------------<>-----Q---S?SQS---S-----------------------------------------E---------------<>----------XX--------------------------------------<>---S---------<>---------------------------------------<>------E-E-------------------S----X--XXX--------o-----------XXX--------------------------<>-----------SSS??SSSSSSS--SS-------EQ?S--<>----------------------------------E---------------SSSS-----XX-------------------XS--S?S------XXXXXXX----------------<>----<>----------------Q-----------XXXXX-------E--<>-------------------SS--S-----------------QQQQ----------------------------------
------------------------------------------XXXX--------XX-----------------------------------SS---------------E--X-----------------------<>---E----------<>----------XXXX----[]----<>------------------XX------------------XX-----------------------------EXXX-----------E----------E-----------------X---XXX-------------------<>-------------XXX------------------------o-----------------XXXX--------E----------------XXX-------------[]-----[]------E------XXXXXXXXXXXXXXX------------------------------------XXXX-XXX-----------------E----------------------------------------------------[]--------XXXX--------------------------------------------------[]------<>----[]----<>-------------------E----------------------------[]-------------------------------------------------------------------XXXXXXX--------------E----[]--------------------------------------------------------XXXXXXX---------------<>--------------------------E---------------------------------[]-------------------E------X-------------------------------<>---------------[]--------XXXX--------------------------------------[]------E-E----[]-----------------------E---------------[]-----<><>---------------------E--X-XXXX------------------XXXXXX---------------E---------[]-----------SS---SSSSSS---SS-------------[]---------E-----------------------<>-----------E--XX-------XXX------------------------------EXXXXXXX-----------------[]----[]--------------------------XXXXXXX----------[]------------------------------E-------------------------------------------X----
o----------------------------------------XXXXX--------XX-----------------------------<>---SSS------<>------<>--X-----------------------[]---E----------[]------<>--XXXX-E--[]----[]------------------XX------------------XXX--------------------------EXXXXX----------<>--------------------------X-X---XXX--------X----------[]------------XXXX-----------XXXXX-XXXX--XXXXX-------------XXXXX---------X-------------XXXX-------o-oo---[]-----[]-----<>-----XXXX-----------------------------------------------XXXXX-XXXXXXX------------<>----------------------------------------------------[]-------XXXXX--------------------------------------------------[]------[]----[]----[]------------------<>----------------------------[]------------------------------------------------------------------XXXXXXXX-------------<>----[]-------------------------------------------------------XXXXXXXX---------------[]-------------------------<>---------------------------------[]--S----------------------XXX------------------------------[]-----------------------XXXXXX--------------------------------------[]-----<><>----[]----------------------<>---------------[]-----[][]------------------------XXXXXX------------------XXXXXX--------------<>---------[]-----------SS---SSSSSS---SS-------------[]---------------------------------[]----------<>-XXX-----XXXXX------------------------------XXXXXXXXX----------------[]----[]--------<>--------------E-X-XXXXX-------X--[]-----------------------------<>-------------------------------------------X----
EE-----------------------------------E--XXXXXX---------X----------------------E------[]--------o---[]------[]--X-----------------E-EE--[]-E--------E---[]------[]-XXXXX----[]----[]------------------XX--------------EEE-XXXX------EE------E--E-------XXXXXX--------E-[]--------------------------X-X---XXX-------XX---EE-E-E-[]-----------XXXXX--ooo-----------------------------------XXXXXX---------X----------X--XXXX--SS?S?S------[]-E-E-[]-----[]----XXXXX------------------------------------EE-----E--XXXXXX-XXX-----oo---------[]--------------------------------------E--------E-E--[]-E----XXXXXX--------------------------------E-E--E---E-E------[]------[]----[]----[]-----------S-EE-E-[]-------------------X-EE-E---[]-E--E---------------EE-------E--------------------------------E--XXXXXXXXX-------------[]----[]-----------------------------------------E--E-----E---XXXXXXXXX----------E-E--[]-------------------------[]-----S------------E-EE----EE-EE--[]--------------------------XX----E-----E-E--------------E--[]-----E-E-EE------------XXXXXX---------------------S---------E--E---[]-----[][]-E--[]----------EE-E--------[]-E-E----EE-----[]-----[][]-E--------------E---E---XXXXXX------------------XXXXXX-------XX-----[]---EE-E--[]--------E----oooSSSSSSSSoSS-------------[]---------------------------EE-E--[]----------[]-XXX----XXXXXX-------------------E----------XXXXXXXXX-------X-E--E---[]----[]------E-[]------------------XXXXX---E---X--[]-----------------------E-E---[]-------------------------------------------X----
XXXXXXXXXX-X----------X-XXXXXXXXXXXXXXXXXXXXX---XXXXXXXXXXXXXXXXXXXXXX---XXXXXXXXXXX-XXXXXXXXXXXXXXXXXXXXXXXXXXXXXXXXX---XXXXXXXXXXXXX-XXXXXXXXXXXXXXXXXXXXXXXXXXXXXXXXXXXXXXXXXXXXXXXXXXXXXXXXXXX--XXX-XXXXXXXXXXXXXXXXXXXXXXXXXXXXXXXXXXXXXXXXXXXXXXXXXXXXXXXXXXXXXXXXXXXXXXXXXXXXXXXXXXXXXXXXXXXXXX--XXXXXXXXXXXXX-XXXXXXXXXXXXXXXXXXXXXXXXXX--XXX-----------------------XXXXXXXXXXXXXXXXXX-----XXXXXXX--------X?XXXXX--SS--SSXSXXXXXXXXXXXXXXXXXXXXXXXXXXXXX---------------------------X-XXXXXXXXXXXXXXXXXXXXXX--XXX----XXX-------XXXXXX-X-XX---XXXXXXX---------------------XXXXXXXXXXXXXXXXXXXXXXXXXXXXX-XXXXXXXXXXXXXXXXXXXXXXXXXXXXXXXXXXXXXXXXXXXXXXXXXXXXXXXXXXXXXXXXXXXXXXXXXXXXXX---XXXXXXXXXXXXXXXXXXXXXXXXXXXXXXXXXXXXXXXXXXXXXXXXXXXXXXXXXXXXXXXXXXXXXXXXXXXXXXXXXXXXXXXXXXX----X-X--XXXXXXXXXXX-XXXXXXXXXXXXXXXXXXXXXXXXXXXXX-XXXXXXXXXXXX----X------XXXX--XXXXXXXXXXXXXXXXXXXXXXXXXXX----XXXXXXXXXXXXXXXXXXXXXXXXXXXXXXXXXXXXXXXX--XXX-XXXXXXXXXXXXXXXXXXXXXXXXXXXXXXXXXXXXXXXXXXXXXXXXXXXXXXXXXXXXXXXXXXXXXXXXX---XXXXXXXXXXXXXXXXXXXXXXXXXXXXXXXXXXXXXXXXXXXXXXXXXXX---XXX-----XXXXXXXXXXXXXXXXXXXXXXXXXXXXXXXXXXXXXXXXXXXXXXXXXXXXXXXXXXXXXXXXXXXXXXXXXXXXXXXXXXXXXXXXXXXXXXXXXXXXXXXXXXXXXXXXXXXXXXXXXXXXXXXXXXXXXXXXXXXXXXXXXXX---XXXXXXXXXXXXXXXX--XXXXXXXXXXXXXXXXXXXXXXXXXXXXXXXXXXXXXXXXXXXXXXXXXXXXXX-XXXXXXXXXXXXXXXXXXXXXXXXXXXXXXXXXXXXXXXXXXXX------XXXXXXXXX---XXXXXXXXXXXXXXXXXXXXXXXXXXXXXXXXXXXXXXXXXXXXXXXXXXXXXXXXXXXXXXXXXXXXXXXXXXXXXXXXXXXXXXX--XXXXXXXXXXXX---XXXXXXXXXXXXXXXXXXXXXXXXXXXXXXXXXXXXXXXXX-XXXX----XXXXXXXXXEXX----