-----------------------------------------------------------------------------------------------------------------------------------------------------------------------------------------------------------------------------------------------------------------------------------------------------------------------------------------------------------------------------------------------------------------------------------------------------------------------------------------------------------------------------------------------------------------------------------------------------------------------------------------------------------------------------------------------------------------------------------------------------------------------------------------------------------------------------------------------------------------------------------------------------------------------------------------------------------------------------------------------------Q-----------------------------------------------------------------------------------------------------------------------------------------------------------------------Q------------------------------------------------------------------------------------------------------------------------------------------------------------------------------------------------------------------------------------------------------------------------------------------------------------------------------------------------------------------------------------------
--------------------------------------------------------------------------------------------------------------------------------------------------------------------------------------------------------------------------------------------------------------------------------------------------------------------------------------------------------------------------------------------------------------------------------------------------------------------------------------------------------------------------------------------------------------------------------------------------------------------------------------------------------------------------------------------------------------------------------------------------------------------------------------------------------------------------------------------------------------------------------------------------------------------------------------------------------------------------------------------------------------S------------------------------------------------------------------------------------------------------------------------------------------------------XXQ------------------------------------------------------------------------------------------------------------------------------------------------------------------------------------------------------------------------------------------------------------------------------------------------------------------------------------------------------------------------------------------------
------------------------------------------------------------------------------------SSSSSSSSSSSSSSSSSSS-SSSSSSSS---ooo---------------------------------------------------------------------------------------------------S--SS--------------------------------------------------------------------------------------SSSSSSSSSSSSSSSSSSSSSSSSSSSS----------------------------------------------------------------------------------------------------------------------------------------------------------------------------------------------------SSSSSSSSSSSSSSSSSSSSSSSSSSSS--------------------------------------------------------------------------------------------------------------------------------------------------------------------------------------------------------------------------------------------------------------------------------------------------------------------------------------------------------------------------------------------------------------------------------------------------------------------------------------------SSSSSS---S----------------------------------------------------------------------------oo------------------------------------------------------------------------------------------------------------------------------------------------------------------------------------------------SSSSSSSSSSSSSSSSSSSSSSSSSSSS--------------------------------------------------------------------------ooo-------------------------------------------------------------------------------------------
--------------------------------------------------------------------------------------------------------SS---------XXXX------------------------------------------------------------------------------------------------------------------------------------------------------------------------------------------------------------SS-------------------------------------------------------------------------------------------------------------------------------------------------------------------------------------------------------------o---SSSS------oSS-SSSSSS--SSSS-------------E------------------------------------------------------------------------------------------------------?-----Xoo----------------------------------------------------------------------------------------------------------------------------------------------------------------------------------------------------------------------------------------------------------------------------------------E-------X----oo----------------------------------------------------------SSS--------------------------------------------------------------------------------------------------------------------------------------------------------------------------------------------------------------------------------------------------------------------------------------S-------------------SS-S---------------------------------------------------------------------------XXXX------------------------------------------------------------------------------------------
------E--------------------------oo----------------------------------------------------------------------S--------------------------------------------------------------------------------------------------------------------------------------------------E-----------------------------------------------------------------------------------------------------------------------------------------------E-----------------------------------------------------------------------------------------------------------------------------------------SSSS--E--?SSS-SSSSSS--SSSS-----------ooXXX-------------------------------------------------------------------------------------------------------------E-----------------------------oo--oo-------------------------E------------------------------------------------------------------------------------------------------------------------------------------------------------------------oooo-----------------------------------------------XX----------XX---------------------------E------------------------------SSS---------------------------------------------------------------------------------------------XX-----------X------------------------------------------------------------------------------------E--------------------------------------------------------------------------------------S-------------------S-SS-------------------------------------oo---------------------------E------------------------------------------------------------------------------------------------------
-----XXX---QQ-QQ----------------XXXXX-------------------QSSSQ--------SSSS----?SSSSS----Q----------------SSSS---------------------S----SSS--S---------------------X---------------------------------S---------------------Q--Q---S-SS------------SSSSSS---S------SQS---?SSS-----------------------------------------S----S-----S----------S----S--S---------------------SSSSSS-S----------SSSSSSSSS---------SQS-----SSSSSSSS--?-----SSSSSS-----QQQ---------------------SSSS--E---------SSSSS-S?SSS-----------------------------------------------SS-o--SS---SS---S--------S-----S-------------------------------S---Q----SS----------------------------------S-----------------------------------XX-----------E--E-E-----ooo-SSS------------------------------------------S?SSSSS-------SQS----------------------QQ--------------------------SSSS------------SSSSSSSS-SSS------S-------------------------------SSS---------------------?-----XXoo---XXXX--------------------------------------------------------XXS-?------------S--SSS------SSSS------------------------------S----SS-----------------S-------SSS?-----------S------SQQ----------------------------XXX----------------------------------------------------------------------------------------------------------SS--SQS---?--------------------------------------------------------------SSSSS-----------------------------------------------------------------S----XX-------XXX-----------------E--E--------------o----------------------------------S------------------------?----------------SSSS----
--------------------------------------------------------------------------------------------------------------------------------------------oooo-----------------------------------------------------------------------------------------------------------------------------------------------------------------------------SS---------------S-----------------------------------------------------------------------------------------------------------------------------XXX-----------------------------------------------------------------SS-----S---SS---S--------SS----S------E--------------oooo--------------------------------------------------------------------------------oooo----------E-------XXXXXX--------------------------oooo----------------------------------------E------------------------------------------------------------------------------------------------------------------------------------XXX---------------------------------o-------------------------------EE--o-----XXX-------------------------------------------------------------S----SS----------E--------------SS--------------------------------------o---------------------o---o-----------------------------------------------------------------------------------------------S------------------------------------------------------------------------------------------------------------------------------------------------------------XXX----------------------XX----------XX---------------------------------------------oo-------------------------------------
-----<>--------------------------------------------------------------------------------------------------S------------------------------------------------------XXXS------------------------------------------------------------------------------------------------------------------------------------------XSS--oS--------SS----------------------------------------------------------------------------------------------------------------------------------------------------------------------------------------------------------S-SS-S-SS-----S---SS---S--------SS----SXXXXXXX-------------------------------------------------------------------------------------------------------------XXXXXXX-------------------------------------------XX------------------------------SS-----------------------------------------------------------------------------------------------------------o-------------------------------------------------------------------------------------------XX-XXXXXXXX---XXXX-------------------------------------------------------------S-S--SS---------<>--------------SSS-------------------S--------------------------------------XXX-XXX--XXX----------------------------------------------------------------------------------------------------------------------------------------------------------------------------------------------------------------------------------------------------XXXX-----------------------------------o-------------------------------------------------------------------------------------
-----[]-------------------E--------o-----------------------------------------------------------------o-?-----------------E--S-----------------------------------XXXX-------------E--------------SS------------ooo------------------------E---E---------------------------------------E-------------------------------E-------SS----------So---So---------------------------------------------------------------------------------------------------------------------------------------------SSSSS---------------------------------------SSS--SoSS-----So--SS---So?--ooooSS--?-S-------------------E-------------------------------------------E--S---------------o--------------------E--<>-----------------------------XXXSQ--------------------------------------------------------SS-------------------------------------------------------------------------E---------------------------XX--------------------------------------------------------------------------------------------------------------XXXX-----------------------------------------------------------?-SoS-------------[]SSQ-------ooooSS-----oo---?--S-----------------------------------------------------------------------E-----------------S--------------E-------E----X----------------------------S-----------------------------------------------oo---------------------------------X------------ooo------E--------------------------------E----SSS---------XXXX----oo--------------------------------S-SQ--------------------------------------E----SS---------------------E------------
XX---[]-----SSQS---------<>-------------------------------ESQS-----------------SS-----SSS----------------SSS-------E----<>-----E-SS-------SS-------------------XXXXX------------<>-------E------SSS-----------------------QQQQ-----------------XXX-SSSS---------S?S--------S--------<>--------------S-------------S-SSSS--------E--SS----SSS--SSQQ---------------------------------------------SS----------SSS---------QQ----QQQQ---S---Q--QQ??SQQQQ--Q--------Q----SXXX-----------------------------------------------------------------SXX--SSSS-----SSS-SS---SSS--SSSSSS----S------ooo--XXX----<>----------QQ--QQQQ--Q----------Q----S--E--<>-----E--?----------------QQQQ----E--<><>--[]----XXX-----ooo-o---------------S---------XXXX--XX---------------------XX-X------------XX--SS---Q----E-Q-----Q------QQQQ--------------------E-------------E------S-SSSS----X------SSS---S----X--XXX--ES----E------SQ--------------------------------XXXXXXXXX---------------------E----------------------------X-XXXX--------------------------S------------------------------E---SSS-ES--------SS[]------SS---SSSSSS-S-------------o-SSSSSSS-----------------------------XXXX---------------------E----<>------S--------------------S---<>-----E<>----X------------S--------X------XS--S?SSS--------X--X-------X-----------------------------------------------------XX--------------------<>----S?-------------------------<><-------------X-XXXX-----------------------------S----------------------XXX---------------S--------<>------------oo--------E---<>------------
X-------E----------------[]-------------------------------------------------------------------XX------------------<>----[]----------------SS-----XXX-----------XXXXX------------[]-----E<>-----------------------------------------------------------------X------------------------[]-----------------E----X-------E------E----E----------------------------------------------XX---------------------------------------------------------------------------------------------------E-------------------------------------E------XX-------XX-----------------X--------------E---------------------[]--------------------------------------<>--[]----<>--------------------------<>--[][]--[]--------------E-------------------------------------------------------XXX-XX---E-------XS-----------<>---------------------------X--?--------------------<>--------E------XX-----------------Q-XXXXX<>----<>-------------------------------E-------------------------------E-----<>----------------------------XXXXXX------------------------------------E------E------------<>-------------------[]------------------------E-------E-EXE-----------------------------XXXXX-----------------------<>----[]--------------E----------------[]----<>[]----X---------------------X--------------------E--X--XX-------------XXX??----------------------------------------EXXX--------------------[]-------------------------------[]X------------XXXXXXX------------------------------------X--------------EXXX--XX----XX--------------[]--E-------EX---------<>---[]------------
XX-----------------------[]------------------------------------------------------------------XXX---X--------------[]----[]----------------SS-------------------XXXX-------------[]----<>[]----------------------------------------------------------------XX------------------------[]----------------<>----X-------------<>---------------------------------------------X-----XX-------------X--------------------E--------------------------------------------------------------------E---------------------------------------XXXXX-----XXX----------------XXX----------------------------------[]--------------------------------------[]--[]----[]--------------------------[]--[][]--[]--------XXXXXXXXXX---------------------------------------------------XXXX-XXXX-----E---XS-----------[]---------------------------------------------------[]------------E-XXX-----------------X--XXXX[]----[]------------------------------<>------------------o-----------<>-----[]---------X------------------XXXXXX-----------------------------------<>-----<>------------[]-------------------[]-----------------------------------X----------------------------XXXXX-------------------------[]----[]--------------X----------------[]----[][]---XX---------------------X-----------------------X--XX----------XXXX------------------------------------------EXXXXX--------------------[]-------------------------------[]X------------XXXXXXX--------X--------------------------XX-------------XXXXX--XX---XXX--------------[]-<>--------X---------[]---[]-----------X
XX----------E------------[]------------------E----------------------------------E----E------XXXX-E-X-----------X--[]--E-[]-E--E--E--------SS------------------XXXXX------EE-----[]--E-[][]----------------------------------------------------------------XX-E-E-------E---E-E---E--[]--E-------------[]-E--X------S------[]--E-------------EE---------------------------X--E--XX----EE-E-----X----------E-----------E--------E---------------------E-E---------------------------------------------------------------XX----E--XXXXXXE----XXX---EE-E---------XXXX---------------------------------[]------------E-E-----------------------[]--[]----[]--------------------------[]--[][]--[]--------------------------------------------------------------------XXXX--XXXX---------X------------[]------------------EE-E------------E------------EE--[]-E-----------XXXX----E-EE---------XE-XXXX[]-E--[]------------------------------[]-----ooo---------XXX----------[]-----[]----------------------------XXXXXX------EE-E--------------EE-E-------[]-----[]------------[]--EE---------------[]----------EE-E---------------------X----------------------------XXS---------------------------[]----[]--------------X--S---------E---[]----[][]----X--------E--------E---X------E----------------X--XXXX----------------------------------------EE------------XXXXXX-------E------------[]---------------E-----------E-E-[]X---------------XXXX-------XX------------XXX----------XXX---------E--XXXXXX--XXXXXXXX---E----------[]-[]------------EE----[]---[]---E------XX
X-XXXXXXXXXXXXXXXXXXXXXXXXXXXXXXXX---XXXXXXXXXXXXX-XXXXXXXXXXXXXXXXXXXXXXXXXXXXXXXXXXXXXXXXXXXXXXXXXXXXXXXXXXX-XXXXXXXXXXXXXXXXXXXXXXXX---SXXXXX-----XXXXX-XXXXXXXXXXXXXXXXXXXXXXXXXXXXXXXXXXXXXXXXXXXXXXXXXX---XXXX-----XXXXXXXXXXXXXXXXXX---------XXXXXXXXXXXXXXXXXXXXXXXXXXXXXXXXXXXXXXXXX---XXXXXXXXXXXX-XXXXXXXXXXXXXXXXXXXXXXXXXXXXXXXXXXXXXXXXXXXXXXXXXXXXXXXXXXXXXXXXXXXXXXXXXXXXXXXXXXXXXXXXXXXXXXXXXXXXXXXXXXXXXXXXXXXXXXXXXXXXXXXXXXXXXXXXXXXXXXXXXXXXXXX---XXXXXX--------XXXXXXXXXXXXXXXXXXX-----XXXXXXXXXXXXXXXXXXXXXXXXXXXXXXXXXXXXXXX--XXXXXXXXXXXXXXXXXXXXXXXXXX---XXXXXXXXXXXXXXXXXX-XXXXXXXXXXXXXXXXXXX--XXXXXXXXXXXXXX-XXXXXXXXXXXXXXXXXXXXXX---XXXXXXXXXXXXXXXXXXXXX--XXXXXX----------------------------XXXXXXXXXX---XXX---XXXXXXXXXXXXXXXXXXXXXXXXXXXXXXXXXXXXX--XXXXXXXXXXXXXXXXXXXXXXXXXXXXXXXXXXXXX-----XXXXXXXXXXXXXXXXXXXXXXXXXXXXXXXXXXXXXXXXXXXXXXXXXXXXXXXXXXXXXXX-XXXXXXXXXXXXXXXXX--XXXXXXXXXX---------XXXX---XXX------------XXXXX---XXXXXXXXXXXXXXXXXX-X-----------XX-X-XXXXXXXXXXXXXXXXXXXXXXXXXXXXXXXXXXXXXXXX-XXXXXXXXXXXXXXXXXXXXXXXXXXXXXXXXXXXXXXXXXXXXXXXXXXXXXXXXXXXXXXXXXXXXXXXXXXXXXXXXXXXXXXXXXXXXXXXXXXXX--XXXX-XXXX--------------X-XXXXX-------XXXXXXXXXXXXXXXXXXXXXXXX----XXXXXXXXXXXXXXXXXXXXXXXXXXXXX---XXXXXXXXXXXXXXXXXXXXXXXXXXXXXXXXXXXXXXXXXXXXXXXXXXXX-----------XXXXXXXX----XXXXXXXXXXXXXXXXXXX-XXXXXXXXXXXXXXXXXXXXXXXXXXXXXXXXXXXXXXXXX----XX-XXXXX-XX---XXXXXXXXXXXXXXXXXXXXXXXXXXXXXXXXXXXXXXXXXXXXXXXX------------XXXXXXX-X-XXXXXXXXXXXXXX--XXXXXXXXXXXXXXXXXXXXXXXXXXXXXXXXXX-XXXXXXXXXXXXXXXXXXXXXXXXXXXXX