------------------------------------------------------------------------------------------------------------------------------------------------------------------------------------------------------------------------------------------------------------------------------------------------------------------------------------------------------------------------------------------------------------------------------------------------------------------------------------------------------------------------------------------------------------------------------------------------------------------------------------------------------------------------------------------------------------------------------------------------------------------------------------------------------------------------------------------------------------------------------------------------------------------------------------------------------------------------------------------------------------------------------------------------------------------------------------------------------------------------------------------------------------------------------------------------------------------------------------------------------------------------------------------------------------------------------------------------------------------------------------------------------------------------------------------------------------------------------------------------------------------------------------------------------------------------
------------------------------------------------------------------------------------------------------------------------------------------------------------------------------------------------------------------------------------------------------------------------------------------------------------------------------------------------------------------------------------------------------------------------------------------------------------------------------------------------------------------------------------------------------------------------------------------------------------------------------------------------------------------------------------------------------------------------------------------------------------------------------------------------------------------------------------------------------------------------------------------------------------------------------------------------------------------------------------------------------------------------------------------------------------------------------------------------------------------------------------------------------------------------------------------------------------------------------------------------------------------------------------------------------------------------------------------------------------------------------------------------------------------------------------------------------------------------------------------------------------------------------------------------------------------------
SSSSSSSSSSSSSSSSSSSSSSSSSSSS----oo--------------------------------------------------------------------------------------------------------------------------------------------------------------------------------------------------------------------------SSSSSSSSSSS--S-SS?--SSSSSSSS---ooo------------------------------------------------------------------------------SSSSSSSSSSS-----------------SSSSSSSSSSSSSSSSSSSSSSSSSSSS--------------------------------------------------------------------------------------------------------------------------------------------------------------------------------------------------------------------------------------------------------------------------------------------------------------------------------------------------------------------------------------------------------------------------------------------------------------SS-----------------------------------------------------------------------------------------oo-------------------------------------------------------------------------------------------------------------------------------------------------------------------------------------------------------------------------------------------------------------------------------------------------------------------------------------------------------------------------------------------------------------------------------------------------------------oo----------------------------------------------------------------------------------------------------------
-SSSS--------S--SSSSS-----SS---------E---E------------------------------------------------------------------------------------------------------------------------------------------------------------------------------------------------------------------oSSS---------------------------XXXX-----------------------------------------------------------------------------------------------------------SSSS------SS-SS---SS--------------------------------------------------------------------------------------------------------------------------------------------------------------------------------------------------------------------------------------------------------------------------------------------------------------------------------------------------------------------------------------------------------------------------------------------------------------------oS----X--------------------------S-------------------------------------------------------------E--E---------------------------------------------------------------------------------------------------------------------------------------------------------------------------------------------------------------------------------------------------------------------------------------------------------------ooo---------------------------------------------------------------------------------o---------------------------------------------------X---E--E----------------------------------------------------------------------------------------------------
ESSSS-EE----ES--SSSSS----SSS-------XXXXXXXXX-----------------------------------------------------------------ooo------------------------------------------------------------------------E-------------------------------------------------------------------SSSS-----------------------------------------------------------------------------------------------------oooo---------------------------------SSSS--EE--SS--SS--S-----E-------------------------------------------------------------------------------------------------------------------------------------------------------------------------------------------------------------------------------------------------------------------------------------------------------------------------------------------------------------------Eooo---------------------------------------------------------------------------------E------ES--------------------------------------------------------------------------------------------XXXXXX-----------------------------------------------------------------------------------------------------------------------------------------E--------------------------------------------------------------------------------------------------------------------------------------------------E------------------------------------------------------------------------------------------------------------------------------------------------------------X-XXXXX-----------------------E------------oooo----------------------------------------------------------
-S----oSS---S--------SS---SS------------------------------------------------------------------------------X--XXX----------------------------------------------------------------------SSSSSS---------------------------------------------------SSS----SSS----S---------oo------------------?------------------------------------SSSS-------SS------------------------XXXXX-----S----S----------------------SS---SSS----------S----SS---------------------SS--------------------------------------------XSSX------------------------------------------------------------------------------------------------------------SSS-----------SSS----------------------------------------------------SSS--------Q-Q-QQQ----------------------------------------------------------------------------------------XXXXX--------------------------------------------------------------------------------SS---SSS-------S--------------------S--SS----------------------------SSSS?SSS------------SSSS---------------------------------------------------SSSSS--------------------XXX---------------------------------------SSSQS---------------------------SQS--SQSS--------S-----------------------?SSSS------------------------------------------------------------------------------------SS---------------SQS-SSS---S----------XXXX----oo-------o------S---?SSS----------------SSS---?---------------SS-------------XXXoo-----------o-------------------------------------------------------S-------SSQS-----------XXXX--------S--------------------S----------------SSSSS-----E-
-S----SSS---S--------SS---SS-----------------oo---------------------------------------------XX----------------------------------------------------Qooo---------------------------------------------------------------------------------------------------------------------------------------------------------------------------------------------------E-------------------------------------------------S----SSS----------S----SS------------------------------------------------------------------------X-------------------------------------XX--------------------------------------------------------------------------------------------------------XXXX----------------oooo-------------------------------------------------------------------------------------------------------oooo--------------------------------------------------------------------------------------------SS---SS-------------------------------------------------------------------------------------------------------oooo----------------------------------E------------oooo---XXXX-------------------------------------------------------------------------------------------------------------------------------------------------------------------------------E-------------------------ES--------------------S-------XXXXX------------------XXX----------------------------------------------------------XXXX---------------------X---------------------------------------------oo------------------------------------------------------------------------------------------<>-
-S--S-SSS---S----S-S-SS----SXXXXXXX---------------------------------------------------------------------------------o-----------------XX---------------------------------------------------------------------------------------------------------------------SS----------------------------------------------------------------------------------------------------------------S-----S--------------------SS-----SS----------S----S------------------------------------------------------------------------XXX-----------------------------------oo----------------------------------------------------------------------------------------------------------------------------------------------------------------------------------------------E---------------------------E-----------------------------------------------------------------------E---------E---------------------------SS---SS-----------------------------------------------------------------------------------------o-----------------------------------------------------------------------XXXX-------------------------------------E--------------------------------------------------------------------------------------------------------------------------------------------------------------------S-------------------SS-------------------------------o-----------------------------------------------X----------------------------------oo-----------------------------------------------------------------------o------------------------------------------------------------------[]-
SSSoS--SS---So??-So?-SS--?-S-------------------------So-----------------------XX--o------E------------------------------------------XXXX--------E-----------------ooo----oo---------------------------------------------------E-S--------E------------------SoS-------------------------------------------S--Q----------------------------------------------XXXXX--------------So??S-------o--------------SSS----SS----------So??-S------------------------SS----------------------------E----------------XXXX---------------------------------------------------------------------------------------------------------E-----------oo-----------------------------------------E----------------------------------------XSS----------------------<>-----------------------E--<>--------------------------------------------------------------S-------<>--------<>-----S---------------o---?-SS---SS-----------------E---------E---------S----------------------------------------------------------------------------S---------------------SSSSSS----------E-----S--XXXX------S-------------------------X-X-----------------------------------------------------------------E-------------------------------------------------------------------------S--Q-------E---E------------S-------------------SS------------------E-S-------------------------------------E-------------E-----XX-------------------------------------o---------------------------------------S--E------------------------------------------------------------------------------------------------
SSSSS--SS---SSS--SSS-------S-----------------------------------o-------------XXX---E----<>--XS------------------X-----------S-------XXXX-------<>---------------------------------------S----S----E---------------------E----<>----E----<>-----ESSS---------SSSS---------S---------------Q-Q-----------XXX---------------------E------XX---------------E-E---------XXX------X--SSS--SS---E----------------SSSS---SS--E--S----SSS--SSQQQQ------------------XXX---X----------S-S----------<>---------------XXXXX---S--------------------XXXX---SSS---------------SS-----------------------------------------E-----------<>XX-XX-------------------ooo----XXX----------Q--------<>-------------------QQQ--S?S-QQQQ------XXXX-X-QQ---------------E--[]----------------------<>--[]----------<>----------------QQQQ---------------------------------E----[]------SS[]----------------------------S---SSSQ-----SS-------<>--------<>---QQ----S-----------------------Q-------S-----------------------------------------E-----E-----E----E-----------------E----<>--------XX-X--------------------S----------XXXXX-SS----SSXXS---------------------<>-----SSQ--------SS----------<>--------------S---------------E-------------------------------X--------------------------X--X------------SS----X---------------X------------XXXXXXX---------Q---S?SQS---S--S--------<>---------------XX-XX---------X---------------XXXX--XXXX----------------------X--------------SS------<>---E-------S-----XXXXXXX---------------------SS--------S----------XS-------------------S------XX
--------E----------------------E---E-----E---------XXXXX--------------------EXXX--------[]------E---E-----------X-----------------XXXXXX----E--[]---------------------XX-------------------------<>------------E------E<>----[]---<>----[]------------------------------------------------------------EXXX--XX----------------<>------XX----------XXXXXXXXXXXXX-------------------------<>--------------E-----E-----<>-----------------------------------XXXX-XXX-----------------------[]-------------EXXXXXX---------X------------------------------<>-----------------X-------------------------------<>-----------[]X--XX-------------------------------------E-------XX-[]-------------------------------------XXXX--XX----------------<>--[]---------E-E----------[]--]-----------[]----------------------------------------E-----------<>----[]--------[]------------------------------E-------------------[]--------[]---------------------------------------------------------------------------------XXXXX--<>----<>---<>----------------<>----[]-------XXX-X------------------------------XXXXXX--------------E------------------[]----------------------------[]-----------------------------<>-----<>------------------------X-----------------------E--X--XX----------------XX---X-----------X-----------XXXX--XX--------E------------------------[]--------------XXX-XXX--------X---------------------------------XXX-----------XX---------------------[]--<>-------S-----------------------------------------------------XXX-------------------------XXX
------------------------------<>--<>----<>-------X--------------------------XXXX--------[]-----<>--<>-----------X-----------------XXXXXX----X--[]---------------------XX-------------------------[]-----------<>-----<>[]----[]---[]----[]-----------------------------------------------------------XXXXX--XXX---------------[]---X--XXX---------------------------------X-------------[]--------------------------[]----------------------------------XXXXX--X------------------------[]------------XXXXXXXX--------XX------------------------------[]-----------------X-------------------------------[]----------X[]X--XXX---------------XXXXXX--------------<>------XXX-[]-----------------X------------------XXXXX--XX----------------[]--[]--------<><>----------[]--------------[]---------------------------------------<>-----------[]----[]--------[]--------------------------------------------------[]--------[]-------------------------------------------X--------------------------------------------[]----[]---[]----------------[]----[]-------XXX--------------------------------XXXXXX--SSS----------------------oo----[]----------------------------[]-----------------------------[]-----[]------------------------X--------------------------X--XXX--------------XXX---XX----------X----------XXXXX--XX-------XX------------------------[]-------------XXXX--XX--------X-----------------------------------------XX----XX---------------------[]--[]-------S----------------------------------------------------XXXX------------------------XXXX
E-EE--------------------------[]--[]----[]-----XXX---------------------------XXX-------E[]-----[]--[]--X--------X------EE--------XXXXXXX----X--[]----E----------------XX---------EE-E------------[]-----------[]-----[][]----[]---[]E---[]--------------------E---------------------------------E---XXXXXX--XXXX--------EE-E--[]-E-X--XXX-------------------------------------E---------[]--------E--------------E--[]--------E-E----------------------XXXXXX--XX----E-EE---------------[]-----------XXXXXXXXX-------XXX------------------------------[]-------------EE--X----E---------EE------E--------XXX---EE-E-XX[]X--XXXX--EE-E-XX-------------------------[]-E--EXXXX-[]---E-------------------E--------EE-XXXXXX--XX----------EE-E--[]--[]----X---[][]------E---[]--------------[]---------------------------------------[]-------XX--[]----[]--------[]----------E----E---------------------E-EE------E--[]-----E--[]-SE-----E----------------------------------Q--------E-E-E-------------------------------[]----[]---[]-------------E--XX----[]--------XX---------------EE-E--EE---------XXXXXX---------------------------[]----[]---------------------EE-E---[]--------------XX-----E-------[]-E---[]------------------E-EE--X-------E----------E---S---X--XXXX-----E-E----XXXX---XXEXE-------X---------XXXXXX-XXX-----EXXX---------------E-----E--[]------------XXXX---XX----EE--X----------------------------------------XXX----XXX-E-----E---------E--[]--[]-------S--ooo--------------------------E-------E--EE-E-----XXXXX---------E--E----------XXXXX
XXXXXXXXXXXXXXXXXXXXXXXXXXXXXXXXXXXXXXXXXXXXXXXXXX------XXXXXXXXXXXXXXXXXXXXXXX---XXXXXXXXXXXXXXXXXXXXXXXXXXXX--X-XXXXXXXXXXXXXXXXXXXXXXXXXXX--XXXXXXXXXXXXX--XXXXXXXXXXXXXXXXXXXXXXXXXXXXXXXXXXXXXXX--XXXXXXXXXXXXXXXXXXXXXXXXXXXXXXXXXXXXXXXXXXXXXXXXXXXXXXXXXXXXXXXXXXXXXXXXXXXXXXXXXXXXXXXXXXXXXXXXXXSXXXXXXXXXXXXXXXXXXXXXXXXXXXXXXXXXXXXXX-----------------------------XXXXXXXXXXXXXXXXXXXXXXXXXXXXXXXXXXXXXXXXXXXXXXXXXXXXXXXXXXXXXXXXXXXXXXXXXXXXXXX--X-XXXXXXXXXXXXXXXXXXXXXXXXXXXX-XXXXXXXXXXXXXXXXXXXXXXXXXXXXXXXXXXXXXXXXXX--------XXXX-XXXXXXXXXXXXXXXXXXXXXXXXXXXX---XXXXXXXXXXX-XXXXXXXXXXXXXXXXXXXXXXXXXX--XXXXXXXXXXXXXXX---------------------XXXXXXXXXXXX--XX----XXXXXXXXXXXXX--XXXXXXXXXXXXXXXXXXXXXX--X-XXXXXXXXXXXXXXXXXX--XXXXXXXXXXXXXXXXXXXXXXX-XXXXXXXXXXXXXXXXXXXXXXXXX--XXXXXXXXXXX--XXXXXXXXXXXXXXX-XXXXXXXXXXXXXXXXXXXXXXXXXXXXXXXXXXXXXXXXXXXXXXXXXXXXXXXXXXXXXXXXXXXXXXXXXXXXXXXXXXXXXXXXXXXXXXXXXXXXXXXXXXXXX--XXXXXXXXXXXXXXXXXXXXXXXX--X---XXXXXXXXXXXXXXXXXXXXXXXXXXX--XXXX------XXXXXXXXXXXXXXXXXXXXXXXXXXXXXXXXXXXXXXXXXXXXXXXXXXXXXXXXX---XXXXXXXXXXXXXXXXXXXXXXXXXX------XXXXXXX-XXXXXXXXXXXXXXXXXXXXXXXXXXXXXXXXXXXXXXXXXXXXXXXXXXXXXXXXXXXXXXXXXXXXXXXXXXXXXXXXXXXXXXXXXXXXXXXXX---XXXXXXXXXXXXXXXXXXXXXXXXXXXXXXXXXXX-XXXXXX-XXXXXXXXXXXXXXXXXXXXXXXXXXXXXXXXXXXXXXX---XXXXXXXXX--XXXXXXXXXXXXXXXXXXXXXXXXXXXXXXXXXXXXXXXXXXXXXXXXXXXXXX--XXXXXXXXXXXX---X------------------------XXXX----XXXXXXXXX--XXXXXXXXXXXXXXXXXXXXXXXXXX-XXXXXXXXXX--XX-------XXX-XXXX---------XXXXXXXXXXXXXXXXXXXXXXXXXXSX--X-XXXXXXXXXXXXXXXXXXXXXXXX