-----------------------------------------------------------------------------------------------------------------------------------------------------------------------------------------------------------------------------------------------------------------------------------------------------------------------------------------------------------------------------------------------------------------------------------------------------------------------------------------------------------------------------------------------------------------------------------------------------------------------------------------------------------------------------------------------------------------------------------------------------------------------------------------------------------------------------------------------------------------------------------------------------------------------------------------------------------------------------------------------------------------------------------------------------------------------------------------------------------S-------oEXX--S-X--------------------------------------------------------------------------------------------------------------------------------------------------------------------------------------------------------------------------------------------------------------------------------------------------------------------------------------------------------------------------------------------------------------------------------------------
---------------------------------------------------------------------------------------------------------------------------------------------------------------------------------------------------------------------------------------------------------------------------------------------------------------------------------------------------------------------------------------------------------------------------------------------------------------------------------------------------------------------------------------------------------------------------------------------------------------------------------------------------------------------------------------------------------------------------------------------------------------------------------------------------------------------------------------------------------------------------------------------------------------------------------------------------------------------------------------------------------------------------------------------------------------------------------------------------------XS-S--oSXXXSXSXXX-S-E------------------------------------------------------------------------------------------------------------------------------------------------------------------------------------------------------------------------------------------------------------------------------------------------------------------------------------------------------------------------------------------------------------------------------------------
------------------------------------------------------------------------------------SSSSSSSSSSSSSSSSSSSSSSSSSSSS-------------------------------S--------------------------------------------------------------------------------------------------------------------------------------------oo----------------------------------------------------------------------------------------------------------------------------------------------------------------------------------------------------------------------------------------------------------------------------------o-------------------------------E------------------------------------------------------------------------------------------------------------------------------------------------------------------------------------------------------------------------------------------------------------------------------------------------------------------------------------------------------------ooo------------------------------------SSSSSSSSSSSSSSSSSSSSSSSSSSSS----------------------------SSSSSSSSSSSSSSSSSSSSS---------SSS----XX-----------------------------------------------------------------------------------------------------SSSSSSSSSSSSSSSSSSSSSSSSSSSSSSSSSS---------------------------------------------------------------------------------S--------------------------------------------------------------------------------SSSSSSSSSSSSSSSSSSSSSSSSSSSSSSSSSSSSSSSSSSSSSSSSSSSSSSSS------------------------------------------------------------------------------------
--------------------------------------------------------------------------------------------------------SSSS--oS------------------------------SS-----Q------------------------------------------------------------------------------------------------------------------------------------------E--E-------------------------------------------------------------------------------------------------------------------------------------------------------------------------------------------------------------------------------------------------------------------------------------------------------------o----------------------------oo-------------------------------------------------------------------------------------------------------------------------------------------------------------------o----------------------------------------------------------------------------------------------------------------------------------------------oo---------XXXX------------------------------------SSSS--------------------------------------------------------------------------------------X-EXXXXXX--------XXX------o--------------------------------------------------------------------------------SSSS------SSSSSSSSSSSSS-SS---------------------------------------------------------------------------------------S--------------?----o---o------------------------------------------------------------------------------------SSSSSSSSSSSSSSSSSSSSSSSSSSSS------------------------------------------------------------------------------------
---------------------------------------------------------------------------------------------------------SS---------------------------------E-SS--E--------------------------------------------------------------------------------------------------------------------------------------------XXXXXXX--------------------------------------------------------------------------------------------------------------------------------------ooo-------------------------------------------------------------------------------------------------------------------------------------------------------------X-------E---------------------------oo------------------------------------------------------------------------------------------------------------------------------------------------------------------------------------------E------------------------------------------------------------------------------------------------------------------------o----------------oo----------------------------SSSSS--E----------------------------------------------------------------------XXXX------------XXXXXX----XX------X--EE--------------------------------------------------E------------------------------SSSS--E--?SSSSSSSSSSSS-SSS----------------------------------------------------------E---------------------------SS--------------E---------------------------------------------------------------------------------------------SSSSSSSSSSSSSSSSSSSSSSSSSSSS-----------E----------------------------------E-------------------------------------
S-----------X-----SSSSS----------------------------------------------------------------------------------S----------------------------------SS----SS-------------SS----S----------------SS--------------SQS-----------------------------------SSSSSSSS---------SQQS----SSS----------------S-------------------------Q?SSS-----?SSS-------?SSS---------S--------------------S---?-----------------------S------------------------------------XXXX-----XX-------------------------------------SSS-----ESSS-----------------------SSSSSSS----oo------------------------------------S-----------XXoo----oXX--------SSQ----------------------S?SSS--XXXXX------------------------------SQSQSQ--------SSS-------------SSSSSS--SSSSSSSSS-------S-SSSSSSSSSS----------------XX-----XXXX---------------------------------SQQS------------------------SS--SQS--------------SSSSS------------------------------------------------E---------------------------------------------XXX-------oo-----------------------------------S--SS---SS--SQ--------------------------------X------SQQQ-------------------------------XXX-------------------SS?---SQS----QQQS----------------SSS-----SSS--SSSSS-----SSSSSSSS---------SSSSSSSS---SQQ--S----SS---S--------S----SS--SQQ-----------SS---SSS----------------------------------E--E----------------------SS---------------SQ--SSS---S-----SS---SSSS------------------------------------------------------ooooooo-----ooooSSSSSSSSSSSSSSSSSSSSSSSSSSSSSSSSS-----SQS---SSSSSS-------QQQQ------------SQSSSSS------SSS---?-----------------S-
---------------------------------------------------------------------------------------------------------S----------------------------------SS----SS-------------S---------------------------------X-----------------------------------------------------------------------------------------------------oo--------------------------------------------------------------------------------------------X------------------o--------------------------XX--------------------------------------------<>------------------o--------------------------XX-----------------------------------------------------------S------------------------------------------------------------------------------------------------------------------------------------------------------XX--------------------------------------------------------------------SS-----------------------------------------------------------------------<>---------------------------------------XX---------XX-------------------------------------------SS---SS--------------------------------------------------------------------------------------------E-------------------------------------------------------------------------------------------XXX-------SS---S--------S----SS------------------------------------------------------------XXXXXX-------------------S-------------------SS------------------------------------------------------------------E--------------------------------------------------------------------------------------------------------------------------------------
---------------------------------------------------------------------------------------------------------SS----------------------------------S----SS-------------S------------------------------XXXX--------------------------------------------------------------------------------------------E----------E------------------------------------------------------------------------------------------XXXX-XXXX------------------------------------E-XX--------------------------------E-----------[]----------------------------------------------------------------------------------------------------Eo--SSS------------------------------------------------XXX----------------------------------------------------E----------------------------------------------------------------------------------------S--o------------------------SS----S--------------S---------------------------------------------------[]----------------------o------------------------------------------------------------------------SS---SS---S--------------------------------XX------------------------------------------------XXXXX-XX---------XX-S---------------------------------------------------------------------------------------SS---S--------S----SS----------------------------------------------X--------------------------------------S-------------------SS------XX--------------------------------------------------------o--------SSSSSSS-----S--S----------------------------------------------------------------------------------------------------------------
SSSSSSS----------------S-S-------------------------------o----------------------o--------------------oo-------------------------------------Soo-ooSS-------E----SSS-----S--------E--S----------XXXXX-------------S---------oo--------------------------------------------------------------------------E--<>-----------------------------------------------------------------SQSQ---------------------XX--------------------------------E---------XX-XX-------------------------------<>-----------[]---------------E--------------------------------------oo--------------------------------------------------SoS--------oo------------XXX-----------------------------------E------------------------------------------------------ooo------------------S--S---------------------------E--------E----------------------S-S----------------SS--SoS--------------SS--------------------E-------------SSSSSSSSS-------[]------------SSSSS-----------------E---------------------XXX----------------------------------X-SS-?-SS---Soooo---------SS--------E--------XX------------------------------E--------------------------------XXXX-S-----------------------------------------------------------------------------------ooooSS---SooooooooS---oSX---------E--------------------E-----------E--XX-------------------------S-----------oSS---------------??-SS--E---XX---------------------E------------------------------------------SSSSSSSS--------S-------------------------------------------------------------------o---------------------------------S----------
----------------XX------------------XXXX----------------------------------------------SS-------------SS--------X--SS-------XX--X------------SS-?SSSS--S---<>----------SS---E----<>-----E------XXXXXXQ---S?S----XXX-XX-----o---------------------SS------------ESQS------------------------Q---S?S-----<>--[]------------SQQ--Q--Q--QQQ?--QQQ---------SS------------------------------------E---------XXX----------oooo-----------------<>--------XXX-XX----------------------------E--[]-E-----------S?S----------E<>-------QQQ--SSS-XXXXX-------------------------------------------------XX---XXXX--XXXX-----SSS--------------------S--------------------------------------<>------SSSQS-----S----------E----------S?S-----SSSS-------E---XX--SSSSSS------------------XX--------------<>-------<>-------------SSS----E--------------------SSS?SSS----XX-XX-------------Q-Q----------<>-----------X------------S----XX--------------------SS-----------<>-----------XX---------------------------------------X-----X-SSS--SSS--SSSS----------SS--E----<>----XX--XX-E--------<>-----------------<>-----------EE-E-------------------S--SSS--SS-SQSQQ---------------Q-Q--Q------------S?S-------------------XXX--SSSS------ESSSSSS---SSSSSSSSSS--SSS?--S-----<>------QQ-----------<>----------<>-------------X----------------S----X-----SSSSS------------S---SS----X-<>------S?S----E------<>---QQ----------------------E----SS------------------------S------SSSSSSS??SSSS----S----Q------QQQ--Q--QQ-Q--QQQ----?SSS-------------o---------------S--------------E--S----
----------------------------------XX-------E--------------------------------------E---E-----XXX-------------EXEX----------XXX--XX-------------------------[]---------X----<>----[]----<>-----XXXXXXX----------XXX--XX--------------------------------------X------------------------------------------[]--[]-----------------------------------X-----------------X------------------------<>------X-EXXX------------E---------XXXXXX---[]-------XXXXXXX--------E------------------<>--[]<>---X-------------------<>[]-----------------------------------E---------------------------------------------------------------------------------------------------------------X-X--[]--------------------------<>----------------------------------E-EE---------------------------------------[]-------[]-------------------<>---------------XXXX?----------XXX-XXX-------E-----------------[]-----------X--------------E--XX-XXX-------<>-----------E-----X--[]-------------------X--------------------X---X-------X----XX----------------------------<>----[]--XXX---XX<>--------[]-----------------[]------XXXXXXXXXXXX----------------S-----------------------------------------------------------------------------------------------------------------------[]-------------------[]----------[]-----E-------X---------------------X---------------XX--XX--------E--X-[]------------<>---E--[]-------E-------------------------X--------------------------------SSSSS----S------------------------------------------------------------------X-------------------<>-------
------------------------------------------<>-------------------------------------<>------E--XXXXX-----------XXXX---------XXXX--XXX------o-----------------[]---------X----[]----[]----[]----XXXXXXXX---------XXXX--XXX-------------X-----------------------X------------------------------------------[]--[]-----------------------------------X---------------X-X------------------------[]----X-EXXXXX--------XXXXXX-----------------[]------XXXXXXXX--------X------------------[]--[][]--X--------------------[][]----------------------------------<>-------------------------------------------------o------------------------------------------------------------XXXX--[]--------------------------[]--------------------------------------------o--------------------------------[]-------[]-------------------[]-----------------------------XXXX--XXXX-----------------------[]-----------X-------------XXX-XX-XXX-------[]----------<>----XX--[]-------------------X-------------------XE---X-----X-X----XX----------------------------[]----[]--XXXX--XX[]------X-[]-----------------[]--------X-------------------------S-----------------------------------------------------------------------------------------------------------------------[]-------------------[]----------[]----<>-------X-----------------X---X--------------XXX--XX-----------X-[]------------[]------[]------<>-----------------------------------------------------S----SSSSS----S------------------------------------------------------------------X-------------------[]-------
------------------------------------------[]-------------------E-EE-E-EE---------[]-----E---XXXXX----------X-XXX--E-----XXXXX--XXX-----------EE-----------[]---------X----[]----[]----[]---XXXXXXXXX--------XXXXX--XXXX------XXX---X------E-E-------------XX-E-----------E-------EE-E-E---------------[]--[]---------E-E-----------------------X---E-----E-E---X-X-----X-------EE----E-E--[]-E-XXXXXXXXX-------------------------------[]-----XXXXXXXXX-------XX------E-EE-----E--[]--[][]---S-------------------[][]-E--------------------------------[]---------EE----EE-------------ooo---ooo---------XXX-E--------------------EE---------------------------EE-E-----XXX--[]------------EE------------[]-E--------------X--------------------------XX--------------------------------[]-------[]--E----------------[]---------------------E------XXXXX--XXXX--------------------E--[]-----------X-----------------XX?XXXXE--E--[]----------[]-XE-XX--[]---XXX-------------X----------E---------XE--X--E----X----XX--E----------------E--E-E---[]----[]--XXX---XX[]------X-[]--E-E------------[]----------------------------------S-----------------------E--E---E--------------------------------------------------------------------------E------EE-E---[]-------------------[]---------E[]----[]--EE-E-X--------EE-E--E--X---X-------------XXXXE-X--E---------X-[]--------E---[]------[]------[]---------------X-------------------------------EE--------------o-o-----EE-----E-------------------------------------------------------X-------------------[]-E-E-oo
XXXXXXXXXXXXXXXXXX-XXXXXX---XXXX-------XXXXXXXXXXXXX----X---XXXXXXXXXXXXXXXXXXXXXXXXXXXXXXXXXXXXXXXXXXXXXXXXXXXXXXXXXXXXXXXXX--XXXXXXXXXXXXXXXXXXXXXXXXXXXXXXXXXXXXXXXXXXXXXXXXXXXXXXXXXXXXXXXXXXXXXXXXXXXXXXXXXX--XXXXXXXXXXXXXXXXXXXXXXXXXXXXXXXXXXXXXXXXXXXXXXXXXXXXXXXXXXXXXXXXXXXXXXXXXXXXXXXXXXXXXX-XXXXXXXXXXXXXXXXXXXXXXXXXXXXXXXXXXXX-XXXXXXXXXXXXXXXXXXXXXXXXXXXXXXXXXXXXXXXXXXXXXXXXXXXXXXXXX-XXXXXX------------XXX------XXXXXXXXXXXXXXXXXXXXXXXXXXXXXXXXXXXXXXXXXXXXXXXXXXXXXXXXX----XXXXXXXXXXXXXXXXXXXXXXXXXXXXXXXXXXXX-----XXXXXXXXX-XXXXXXX---XX-XXXXXXXXXXXXXXX-------XXX---XXX------------XXXXXXXXXXXXXXXXXXXXXXXXXXXXXXXXX-----XXXX---XXXXXXXXXXXXXXXXXX--XXXXXXXXXXXXXXXXXXXXXXXXXXXXXXXXXXXXXXXXXXXXXXXXXXXXXXXXXXXXXXXXX---XXXX---XXXXXXXXXX---XXX--------------XXXXXXXXXXXXXXXXXXXXXXXXXXXXXXXXXXXXXXXXXXX--XXXX----XXXXXXXXXXXXXXXXXXXXXXXXXXXXXXXXXXXXXXXXXXXXXXXXXXXXXX---XXX-XXXXXXXXXXXXXXXXXXXXXXXXXXXXXXXXXXXXXXXXXXXXXXXXXXXX--------------X-XX------XXXXXXXXXXXXXXXXXXXXXXXXXXXX---X--XXXXXXXXXXXXXXXXXXXXXXXXXXXXXXXXXXXX-XXXXXXXXXXXXXXXXXXXXXXXXXXXXXXXXXXXXXXXXXXXXX---------------------------XX-XXXXXXXXXXXXXXXXXXXXXXXXXXXXXXXXXXXXXXXXXXXXXXXXXXXXX-XXXXXXXXXXXXXXXXXXX-XXXXXXXXXXXXXXXXXXXXXXXXXXXXXXXXXXXXXXXXXXXXXXXXXXXXXXXXXXXXXXXXXXXXXXXXXXXXXXXXXXXXXXXXXXXXX---XXXXXXXXXXXXXXXXXXXXXXXXXXXXXXXXXXXXXXXXXXXXXXXXXXXX-XXXXXXXXXXXXXXXXXXXXXXXXXXXXXXXXXXXXXXXXXXXXXXXXXXXXXX-----XXXXX--XXXXXXXX--XXXXXXXXXXXX---X-X-XXXXXXXXXXXXXXXXXXXXXXXXXXXXXXXXXXXXXXXXXXXXXXXXXXXXXXXXXXXXXXXXXXXXX--XXXXXXXXXXXXXXXXXXXXXXXXXXXXX