------------------------------------------------------------------------------------------------------------------------------------------------------------------------------------------------------------------------------------------------------------------------------------------------------------------------------------------------------------------------------------------------------------------------------------------------------------------------------------------------------------------------------------------------------------------------------------------------------------------------------------------------------------------------------------------------------------------------------------------------------------------------------------------------------------------------------------------------------------------------------------------------------------------------------------------------------------------------------------------------------------------------------------------------------------------------------------------------------------------------------------------------------------------------------------------------------------------------------------------------------------------------------------------------------------------------------------------------------------------------------------------------------------------------------------------------------------------------------------------------------------------------------------------------------------------------
------------------------------------------------------------------------------------------------------------------------------------------------------------------------------------------------------------------------------------------------------------------------------------------------------------------------------------------------------------------------------------------------------------------------------------------------------------------------------------------------------------------------------------------------------------------------------------------------------------------------------------------------------------------------------------------------------------------------------------------------------------------------------------------------------------------------------------------------------------------------------------------------------------------------------------------------------------------------------------------------------------------------------------------------------------------------------------------------------------------------------------------------------------------------------------------------------------------------------------------------------------------------------------------------------------------------------------------------------------------------------------------------------------------------------------------------------------------------------------------------------------------------------------------------------------------------
SSSSSSSSSSSSSSSSSSSSSSSSSSSS---------------------------------------------o------------------------------------------------------------------------------------------------------------------------------------------------------------------------------------------------------------------------------------------------------------------------------------------------------------------------------------------------------------------------------------------------------------------------------------------------------------------------------------------------------SSSSSSSSSSSSSSSSSSSSSSSSSSSS----------------------------SSSSSSSSSS-----SS--SSSS-SSSS------------------------------------------------------------------------------------------------------------------------------------------------------------------------------------------------------------------------------------------------------------------------------------------------------------------------------------------------------------------------------------------------------------------------------------SSSSSSSSSSSSSSSSSSSSSSSSSSSS------------------------------------------------------------------------------------------------------------------------------------------------------------------------------------------------------------------------------------------------------------------------------------------------------------------------------------------------------------------------------------------------------------------------------------
---SSSS---------------------------------------------------S------------------------------------------------------------------------XX-------------------------------------------------------------------------------------------------------------------------------------------------------o-------------------------------------------------------------------------------------------------------------------ooo--------------------------------------------------------------------------------------------------------------------------------------------------------Q-----SSSS-------oS--SSSSSS----SS--------------------------------------------SSS-------------------------------------------------------------------------------------------------------------------------------------------------------------------------------------------------------------------------------------------o-----------------------------------------------------------------------------------------------------------------------------------------------------------------------------------------------------SS------------------------------------------------------------------------------------------------------------------------------------o----------------------------------------------o----------------------------------------------------------------------------------------------------------------------------------------------------------------------------------------------------------------------------------------------------------------------
----SSS---------------------E----------------------------------Eoo------------------------------------------------------------------------------E-------------------------------------------------------------------------------------------------------------------------------------------------------------------------------------------------------------------------------------------------------------------------------------------------------------------------------------------------------------------------------------E------------------------oooooo------------SSSS--E----ES---SSSSS----SS--------------------------------------------SSS------------------------------------------------E-------------------------------oo--oo---------------------------------------E-------------------------------------------------------------------------------E----------------------------------------------------------------------------------------------------------------------------------------------------E------------------------------------------------------------------------------SS--E----------------------------------------------------------------------------------------------------------------------------------S---------------------------------------------------------------------------------------------------------------------------------------------------------------------------------------oo--E--------------------------------------------------------------------E---------------------------------------------------
---S------------------------S----QS--------------SSSSS---------XXXX-----XXX----------------SSS------------------------------------------------SSQS----SSSSSSSSSS--------------------------SSSSS--------------------QSQS--------------------SSS----------------S---------------SSSS-SSSSS-?SSS-------SS------SSSSSS-------------------------------------------------?SSS---------------------SSSSSSSS----E---------XXXX-----------------------------------------------------------S-----------QQQQQ-----------S---SSS-----SSQQ-------SSSSSSSS-?SSS-----XXoo--XXX-------------------SS---SS---S----o---S--S--S------------SSSSSSSSS----------S--------SSSSSSS----S---S----------------------------S---------SQQ------------------------------------------------------Q--------------------ES---QQQQQ--------------------------------------------------------------------------SSS---------XXX---------SSSS--------XXoo----oo------SS-----------------------SSS-------------------------------------------SSS----------SSSSS----E--E---------------?SSSS-------------S?SSS---Q------------------------E---S---S----S------------?-----------------SSS------------------------QQSS-------------S-----------SSS-------------------SS-----------------SS---S-----------------?SSS-SSS----------------SQS---------S------------------------------------------------------E--?SSSQ----?------------S-----SSS-------------S---SSS----SS----oo----X------E--E-----SSSS-------------SSSSSS------------------------------------SQS------SSSS------------o--?-----------------SSSS---
------------------------------------------------------------------------XXX------------------------------------------------------S---------------------------------------------------------------------------------------------------------------------------------------------------------------------------------------------------------------------------------------------------------------------------XX------------------X------------------------------------------------------------------------------------------------------------------------------------------------SS---SS---S--------SS----S-------------------------------------------------------------------------------------------------------------------------------------XXX-----------------------------------------------------------------------------------------------------------------------------------XXXS------------------------------------------------------------------------------------------------------------------------------------XXXXX?------------------------------------XX-----------------------<>---------<>--S------------------------------------------------------------------------------------------------------------------------------SS---------------------------------------------------------------------------oo---------------oo-----------------<>------------------S--------------------------------------XXX------------------XXXXXX-----------------------------------------------------------------------------------------------------------------
---S-------------------------------------------------------------------XXXX--------------------------------------------------------------------------------------------------------------------------------------------------------------------------------------------------------E---------------------------------------------------------------------------------------------------------------------------------------------------------------------------X---------------------------------------------------------------------------------------------------XX-------------SS-?-SS---S-SS-S-S--S----S---------------------------------------------------------------------------------------------------------------------------------------XXXXX----------------------------XX------------------------------------------------------------------------------------------------XXXXX---------------------------------------------------E------------------------------------------------------------E--------------------------------------------------------------------------------------[]-------S-[]---------------------------------------------------------------o-----------------------------------------------------------So----SS---------------------------------------------------------------------------------------------------------------[]-----------------------------------------------------------------------------------------------------------------------------------------------------------------------------------------------------
---SoS---------------E---------------------E-----SSS--------oo--------XXXXX-----------------------------------------oo---------------------------------------------------------ooo-------------E-------------------------------------------------------------------------------------------------------------SSSSS----------------------------------oo---------S----------------------------------------QQ-----------------XXXX--------------------E-----------X-S------------------------------------------------------?---------------------------------------------------------SS---SS??-So?--SoS-------S------------------------------------------o-----------------------------------------------------------------E----SSSSSS-------------------------------------------------XX---------------------------------------------------XS----E------------------------------------XXXXXX----------S-------------------------------X--------<>--------------------------------------------------E--S-----<>--------------------------------------------------------------------------------------[]--o----SS[]---------oo--o----------------------E-----------X-------------------E------------------------------------------------------S-----SS------E-----------------------------------------------------------------------------------E-------E-------E----[]----------------S-S--SS---------------------------SS-----------XXX--------------------S-SQ--------------------oo---------------------------------------------------------XX--oo--------------SQ--S---
---SSS--------------<>----SS----SSS-------<>-------------------------XXXXXX-------------XXXXX----------------------o--o------------------------QQQQ--Q--Q--Q-----------X-------------------SSSSSQS------S-------QQQQ--Q-Q-------Q-QQQ-Q--QQQ--------E----------------------SQ--SSS?S-------------------------------------E------------------X-----------------X----------------------------SQQ?SSQQQ----------------------------------------------<>----------XX----------------S-------------SSSS---------------QQQQ-----SSS-----------SQ?SSSSS---------XXXX----------------------S---SSS--SSS--SSS------SS---------------SS--SSS----E-XX---S-----S?SSSSSSSSSSSSS?S-----------------------------------QQ?-SQSQS----E--<>-----------------XXX----------------------Q--------E--S----SX--Q--QQ?SSQSQ------X------------------------------XXX---<>------SQQ----E--------------S?S----XXXXXXX---------------------XX---XXXX--XXXXX--SS-X-----E--[]------------X------------------------E-----------<>-----E--[]-----E-------XXXX-------XXX---------QQ------------XXXX--SSS---------------------------[]---E---SS[]SSS----SSSSSSQS---------Q-----Q----<>----------XX---------SSQS----SS------E-----------------S-----------------SS--------S--S-----SSSSoS-----------------------------------E------QQQ-------S----------Q---------------------<>-----E<>------<>----[]-----SSS-----XXXXX-------------S-----------------------------------XXXX-XXXX------------------------------XX------o-Q--------------------------ESQS-------------------------o-----------XX-----------
--------------------[]--------------------[]------------------------XXXXXXX-SSS---------------------------------------------------------o-XX--------------------------XX---------------------------------------------------------------------------<>-------------------------------------------------------------------<>------E----------XXX---------------XX-----------------------------------------------------------------------------------[]---------XXX-----------------------------------------------------------------------------------X---XX-----E-----------------X--------X-------------------------------------------<>-XX------E------------------------------------------------------------------<>--[]--S-----------------------------------------------<>-------XX--------------------------------------E----------XXXX---[]------------<>--------------------XXXXXXXX-----------------E------------------------X----<>--[]-----E-----XX-----------------------<>-----------[]----<>--<>----<>----------------------------------------------------------------------------<>--[]--X------[]-----------------------------------[]---------XXX----------------------XX<>SS-----------E------E-----------------------------------S-----E----------------------X--------<>---------------------------------E---------------[]----<>[]------[]----[]------------EXXXXX-------------------<>-----------------X------------------------------------------X----XXXX---------------------------------------------------------------------------XXX-----------
--------------------[]--------------------[]-----------------------XXXXXXXX----------------------XXXX------------------------------------XXX-------------------------XXX---------------------------------------------------------------------------[]----------------------------------X---------------------------X----[]-----<>---------XXXXX-----------X-XXX----E------o------------X---X-----------X------------------------------------------[]--------XXXX-----------------------------------------------------------------------------------XXXX-----------E----E---X-------------XX------------------------------------------[]-XX-----------------------------------------------------------<>------------[]--[]----------------------X---------------------------[]-------XXX------------------X-----------------<>---------XXXXX---[]------------[]-------------------XXXXXXXXX-----------------------------------------<>----[]--[]----<>----XXX-----------------------[]-----------[]----[]--[]----[]--------------------XXXXX-----------------------X--------X------------------[]--[]--XQ-----[]-----------------------------------[]-<>--<>-XXXX----------------------XX[]S-----------<>-----<>--------X--------------------------S----<>------------------E---X--------[]--------------------------------<>------<>-------[]----[][]------[]----[]------------XXXXX-----------X--------[]-----------------X--XXX---------------------------------E---X----XXXX--------------------------------------------------------------------------XXXX-----------
---EE-----E------E--[]-------E-EE------E--[]-----------X----------XXXXXXXXX--------X---o------XXXX-----SSSSSS----------------------X--S--------E------------------E-XXXX---------------------E-----------E---E------E-E-----EE------E--E-----------[]-E--------EE-E-------------------XX-EE-----X--E--------------XX----[]---E-[]--------XXXXXX------------XXXX----SS----------EE-E----X-E-X-----E-----X---------------------------------------E--[]-------XXXXX---------E-E-E---------------EE--------E-E-----E-----------------------------------XXXS--------------------X-XX------E-E-XX---------E-------E--------EE-E------------[]-XX-------------------------------E-E-EE-EE-E--E---------E----[]------------[]--[]--E-------------------X---E-E---------EE----------[]-E---E-XXX----EE-------EE---X---------------E-[]--------XXXXXX---[]------------[]-EE---------------XXXXXXXXXX--------XX--------------oo---------------[]-E--[]--[]----[]----XXX------------E-EE-----E-[]--X-EE-----[]----[]--[]----[]-----------XXXXXX-------------------------------X-------XX-------EEE-----E--XXX-[]--ES--E--[]------------------------EE-E-------[]-[]--[]XXXXX--------E--E----------XX[]SS---EE---E-[]-----[]--EE-E-XX---E-------E-E-----------E-----[]----------------------X-E-EE---[]---------E-EE-----------E--E----[]------[]----E--[]----[][]------[]-E--[]---E-------XXXXXX-SSSSS----XX-EE-----[]-E-----E---------X-------oo---------------------------------X----XXXX-------------------------------------------------------EEE---------------XXXXX--SSSS-----
XXXXXXXXXXX-XXXXXXXXXXXXXXXXXXXXXXXXXXXXXXXXXXXXXXXXXXXXXXXX-XXXXXXXXXXXXXXXX---XXXX-XX---------XX-----------XXXXXXXXXXXXXXXXX----------S---XXXXXXXXXXXXX--XXXXXXXXXXXXXXXXXXXXXX-X---XXXXXXXXXXXX--XXXXXXXXXXXXXXXXXXXXXXXXXXXXXXXXXXXXXXXX---XXXXXXXXXXXXXXXXXXXXXXXXXXXXXXXXXXXXXXXXXXXXXXXXXXXXXXXXXXXXXXXXXXXXXXXXXXXXXXXXXXXXXXXXXXXXXXX--XXXXXXXXXXXXXX----------XXXXXXXXXXXXXXXXXXXXXXXXXXXXX--XXXXXXXXXXX--------------XX--XXXXXXXXXXXXXXXXXXXXXXXXXXXXXXXXXXXXXXXXXXXXXXXXXXXXXXXXXXXXXXXXXXXXXXXXXXXXXXXXXX--XXXXXXXXXXXXXXXXXXXXXXXXX--X---------X-XX-X-XXXXX--XXXXX--XXXXXXXXXXXXXXXXXXXXXXXXXXXXXXXXXXXXXXXXXXXXXXXXXXXXXXXXXXXXXXXXXXXXXXXXXXXXXXXXXXXXXXXXXXXXXXXXXXXXXXXXXXXXXXXXXXXXXXXXXXXXXXXXXXXXXXXXXXXXXXXXXXXXXXXX---XXXXXXXXXXXX--XXXXXXXXXXXXXXXXXXXXXXXXXXXXXXXXXXXXXXXXXXXXXXXXXXXXXXXXXXXXXXXXXXXXXXXXXXXXXXXX-XXXXXXXXXXXXXXXXXXXXXXXXXXXXXXXXXXXXXXXXXXXXXXXXXXXXXXXXXXXXXXXXXX---XXX------------XXXXXXXXXXXXXXXXXXXXXXXXXXXXXXXXXXXXXXXXXXXXXXXXXXXXXXXXXXXXXXXXXXXXXXXXXXXXXXXXXXXXXXXXX-----------------------XXXXXXXXXXXXXX---XXXXXXXXXXXXXXXXXXXXXXXXXXXXXXX--XXX-XXXXXXXXXXXXXXXXXXXXXXXXXXXXXXXXXXXXXXXXXXXXXXXXXXXXXXXXXXXXXXXXXXXXXXXXXXXXXXXXX-XXXXXXXXXXXXXXXXXXXXXXXXXXXXXXXXXXXXXXXXXXXXXXXXXXXXXXXXXXXXXXXXXXXXXXXXXX--XXXXXXXXXX-XXXXXXXXXXXXXXXXXXXXXXXXXXXXXXXXXXXXXXXXXXXXXXXXXXXXXXXXXXXXXXXXXXXXXXXXXXXXXXXXXXXXXXXXXXXXXXXXXXXXX-XXX-XXXXXXXXXXXXXXXXXXXXXXXXXXXXXXXXX-X-------XXX-------------XXXX-XXXXXXXXXXXX--XXXXXXXXXXXXXXXXXXXXXXXXXXXX-XX---XXXXXXXXXXXXXXXXXXXXXXXXXXXXXXXXXXXXXXXXXXXXXXXXXXXXX--SS---XXXX