------------------------------------------------------------------------------------------------------------------------------------------------------------------------------------------------------------------------------------------------------------------------------------------------------------------------------------------------------------------------------------------------------------------------------------------------------------------------------------------------------------------------------------------------------------------------------------------------------------------------------------------------------------------------------------------------------------------------------------------------------------------------------------------------------------------------------------------------------------------------------------------------------------------------------------------------------------------------------------------------------------------------------------------------------------------------------------------------------------------------------------------------------------------------------------------------------------------------------------------------------------------------------------------------------------------------------------------------------------------------------------------------------------------------------------------------------------------------------------------------------------------------------------------------------------------------
------------------------------------------------------------------------------------------------------------------------------------------------------------------------------------------------------------------------------------------------------------------------------------------------------------------------------------------------------------------------------------------------------------------------------------------------------------------------------------------------------------------------------------------------------------------------------------------------------------------------------------------------------------------------------------------------------------------------------------------------------------------------------------------------------------------------------------------------------------------------------------------------------------------------------------------------------------------------------------------------------------------------------------------------------------------------------------------------------------------------------------------------------------------------------------------------------------------------------------------------------------------------------------------------------------------------------------------------------------------------------------------------------------------------------------------------------------------------------------------------------------------------------------------------------------------------
---------------------------------------------------------------------------------------------------------------------o-------------------------------------------------------ooo--------------------------------------------------------------------------------------------------------oo------------------------------------------------------------------------------------------------------------------------------------------oo------------------------------------------------------SSSSSSSSSSSSSSSSSSSSSSSSSSSS----------------------------------------------------------------------------------------------------------------------------------------------------------------------------------------------------SSSSSSSSSSSSSSSSS?SSSSSSSSSS---------------------------------------------------------------------------------------------------------------------------------oo------------------------------------------------------------------------------------------------ooo-------------------------------------------------------------------------------------------------------------------------------------------------------------------------------------------------------------------------------------------------------------------------------------------------------------------------------------------------------------------------------------------------------------------------------------------------------------------------------------------------------o------------------------------------------------------------------
----------------------------------Q----------------------------------------------------------------------------------------EE------------------------------------------------XXXX-------------------------------------------------------------------------------------------------------------------------------------------------------------------------------------------------------------------------------------------------------E--E---------------------------------------------------------------------------------------------------------------------------------------------------------------------------------------------------------------------------------------------------------------------------------------------------S-------------------------------------------------------------------------------------------------------------------------------------------------------------------------------------------------------------------------------------------XXXX-------------------------------------------------------------------------------------------------------------------------------------------------------------------------------------------------------------------------------------------------------------------------------------------------------------------------------------------------------------------------------------------------------------------------------------------------------------------------------------------------------------------------------------------------------------------------
---------------------------------------------------------------------------------------------------------------------------XXX-------------------------------------------------------------------------------------------------------------------------------------------------------------XX----------------------------------------------------------------------E-------------------------------------------------------------------XXXXXX----o-----------------------------------------------------------------------------------------------------------------------------------------------------------------------------------------------------------------------------------------------------------------------------------------------------------------------------------------------------------------------------------------------------------------------------Eooo-------------------------------------------------------------------------------------------------------------------------------------------------------------------------------------------------------------------------------------------------------------------------------------------------------------------------------------------------------------------------------------------------------------E---------------------------------------------------------------------------------------------------------------------------------------------------------------------------oo-------------oooo-----------------------------------------------------oo--oo--------------
S-----oo--XXX--Sooo---------SS----------XXo-------------------------E----------------------------------------------S----------------------SS-----------------------S------S-------------------SS---S--------S----------------------S-----------------------S------------------SSSSSSS---XX-----------XXX----------------------------------------SSSS-------E-------E--E---------------------------------SS-----------------------------------------------------------S-----SSSS--------------S??----------------------------SQS---------XXX-------------------SSSS-------------------------------------E---S---------------------------S--------X----------------------------------------?Q-Q------------------------------------------------SSSS---------------------------------------------------------------------------------------SSSS----------------SQS----------------XXXXX-------XXXX--------S-------SSSS------SSSS------------------------------------------------S----------------------------------------------------------------------------------------------?SSS--------------SSSSS-----------------------SSSSS------SS-------------------------S-------------------?--------S----S--------------------------------SSS-----------?------S----SSSSS----------------------------SSQS---------S-----------Q------------------SSQ--S-----------------------?-------SS----S------------------------------------------------------------------------------XX-----XXXX------------XXXX---------------------------------------------o---------------------------
-----XX------------------------------------------------E-----------<>-------------------------------------------------------------o------XXX-----------------oooo-----------------------------------------------------------------------------------------------------------------------------XXX---------------------------------------------------------<>---------XXXXXX------------------------------------------------------------------oo---------------------------------------------SS------------------------------------------XXX-----------------------------------------------------------<>-------------------------------S-----------------------------------------------------------------------------------------------------------------------------------------------------------------------------------------------------------------------ooo-------------------------XXXXS---------------------------------------------------------------------------------------------------------------------------------E--------------------------------------------------------------------------------------------------------------oooo-----------------------------------XXX--E--------------------------------------------------------------------------------------------------------------------<>---------------------------------------------------------------------------------------------------------------------------------------------------XX-----------------------------SSSS----------------------------------------------------oo---------
----------------------------------------------------XXXX-----------[]---------------XX--o------------------------------S-S--------------XXXX-------------------E------------------------------------------------------------------------------------------------------------------------------------------------------------------------------------------[]-----------------------------------------XXX-------------------------------------------------E-----------------------------o----SS----------------------------------------EEEXX-----------------------------------------------------------[]---o--------------o---------------------------------------------------------------------------------------------------------------------------------------------------------------------------------------------------E----------------------E------------------------------------XXXX------------------------------------------------------------E--------------------------------------------------------------------XXXXX-------------------------------------------------------------------------------------------------------------------o----------------------------------------------------------------XX-------------------------o-------------------------------------------------------------[]--------------------------------------------------------------------------------------------------------------------------------------------------------------------------------XXX------------------------------------------------------------------
----------------------------S-----------------------------------E-->----------------S---------------------------oooQ---SoS-------------XXXXXSSSSSS---------E-----S-S-------------------E-----------------------------------oo----------------ooo----------------------------------------------------------------------------------------------------------[]-----------------------------------------------------------------E------XXXX-------------E--<>----------------------------------SS---------o----o-----------------------E-XXXXX-------------------------------E--------------------------EXX--o-----------------------E------SQSQS---------------------------------o-----------------S-SQ---------------S----------------------------------------------------------X-S--SSSSSSS-------------------------E--------<>------------XS--E----<>--------------------------------E---XXXX--------------------------------------------------------E--<>-----------------------E--------------------------------------------------------------SSSSSSSS----------------oo----------E---EE---------------------------------------------------E--------------------------------------------------------------------oo---S---------------------X---------------------------E------------------------------------S-[]--------------------------------------------------S--Q-----------------------------------------------------------------------------------------------------------o----oo--------XXSS--Q-------------------------------------------------E----SS---S--
--------XXXXXXX----XXXXXXXXX-----------S----XXX-----------E----<>-----------------------------------------------?SSQ---SSS------------XXXXXX--------------<>-------------QS-----------<>-----------S------------------E-------------------<>----------------------------------------------------XXXXX---XXX---XXXX--------------S-------------------------XXS--XXXX-----------------------XXXX----------SS------------------<>----S-S---------------<>--[]---------QQQQ--QQQQ--------------XSSS-----X-----------------------S?S------XXXXXX------------Q--Q--QQQ---------<>---S---------------------XXXX-XX----------------------<>--S--------------S----XX-X----------------------------EQQQ-------------------XX---------X-----------------S----X---XX----------------------XX-----------------------------------<>-----E--[]-----------XX--<>----[]------S?S---------------------------XXX---------QQQ-QQ-Q--------------------------------E------<>--[]---------------E------<>---Q---------<>--------------------E-E---------------------------------------------------Q--------------X--XX---------o-Q-------------Q--SSSS----o--------<>---------------XX---E------XXXX----X--------------SSS--------------------S-------------------XXX--SS----QQQQ--Q----E------<>---------S---------S-----E----------S-[]SS--S--------<>---------SSS-SS----SSS---------------------------S-----------X-------------------------------------------------------------------------XX------------------------XXX-----------------------------------XXX--------------<>------------
-----------------------------------E---------------------<>----[]-------E-------E----------------------------------------------------XXXX-XX--------------[]--------------------------[]---------E-------------E-----<>-------------------[]------------------------------X-------------------------------------------------------------------------------------------------------------------------------------------E-----[]----X-----------------[]--[]--E-----------------------------XX-------XX--------------------------------XXXXXX------------------------E-----[]------------------------XXXXX-XXX---------------------[]--S-X--------------E--X--XX-----------------------------------------------X-XXX--------XX-------------------E--E----X-----XXXX?-----------XXX-------------------------------X---[]----<>--[]----------EXX--[]----[]-----------------------------------XXXX------------------------------------------------<>------[]--[]--------------<>------[]-------------[]---------------E---XXXXXXXXX-?-----------X-------------------E---------------------------XX-XX---------------------------EE----------------[]--------------XXX--<>------------------------------------------------------------------------XX-------------------<>------[]------------------------<>------------[]-------------[]------------------------------------------------------------XX-XX-?--------E-----------------------------------------------------------------------------------XXXXXX-------EX------------------------------------------[]------------
----------------o-----------------<>---------------------[]----[]------<>------<>---X-----------------------------------------------XXXX--XX--------------[]--------------------------[]--------<>------------<>-----[]-------------------[]--------------------------E---X------------X-------------------------------------------------X---------------------------------------------------------------------<>----<>-----[]----X-----------------[]--[]-------------------------------XXX------XXX--------------------------------XXXXXX-----------------------<>-----[]-----------------------XXXXXX-SXX---------------------[]--XXX-----------------X--XXXXX--------------------------------------------X-XXX-------XXX---------X------------X---XX--------------------XXXXX-----------------------------XX---[]----[]--[]----------XXX--[]----[]----------------------------------XXXXX----------------------------------E-------------[]------[]--[]--------------[]------[]-------------[]--------------<>-------------------------X------------------<>----------------------EX---XX-XXX------------------X-----------E---o---------[]-------------XXXX--[]---------------------------------------X------------E-------------------XXX------------------[]------[]------------------------[]------X-----[]-------------[]---------------------------------------------------X-------XXX------------<>----------------------------------------------------------------------------------XXXXXXX-------XX------------------------------------------[]------------
------ooo-------------------------[]---------------------[]----[]------[]------[]---X---EE-E--------------------E-EE-----------EE--XXXXX--XX--------------[]-------------E---------E--[]--------[]------EE--E-[]-----[]------------EE-E---[]-------E--E-------------------X------------X--------o----------------------------------------X---------------------------------------------------------------------[]--E-[]--E--[]-E--X-----------EE-E--[]--[]----E-------------------------XXXXE----XXXX----------------------------E---XXXXXX-------XX------EE------[]-----[]-----------E-E------E-XXXXXXX-XSX-----EE-E------E-----[]--XXX-------------E---X--XXXX-----------------------EE----------E-----E-E-XXXXX------XXXX-------E----E---------X---XX-------------------XXXX-X------------------------EE-XXXX---[]-E--[]--[]--------XXXXX--[]----[]-----------------------------------XXXX------X-----------E---------------S-----E-EE----[]------[]--[]---X-E--------[]-----E[]-------E-E-E-[]----EE------E-[]-------------------------X------------------[]--------------E------XXX---X--XXX------X-----------X--------------XXE--------[]------------XXXXX--[]------------------------E----------E---X-------------------E------------XXX--------E---------[]------[]--------------E--E-E----[]-E----X--E--[]----E--------[]----------E-------------------------------EE-E-----X------XXXX------------[]------------------------------E--E-----------------------------------------------XXXXXXXX-SSSSSXXX------o--------------------------------E--[]------------
------XXX-------------------XXXXXXXXXX-XXXXX-------XXXXXXXXXXXXXXXXXXX-XXXXXXXXXXXXXXXXXXXXXXXXXXX-XXXXXXXXXXXXXXXXXXXXXXXXXXXXXXXXXXXXX--XXXXXXXXXXXXXXXXXXXXXXXXX-XXXXXXXXXXXXXXXXXXXXXXXXXXXXXXXXXXXXXXXXXXXXXXXXXXXXXXXXXXXXXXXXXXXXXXXXXXXXXXXXXXXXXXXXXXXXXXXXXXXXXXXXXXXXXXXX---X------X------XXX------------XXXXXX--XXXXXXXXXXXXXXXXXXXXXX-X-------XXXX------XXXXXXXXXXXXX---XXXXXX-----XXX-----XXXXXXXXXXXXXXXXXXXXXXXXXXXX--XXXXXXXXXXXXX-XX--XXXXXXXXXXXXXXXXXXXX-----XXXXXXXXXXXXXXXXXXXXX---XXXXXXXXXXXXXXXXXXXXXXXXXX-XXXXXXXXXXXXXXXXXXXXXXXXXXXXX-XXXXXXXXXXXXXXX---XXXXXXXXXXXXXXXXXXX---XXXXXXXXXXXXXXXXXXXXXX-XX--XXXXXXXXXXXXXXXXXXXXXXXXXXXXXXXXXXXXXXXXX--XXXXXXXXXXXXXXXXXXXXXXXXXXXXXXXXX-X-XXXXXXXXXXXXXXXXXXXXXXXXXXXXXXXXXXXXXXXX-----XX-X--XXXXXXX------XXXXXXXXXXXXXXX--XXXXXXXXXXXXXXXXXXXXXXXXXXXXXXXXXXXXXXXXXXXXXXXXXXXXXXXXXXXXXXX---XXXXX----XXXXXXXXXXXXXXXXXXXXXXXXXXXXXXXXXXXXXXXXXXXXX--XXXXXXXXXXXXXXXXXXXXXXXXX-XXXXXXXXXXXXXXXXXXXXXXXXXXXXXXXXXXXXXXXXXXXXXXXXXXXXXXXXXXX-----------XXXXX-XXXXX-XXXXXXXXXXXXXXXXXXXXXXXXXXXXXXXXXXXXXXXXXXXXX---XXXXXXXXXXXXXXXXXXXXXXXXXXXXXXXXXXXXX----XXXXXXXXXXXX-X-XXXXXXXXXXXXX--XXXXXXXX-------------XXXXXXXXXXXXXXXXXXXXXXXXXXXXXXXXXXXXXXXXXXXXXXXXXXXXXXXXXXXXXXXXXXXXXXXXXXXXXXXXXXXXXXXXXXXXXXXXXXXXXXXXXXXXXXXXXXXXXXXXXXXXXXXXXXXXXXXXXXXXXXXXXXXXXXXXXXXXXXXXXXXXXXXXXXXXXX-X-XXXXXXXXXXXXXXXXXXXXXXXX----XXXXXXXXXXXX-XX-X-XX----XXXXXXXXXXXXXXXXXXXXXXXX---XXXXXX-------XXXX------------XX-X----XXXXXXXXXX------XXXX----XXXX-XXXX---XXXXXXXXX---XXXXXXXXXXXXXXXXXXXXXXXXXXXX