------------------------------------------------------------------------------------------------------------------------------------------------------------------------------------------------------------------------------------------------------------------------------------------------------------------------------------------------------------------------------------------------------------------------------------------------------------------------------------------------------------------------------------------------------------------------------------------------------------------------------------------------------------------------------------------------------------------------------------------------------------------------------------------------------------------------------------------------------------------------------------------------------------------------------------------------------------------------------------------------------------------------------------------------------------------------------------------------------------------------------------------------------------------------------------------------------------------------------------------------------------------------------------------------------------------------------------------------------------------------------------------------------------------------------------------------------------------------------------------------------------------------------------------------------------------------
------------------------------------------------------------------------------------------------------------------------------------------------------------------------------------------------------------------------------------------------------------------------------------------------------------------------------------------------------------------------------------------------------------------------------------------------------------------------------------------------------------------------------------------------------------------------------------------------------------------------------------------------------------------------------------------------------------------------------------------------------------------------------------------------------------------------------------------------------------------------------------------------------------------------------------------------------------------------------------------------------------------------------------------------------------------------------------------------------------------------------------------------------------------------------------------------------------------------------------------------------------------------------------------------------------------------------------------------------------------------------------------------------------------------------------------------------------------------------------------------------------------------------------------------------------------------
--------------------------------------------o-----------SSSSSSSSSSSSSSSSSSSSSSSSSSSS-------------------------------------------------------------------------------------------------------------------------------------------------------------oo----------------------------------------------------------------------------------------------------------------------------------------------------------------------------------------------------------------------------------------------------------------------------------------------------------------------------------------------------------------------------------------------------------------------------------------------------------------------------------------------------------------------------------------------------oo-------SSSSSSSSSSSSSS?SSSSSSSSSSSSS------------------------------------------------------------------------------------------------------------------------------------------------------------------------------------------------------------------------------------------------------------------------------------------------------------------------------------------------------------------------------------------------------------------------------------SSSSSSSSSSSSSSSSSSSSSSSSSSSS--------------------------------------------------------SSSSSSSSSSSSSSSSSS--------------------------------------SSSSSS-------S?SSSSSSSSSSSSS----------------------------------------------------------------------------------------------------------------
-----------------------------------------------------------------------------------------------------------------------------------------------------------------------------------------------------------------------------------------------XXXXX--------------------------------------------------------------------------------------------------------------------------------------------------------------------------------------------------------------------------------------------------------------------------------------------------------------------------------------------------------------------------------------------------------------------------------------------------------------------------------------------------------------------------------------------------XXXX-------SSS-----------------------------------------------------------------------------------------------------------------------------------------------------------------------------------------------o-------------------------------------------------------------------------------------------------------------------------------------------------------------------------------------------------------------------------------------------------------------------------S--SSSSSSSS--SS---S-------------------------------o----------------------------------------------------------------------------SSSS----------------------------------------------------------------------------------------------------------------------------------------
-----------------------------------Eoo-------------------------------------------------------------------------------------------------------------------------------------------------------------------------------------------------oooo------------------------------------E----------------------------------------------------------------------------------------------------------------------------------------------------------------------ooo--------------------------------------------------------------------------------------------------------------------------------------------------E--------------------------------------------------------------------------------------------------------------------E--------------------------------------------------------------------------------S-------------------------------------------------------------------------------------------------------------------------------------------------------------------------------------------------S------------------------------------------------------------------------------------------------------E-------------------------------------------------------E----------------------------------------------------------------------------------------------------------S--SSSSSSSS--SS---S--------------E----------------------------------ooQ--------------------------------------------------------SSSS----XX----------------------------------------------------------------ooo---------------------------------------------------------------
------------------------------------XXX------XX----------------------oooooo-----oooo------------E--S--------------------------------------------------------------------------S--?SSS-------?--------S---------SSS--SS?SSSSS-------S---XXXX----------XX----------------ES-S---EE--E---------------------------------SSSSS-----------------------SQQQQ--------------SSSSS------------------------------------oo---XXX---XXoo---------------------------XXXSS----------------------X----------------S----------------------------------------X------------------------------------------------------------SSSSSSSS--------------------------Q-------------SSS---------SSSSS------------E------------------------------------------ES--SQQQQS---------------------------------------XXXSSS------E--E--------o------SE--------ooooo----------o-------------------------------QQ--------------------------------------------------------------------------------------------SS--------------------------------S---SSS------------------------------------------QQQQ----------------Q-------------------------SSQQQ------------S?SSSSS--------------------------------Q-----------------S?SXQ---SQ--------------------------------------------------------Q-SSSQ--?--------------SSSSSSS?------------------SSS---SSS?Q--SS----S----SQS-SSS---SE--------XXX-----ooo--------------------------------------------------------------------------ooo---------------SS------------------SSS-----------------------XXXX----Q-----------------------------S---------------------------
---------------------------------------------XXXS----------------------------------------------<>---------------------------------------------------------------------------------------------------------------------------------------------------XXX---------------<>---------XXXXXX-------E--------------oooo---------------------------------------------------------------------------------------------------------------------------------------------------------------XSSSS-----------------------------------------------------------------------------------------------------------------------------------------------------------------------------------------------<>--ooo-------------------------------------------------------------------------oooo---------XXX------------XXXXX-----------SS--------------------------------------------------------------------o---------------------------------------------------------------------------------------------------------------------SS------------------------------------------------------------------------------------------------------------------------------------------------------------------------------------------------------------------------------------------------------------------SS-------------------SSS----SS--------------------S---------XX-----------------------------------------------------------------------------------E----------------------------------oooo------------------------------------------------------------------------------------------------
--------------------------------------------XXXXX-------------------SSSSSS--S-S-SSSS-----------[]-----------------------------------------------------------------XSS------------o-----------------------------------------------------------------XXXX---------------[]--------------------X----------------------------------------------XXXXX-------------------------------------------------------------------------------------------------------------------------------XXX--------------------------------------------------------------------------------------------------------------------------------------------------------------------------------------------------[]--------------------------------------XX------------------------------------------------EXXXXX----------------------------S---------SSSS---------------------------------------------o------XX-XXX--------------------------------------E------------------------E----------------------------------------------------SS-----------------------------------------------------------------------------------------------------------------------------------------------------------------------------------------------------------------------------------XXX----------------------------SS-------------------SS------S--E-S--------------SS-------------------------------------------------------------------------------------------------SSSSSS-------------------------------------------------------------------------------------------------o----------------------------
---------E---------------------------------XXXXXX-----------XX-------S-X-SoS--SoS--S-----------XXX---------------oo---oo-----------------------------------------XXX--------------------E---------------------------------------------------------XXXXX---------------[]-----------------------------------E-----------------------------------------------oo-------------------------------------------------------------XXX-----------------------------------X-------------XXXXS-SQ---------------------E----------------------------------------------------E-----------------------------E-------------------------------------------------------------------X-----------S-----[]------S-S-----------------------------S------------------------E---S--------E----------XXXXXXX---------------------------SS---------SSSS---------------------------------------E--------------------------------o-------------------E--<>-------------E------------------------------------------------------------??-SS--------------S------E---------E--------E------------S---------------------------E---E-------------------------------------------E------------------------ooo-----------------------------------------------------------------------------------------------------S---------------oooooSS--EE--S-----------------------E--------------------XXXXX-------------------------------------------------------------oE------SSSSS-------------------------E---------------XX----E---------------------------------------------------S---------------------------
--------<>------S------------XX------------XXXXX-----------XXX-S---------SX---SSS--S-----------X------------E---------------------X---------------------S-------XXXX----S-----S--S?S---<>---E------X-o-S-------XX--X-----------XQ----XXXX--------XXXXXX---------------XXX--XX----------X------ooo--------E<>--------------QoQQ--Q----------------?SSS------------------S-----oo-------XX--X-------------------XXXXXXXXX-----------XX------------------------------------------XXXX----------Q-----S-------<>-------------------------------X---------------SS--<>----------------------------<>------------------XX--------------E------SSS-------------S--------XXX-------------E--[]-------------------------S------------S---Q-QQ?SSSQS----------<>-----------<>---------XXXX-XXX------Q-Q-------XXXX---XXX--SSS----EX---ES-------------------------------E------<>---SSS---------------------------------------------<>--[]------------<>-------ES-S--------------S----------<>--E----------------------------XXQ-QQ-Q--Q-----<>--------<>-------<>---SSSS---E----E--S---QQ------------E--<>--<>---E--SSS-----------SQ---SSS--------------<>---------------SQQ-----------------------E-------------------------X---E-------------------------------S?S----------------------SSS----EXX------SSSSSSS----S--SS-SS----XX-XX------o-o------------XXXXXX-------------------------------------------------------------XX------SSSS----------------------------E----<>--------------XXXX--<>------------------------------------------------ES--------------E--S-----------
--------[]-------------------XX----------XXXXXXX--------X-XXXX------------------------E-------------E------<>--------------------XXX----------<>-----------E---XXXXX------------E------[]--<>------X----------XXX--XX--E-------X----------------XXXXXXX--------------------------------X---------------E<>[]-------------------------------------------------------------------------XXX--XX-----------X--------------------------------E---------X----E-------------------EXXXXXX--S----EEX--------------[]---------E----------------XXX--SSS----S------------[]----------------------------[]------------------------------XXX[>-------------E-----E----------XXXX-------E----<>--[]--------------------------------------S-----------------------[]-----------[]---------XXXX-XXX--------------------------------X-XXX----------------X-----------------E<>------[]---------------------------------------------------[]--[]------E-----[]------<>----------------------E-----[]-<>---------------------------XXX--------------[]--E-----[]-------[]---------<>---<>-------------------<>--[]--[]-------------------------------X----------[]----E---------------------------------------------XXX?-------------X------------------------------------------------------------------<>XXX--------------E-----------XXXX-XXX-----E-E----------------------------------------------------------------------------------------------------------------------<>----[]-------------XXXXX--[]-------E---------------X---------------------XX<>S-------------<>--------------
--------[]------<>-----------XXX--------XXXXXXXXX-------XXXXXX------------X---X------<>------------<>------[]-------------------XXXX----------[]----------<>--XXXXXX-------------------[]--[]------X---------XXXX--XXX-----E---X---------------XXXXXXXX--------X-----------------------X--------------<>[][]----------------------------------XX------------------------E-----------XXXX--XXX----------XXXX----------------------------<>------------------E--------------<>XXXXXX--------XX--------------[]--------<>-------------XXXXXX--SSS-----------------[]----------------------------[]------------X--------------------[]------------<>----<>---------XXXXX------<>----[]--[]--------------------------------------S-----------------------[]-----------[]--------XXXXX-XXX-------------------------------XXXXXX---------------------------------<>[]------[]---------------------------------------------------[]--[]-----<>-----[]------[]------X--------------<>-----[]-[]-----------------X--------XXXX--------------[]-<>-----[]-------[]---------[]---[]-------------------[]--[]--[]-------------------------------X----------[]----------------------------------------X--------------------------X------------------------------------------------------------------[]XXXX------------------------XXXXX--XX---------------------------o--------------------------------------------------------------------------------------------------[]----[]------------XXXXXX--[]------<>---------------X---------------------XX[]S-------------[]--------------
-E--E---[]------[]------EEE--XX-------------XXXXX---E--XXXXXXX------------E-E-X----E-[]------------[]--E---[]------------------XXXXX----------[]-----E----[]-XXXXXXX-------------------[]--[]------X--------XXXXX--XXXX----Q---X--------------XXXXXXXXX-----EE-X--------E--------------X--------------[][][]-------E--------------------------XX----------------------------E------XXXXX--XXXX---------SXXXXX--------------------------[]---------------------------------[]XXXXXX---SSSSXXX------E-------[]-E------[]-S-------------------SSS-EE--------E-EE--[]-----E-EE---------EE-E------[]------EE-E-XX--------------------[]-E-EE--E----[]----[]--------XXXXX-------[]----[]--[]-------E-----E----EE-E-EE----------E--S-----------------E-----[]----EE-E---[]-------XXXXXX-XXX--------o---------------------XXXXXXX---------------------------EE--E-[][]---E--[]-------------------------------------EEE----EE-E---[]--[]-----[]-----[]------[]------X--------------[]-----[]-[]-----E-EE----E---X-------XXXXX----------E---[]-[]--E--[]-------[]-E-----E-[]---[]-------------------[]--[]--[]-----E---------E-E-------------X----EE-E--[]----------E-----------------------E-EE--X--------------------------X------------------------------XX-E-------------------EE----XE-----XXXXXX------------------E----XXXXXX--XXX---------X------ooo-------XXX---------------------------------E-EE--------------------------------------------------------E--[]----[]-----------XXXXXXS--[]------[]---------------X----E--E-----E--EE-----[]SS------------[]--------------
XXXXXXXXXXXXXXXXXXXXXXXXXXXXXXX---XXXXX-XXXXXXXXXXXXXXXXXXXXX------XXXXXXXXXXXXXXXXXXXXXXXXXXXXXXXXXXXXXXXXXXXXXXXXXXX---XXXXXXXXXXXXXXXXXXXXXXXXXXXXXXXXXXXXXXXXXX-XXXXX--XXXXXXXXXXXXXXXXXXXXXXXXXXXXXXXXXXXXXX--XXXXXXXXXXX-X-XXXX-----XXXXXXXXXXXXXXXXXXXXXXXXXXXXXXXXXXXXXXXXXXXXXXXXXXXXXXXXXXXXXXXXXX---XXXXXXXXXXXXXXXXXXXX----XXXXXXXXXXXXXXXXXXXXXXXXXXXXXXXXXXX-XXXXXXXXXXXXX--XoXXXXXXX----X----------------------------XX-XXXXXXXXX----XXXXXXXXX---XXXXXXXXXXXXXXXXXX------XXXXXXXXXXXXXXXXXXXXXXXXXXXXXX-XXXXX---------------SSS--XXXXXXXXXXXXXXXXXXXXXXXXXXXXXXXXXXXXXXXXXXXXXXXXXXXXXXXXXXXXXXXXX--------XXX---XXXXXXXXXXXXXXXXXXXXXXXXXXXXXXXXXXXX--XXXXXXXXXXXXXXXXXXXXXXXXXXXXXXXXXXXXXXXXXXX-XXXXXXXXXXXXXXXXXXXXXXXXXXXXXXXXXXXXXXX-XXXXXXXXXXX---XXXXXXXXX-XXXXXXXXXXXXX------------------XXXXXXXXXXXXXXXXXXXXXXX-X-XXXXXXXXXXXXXXXXXXXXXXXXXXXXXXXXXXXXXXXXXXXXXXXXXXXXX---XXX---XXXXXXXXXXXXXXXXXXX--XXXXXXXXXXXXXXXXXXXXXXXXXXXXXXXXXXXXXXXXXXXXXXXXXXXXXXXXXXXXXXXXXXXXXXXXXXXXXXXXXXXXXXXXXXXXXXXXXXXXXXXXXXXXXXXXXX-XXXXXXXXXXXXXXXXXXXXXXXXXXXXXXXX---XXXXXXXXXX-XXXXXXXXXXXXXXXXXXXXXXXXXXXXXXXXXX---XXXXXXXXXXXXXXXXXXXXXXXXXXXXXXXXXXXX---X---XXXXXXXXXXXXXXXXXX------XXXX-XXXXXXXXXX-XXXXXXXXXXXXXXXXX---XXXXXXXXXXXXXXXXXXXXXXXXXXXXXXXXXXXXXXXXXXXXXXXXXXXXXXXXXXXXXXXXXXXXXXXXXXXXXXXXXXXXXXXXXXXXXX------XXX-------------------XXXXX-XXXX--XXXXXXXXXXXXXXXX----------------XX-----XXXXXXXXXXXXXXXXXXXXXXXXXXXXXXXXXXXXXXXXXXXXXXXXXXXXXXXXXXXXXX--XX--XXXXXXXXXXXXXXXXXXXXXXXXXXXXXXXXXXXXXXXXXXXXXXXXXXXXXXXXXXXXXXXXXXXXXXXXX----