-------------------------------------X---X--E--------X------------------------------------------------------------------------------------------------------------------------------------------------------------------------------------------------------------------------------------------------------------------------------------------------------------------------------------------------------------------------------------------------------------------------------------------------------------------------------------------------------------------------------------------------------------------------------------------------------------------------------------------------------------------------------------------------------------------------------------------------------------------------------------------------------------------------------------------------------------------------------------------------------------------------------------------------------------------------------------------------------------------------------------------------------------------------------------------------------------------------------------------------------------------------------------------------------------------------------------------------------------------------------------------------------------------------------------------------------------------------------------------------------------------------------------------------------------------------------------------------------------------
--------------------------------------------Q---------------------------------------------------------------------------------------------------------------------------------------------------------------------------------------------------------------------------------------------------------------------------------------------------------------------------------------------------------------------------------------------------------------------------------------------------------------------------------------------------------------------------------------------------------------------------------------------------------------------------------------------------------------------------------------------------------------------------------------------------------------------------------------------------------------------------------------------------------------------------------------------------------------------------------------------------------------------------------------------------------------------------------------------------------------------------------------------------------------------------------------------------------------------------------------------------------------------------------------------------------------------------------------------------------------------------------------------------------------------------------------------------------------------------------------------------------------------------------------------------------------------------
--------------------------------------X------S----------SSSSSSSSSSSSSSSSSSSSSSSSSSSS-----------------------------------------------------------SS-------------------------------------------------------------------------------------------------------------------------------------------------------------------------------------------------------------------------------------------------------S----SSSS-------------------------------------------------------------------------------------------------------SSSSSSSSSSSSSS-SSSSSSSSSSSSS------------------------------------------------------------------------------------------------------------------------------------------------------------------------------------------------------------------------------------------------------------------------------------------------------------------------------------------------------------------------------------------------------------------------------------------------------------------------------ooo-------oo-----------------------------------------------------------------------------------------ooo---------------------------------------------------------------------------------------------------------------------------------------------------------------------------------------------------------------------------------------------------------------------------------S-----------------------------SSSSSSSSSSSSSSSSSSSSSSSSSSS--------------------------------------------------------------------------ooo-------
-----------------------------------oo-XXXX--XS------X---S---SSSSSSSSSSSSSSSS------------------------------------------------------------------SSS-------------------------------------------------------------------------------------------------------------------------------------------------------------------------------------------------------------------------------------------------------S--------SX---------------------------------------------------------------------------------------------------------------------SSSSSSS--SSS-----------------------------------------------------------------------------------------------------------------------------------------------------------------------------------------------------------------------------------------------------------------------------------------------------------------------------------------------------------------------------------------------------oo-----------------------------------------------------------------------XXXX--------X----------------------------------------------------------------------------------------XXXX-------------------------------------------------------------------------------------------------------------------------------------------------------------------------------------------------------------------------------------------------------------------------------SS------------------------------SSSS-----SSSSSSSSSSSSSSSSS--------------------------------------------------------------------------XXXX------
----Eooo-------------------------------XXE--------------S----SSSSSSSSSSSSSSS------------------------E---------------------------------------X-SSS----------------------------------------------------------------------------------------------------------------------------------------------------------------------------------------------------------------------------------------------------Eoo------??------------------------------------------------------------------------------------------------------------------------SSSSSSS-SSSS------------------------------------------------------------------------------------E-----------------------------------------------------------------------------------E---------------------------------------------------------------------------------------------------------------------------------------------------------------------------------------------------------------------------------------------------------------------------------------------------------------------------------------------------------------E----------------------------------------------------------------------------------oo---------------------------------------------------------------------------------------------------------------------------------------------------------------------------------------------------------------------------------------E-------------------------------X-SSSS--E---SSSSSSSSSSSSSSSS------------------------------------------------------------------------------------
----XXXXX-E----X-E-----o----XX--XX-------E--E-E-----oo--S--SSSSSSSSSSSSSSSSS--QS-S----------------SSSSSSSS------------------------------------S----SS?-----------S----SS-------------------------------?---------------?SSS-----------------------SSS-------------------------SSS-------------------------------------------------------SSSS-----------------------------------------SSQ-------------XXXSSS--SS??S-E-------------------------------------SS----------------------------------------------------------S-----------------------SS----S---SQQS--------SSS------------S-Q-----------------------S---------------------------SS---SS-----S--XX----SSS----Q?SSS----SSSS-------------------------------------------SS--SS---------XXX-----SSSSS--------?SSS-----------------?SQS------SSS--SSSSSSSS----S-------------------------Q-----------SSSS--------------o-----------XXX-------------QSSSQ---S--SSSSS--SSSSS-SSQ-------------------------SS------S-----?SSS-----------------S---Q-Q----------------------------X---------XX---------------------------------------------------------------------QQ----------------------------------------------SSSS------------------------------------------XX--------------SS------------SS---SS------------------SSSS-------S----------------------------------------------------Q-Q-------------------------X?-------------------------------------S----------------SS----------------------------S----S----SS--S----S-SSSSSSSSS--------------------------------oo--XXXX--------------------------------------------
---------XX------------------------E--------XXXXX---------------------------------------------------------------------------------------------S----SS-------------------------------------------------------------------------------------------------------------------------------------------------------------------------------------------------------------------------------------------------------------<>-------------------------------SSS--------------------------------------------------------------ES-----------------------SSS-----------------------------------------------------o------------------------------------------------XXXS--------------------------------------------------------------------------------XXXX----------------------------------------------------------------------------------------------------------------------------------------SSSS---------E----------------------------------------------------SS---------------------------------------------------------------oo-------------XSSS-----------------------------------E--E-----------XXXXXX--------------------------------------Qooo-----------------S-------------------oooo----------------------XX------------------------------------------------------------------------------------------------------------------------------------------------XXX---------------------ooo------------------------------SS---------------------------------S---SSS----------------S-------------------------------XXX-------------------------XXXX----------------------
---------------------------------XXXX--------------------------------------------------------------------------------------------------------------SS----------E--------------------------------------------------------------------------------------------------------E---------------------------------------X-X-----------------------------------------------------------------------------------------------[]------------------------------------------------------------------------XX--o--------------S-----------------------------SS------------------------------------------------------E------------------------------------------------XXX--------------------------------------------------------------------------------EXXXX----------------------------------------------------------------------------------------------------------------------------------------------------XX----------------------------------------------------SS-------------------------------------------------------------------XX--------XXX------------------------------------XXXXXXX----------------XXX-------------------------------------------------------S---------------------------------------------XX-----------------------------S-----------------------------------------------------------------------------------------------------------------XXX-------------------------------------------------------SS-------------------------------SSS---SSS-S--------------S-------------------------------------------------------------------------------------
------------XXXX--------------------------XXX-------XXX---------------------------------------------------------------------------------------ooo--SS---------<>---E-----------------------S-----------------------E--------------------------------------------E------<>--------------X-----------------------SX-X----SSS---------E----SSS---------------------------E------------------------------------XX-----[]-E--------------X---oo-------XXS------------SSQSQS----------------------X-----------E--EE---------------------------oooooSS--E-----------------------------------------------E--<>---------------------E---SSSS-----------------XXXX-X----------S---------------------SSSSSSSSSSSSS---------------------E-----------XXXXXX------------------------E--o------------------------------------------------------------------SS--Q-----------------------XX---------------------------------------EE-----------------------------------X-SS-----------------------------------------------------E----------------------XXXS-------------------------------------------------------------------------------------------S-------------------------------------------E--------------------------XXX-----------------------------S---S-----------------------------------------------------ooo-----------------------E-----------E--o----------EX-XXXX--------------------------------------S----------------SS---------------------------------So??-SS--?oooooooo----oS------------------SS-----------------------------------------------------------------
XXXXXX-------------XXXXXXX--XXXX----ooo---------------------X------S?SQS---SQS----QQ----X-------SSSSSSSSSS----------------ooo---XXX-SS--------SSS-SSS-S--E--SS[]--<>--------------------------E------QQQ----------<>-------------------------------------------<>------[]-------------ES------------S---------XX--XX-o------------<>------------Q-QQQQQ--------------<>---------------SSS---------E--S----X---SSSS[]-SS------------o---oo-o-----XXX--X---SS-------------------------------XXX----------------XX-X---SS-------E-X-X------SSSSSSSS--------SS------------------------ESS--------E--<>--[]----S-QQ------------<>------------oo--SSS----XXXXXXX---------X---E-----QQQ---Q-Q--------------------------------------XS--S?S-----XXXXXXX------------------S---<>-----E--S------SSQS-----XX--X-----SSS----------S--SSS----E--------------E-----------------------X----------------XXX------------S?S--Q------XX-X--SSSSS-------------------SS-XXX---SS----QQS--------------------X--QQ---QS---------<>--<>---------XXXX--------XXXXX------------------------------------------ooo-XXX-------------------S?S--------------------------------------------XX---------Q-------<>-----------------------XXXXXX--------X-----SS--------S--------SSS------------E---S----------SS--------------------ooo---------------------E--<>---QQQQ---<>------------<>XXXXXX----------------E---------------QQ----SS---------------SSSS---------------------E--QQQQ---SSS--SS-E?SSSSSSSSS---SS-----------------------------------XXXX--S--------------------------Q----------------
----------XXX---------------------------------------------EXXX--------------------------X-----------------------------------E---------o-----------------<>----[]--[]----------------E--------<>-------------------[]---------------------------------------X---[]------[]----------XX<>----------------------XXX--XX--------------[]---------------------------E-----[]--------------------------<>-----XXXX--SSSS---S-S--S--------------------XXXX-----------XX-------------------------EXXX----------------XX-XX----------XXXX-XX--------------E------------------------------------------<>--[]--[]--------------------[]----------------------XXXXXXXX--------XX--<>---------------------------------------------------X-----------XXXXXXXX----------------------[]----<>-----------------XXX--XX--------------------------<>-------E--X--------------------------XX-------------X---XX--------X---------------XX-X-----------------------------XXXX--SS--------------------------XX------------------[]--[]--------------------XXXXXX-SSS----------------------------------------E---------------E----------------E-------------------------------------XXX----------------[]------<>---------------XXXXXX-------XX----------------------E---------------<>---------------------------E-------------------------------<>--[]----------[]------------[]XXXXXX----------E----<>-----------X----------------------------SS--------------------------------------------------------------------XXXX?--------------------------------S--------------------------------E-
---------------------------------X----------------------o-XXXX--------------------------XX-------------------------------XXXXX------------o-------------[]----[]--[]---------------<>--------[]-------------------[]-------E-------------------------------X---[]------[]------<>-XXX[]---------------------XXXX--XX--------------[]--------------------------<>-----[]--------------------------[]-----X-----SSSS-----S----------------------XXXXX-----------XX-------------X----------XXXXX----------------XX-XXX--------XXXXX-XXX--------------------------------------------------------[]--[]--[]--------------------[]---------------------XXXXX-XXX-------XXX--[]--------------------------------------------------XX----------XXXXXXXXX--------X-------------[]----[]----------------XXXX--XXX-------------------------[]------<>--X-------------------------XXX------------XXX------X----XX------------E---X-X----------------------------XXXXX-SSS-------------------------XXX------------------[]--[]---------------XXXXXXXXXXX-----------------------------------XXXXXXXXXX--------------<>---------------<>-------------------------------------XXX----------------[]------[]---------------XXXXXX------XXX--------------------------------------[]-----------------------------------------------------------[]--[]----------[]------------[]X-XXXX---------<>----[]-----------X---------------------------SSS---------------------------------------------------------------------------E-----------------------------X-------------------------------<>-
--------------------------------------------------------XXXXXX------------------E-EE----XX---E--E-----E--E--------------XXXX-----------------EE---------[]-E--[]--[]---------E-EE--[]-E-E-E--[]----------------E--[]-----------X---------------------------XE--[]------[]------[]XX--[]--------------------XXXXX--XX--------------[]------------------EE------[]-E---[]---------------------EE---[]-E-E--XXX------ooo-SS-----------E---------XXXXXX--SS------XXX---E-----E-E-X-------E-XXXXXX------------E---XX?XXXX------XXXXXS-XXXX--------------X---E-------E-E------------------------E-[]--[]--[]-E-EE------------E--[]--------------------XXXXXX-XXX---E--XXXX--[]--------------------E------------------------EE-XXXXE--------XXXXXXXXXX-------XX-------------[]----[]-----E--EE-----XXXXX--XXXXE-EE--------------------[]------[]--X-----------E------------XXXX----XXXX-XXXXXX-----S----XXX---------------XX-X-----------------E--E-EEE-E-XXXXX-SSS---E-------E------------XXXX------------------[]--[]---E--ooo-------------XXXX----?o--------EE-E------------EE---------------------------[]--------E------[]------------------E-EE-E--EE-E-------XXX------------E---[]------[]-----------E---XXXXXX-----XXXX---EE------E-E-----------------EE-E-E-[]---------------------E-E-----------------------------------[]--[]-------E--[]------------[]X-XXXX---------[]----[]-----------X----E--------------E-------E------------------------------------------------------E----------------------------------ooo---------------S-------------------------------[]-
--------------------------------------------------------XXXXX--XXX--XXXXXXXXXXXXXXXXXXXXXXXXXXXXXXXXXXXXXXXXXXXXXXXXXXXX--------------------XXXXXXXXXXXXXXXXXXXXXXXXXXXXXXXXXXXXXXXXXXXXXXXXXXXXXXXXXXXXXXXXXXXXXXXXXXXXXXXX----X---XX-XXXXXX---XXXXXXXX----XXXXXXXXXXXXXXXXXXXXXXXX-XXX----XX-X-XXXX---XXXXXXXX--XXXXXXXXXXXXXXXXXXXXXXXXXXXXXXXXXXXXXXXXXXXXXXXXXXXXXXXXXXXXXXXXXXXXXXXXXXXXXXXXXXXXXXXXXX-----?XXXXXXX-XX---XXXXXXXXXXXXXXXXXXX---S---XXXXXXXXXXXXXXXXXXXXXXXXXXXXXXXXXXXX-X-XXXXXXXXXXXXXX--XXXXXXXXXXXXXXXX-XXXXXXXXXXXXXXXXXXXXXXXXXXXXXXXXXXXXXXXXXXXXXXXXXXXXXXXXXXXXX--XXXXXXXXXXXXXXXXXXXXXXXXXXXXXXXXXXXXX---XXXXXXXXXXXXXX-XXXXXXXXXXXXXXXXXXXXXXXXXX----XXXXXXXXXXXXXXXXXXXXXXXXX---XXXXXXXXXXXXXXXXXXXXXXXXXXXXXXXXXXXXXXXXXXXXXXXXXXXXXXXXXXXXXXXXXXXXXXXXXXXXXXXX--XXXXXXXXXXX--XXXXXXXXXXXXXXXXXXXXXXXXXXXXXXXXXXXXXXXXXXX---X-XXXXXXXXXX----------------------SXSXXXXXXXXXXXXXX---XXXXXXXXXXXXXXXXXXXXXXXXXXXXXXXXXXX--SXXXXXXXXXXXXXXXXX--XXXXXXXXXXXXXXXXXXXXXXXXXXXXXXXXXXXXXXX-XXXX---------XXXXXXXXXXXXXXXXX-XXXXXXXXXXX--XXXXXXXXXXX-----------------------XXXXX-XXXXXXXXXXXXXXXXXXXXXXX---XXXXXXXXXXXXXXXXXXXXXXXXXXXXXX--XXXXXXXXXXXXXXXXXXXXXXXXXXXXXXXXXXXX--XXXXXXXXXXXXXXXXXXXXXXXXXXXXXXXXXXXXXXXXXXXXXXXXXXXXXXXXXXXXXXXXXXXXXXXX--XXXXXXXXXXXXXXXXXXXXXXXXXXXXXXXXXXXXXXXXXXX-XXXXXXXXXXXXXXX--XXXXXXXXXXXX-XXXXXXXXXXXXXXXXXXXXXXXXXXXXXXXXXXXXXXXXXXXXXXXXXXXXXXX-XX-XXXXXXXXXXXXX---XXXXXXXXXXXXXXXXX-XXXXXXXXXXXXXXXXXXXXXXXXXXXXXXX-----------XXXXXXXXX-XX---XXX----XXXXX-XX--XX----X-X---XXXXXXXX------XXXXXXXXXX