------------------------------------------------------------------------------------------------------------------------------------------------------------------------------------------------------------------------------------------------------------------------------------------------------------------------------------------------------------------------------------------------------------------------------------------------------------------------------------------------------------------------------------------------------------------------------------------------------------------------------------------------------------------------------------------------------------------------------------------------------------------------------------------------------------------------------------------------------------------------------------------------------------------------------------------------------------------------------------------------------------------------------------------------------------------------------------------------------------------------------------------------------------------------------------------------------------------------------------------------------------------------------------------------------------------------------------------------------------------------------------------------------------------------------------------------------------------------------------------------------------------------------------------------------------------------
-----------------------------------------------------------------------------------------------------------------------------------------------------------------------------------------------------------------------------------------------------------------------------------------------------------------------------------------------------------------------------------------------------------------------------------------------------------------------------------------------------------------------------------------------------------------------------------------------------------------------------------------------------------------------------------------------------------------------------------------------------------------------------------------------------------------------------------------------------------------------------------------------------------------------------------------------------------------------------------------------------------------------------------------------------------------------------------------------------------------------------------------------------------------------------------------------------------------------------------------------------------------------S------------------------------------------------------------------------------------------------------------------------------------------------------------------------------------------------------------------------------------------------------------------------------------------------
---------------------------------------------------------------------------------------------------------------------------------------------------------------------------------------------------------------------------------------------------------------------------------------------------------------------------------------------------------------------------------------------------------------------------------------------------------------------------------------------------------------------------------------------------------------------------------------------------------------------------------------------------------------------------------------------XSS----------------------------SSSSSSSSSSSSSSSSSSSSSSSSSSSS----------------------------------------------------------------------------------------------------------------------SSS--------------------------------------------------------------------------------oo---------------------SSSSSSSSSSSSSSSSSSSSSSSSSSSS----------------------------SSSSSSSSSSS-------------------------------------------------------------------------------------------------------------------------------------------------------------------------------------------------------------------------------------------------SSSSSSSSSS-------SSSSSSSSSSS------------------------------------------------------------------------------------SSSSSSSSSSSSSSSSSSSSSSSSSSSS----------------------------------------------------------------------------------------------------------------
----------------------------------------------------------------------------------------------------------------------------------X-------------o-----o-----------------------------------------------------------------------------------------------------------------------------------------------------------------------------------------------------------------------------------------------------------------------------------------------------------------------------------------o----------------------------------------------------------------------------------------------------------o----------------------------------------------------------------------------------------oo---------------------------------------------------------------------------------------------------------------------------------------------------------------------------------------------------------------------------------------------------------------E--E-------------------------------------------------------------------ooo-SSSS-------------------------------------------------------------------------------------------------------------------------------------------------------------------------------------------------------------------------oo---------------------------------------------------------------------------------------------------------------------------------------------SSSSSSSSSSSSSSSSSSSSSSSSSSSS----------------------------------------------------------------------------------------------------------------
-------------------------------------------------------------------------------------------------------------------------E---------------------------------------------o------------------------------------------------------o-------------------E-----------------------------------------S---E------------------------------------------------------------------------------------------------------E--------------------------------------------------------------------------------------------------------------------------------------------------------------------------------------------------------------------------------------------------------------------------------------S--------------------------------------------------------------------------------------------------oooooooooo-------------------------------------------------------------X-------------------------------------------------------------------------------------------XXXXXX--------------------------------------------S------------------------S-SSS--E----------------------------------------------------------------------------------------------------------------------------------------------------------------------------------------------------------------------------------------------------------------------------------------------------------ooo--------------------------------------------------------SSSSSSSSSSSSSSSSSSSSSSSSSSSS-----------------------------------Eoo----------------------------------------------------------------Eooo------
SSSSS-------XXoo-----o-----------------------------XXX----------------------------XX-------------------SS----------S--S-SQS-------------------SSS------SSSS----------------------------XXX-----------------------------------SXSQQ----------------SXSSS------------------------------------S---SS--------S---------S--------------------------------SQS-----------E---------QSSSQ-----SSSS-----------SSQSSSS------------------------?SSS-----------------------S-S----S----------------------?SSS------SSS-XXX-------------o-S---------------XX---------------------------------Q?SSS---?--------------SSSSS--SSS------S--------Q-QQQ---E-------E-----------------Q-------------------------SS----SSS------SSS--XXXX----------------------------SS----------------------------------------o------------X------------------------SS----------------------------S?SSS---------SS??----------Q---------SS----S----------SSSSSSS----------------------SSSSS------------------------------------S---Q------------------SS-S----S-----------------SS-S-S?---SS---oo----S---SSS-----------------------------------------SSSS---------------------------------------------------E------S-------------------------Q---------------S-?-----------------------S---SSQS------------SS---SSS-SSSSS----QQQ----------------SoQ-------S------QQS---------------------------------XXX----SSQS-------------------------------------S----------SSSSSSSSSSSSSSSSSSSSSSSSSSSSSS----SS----------------------------XXX------XXXS-----------------------------------------------------XXXXX-----
---------------------------------------oo----------XX------------------------------------------------------------------------XXX----------------------------------XXXXXX---------XXX-----------------------------------------------------------------------------------------------------------SS----------------------------------------------------------------<>--------------------------------------------------------------E---------------------------E--------------------------------------------XXXSSS----------------------------XXX------------------------------------------------------------E----------------------------E------<>-------------------------------------------ES-----------------XXXXX----------------------------------------------------------------XX--------------------------------------------------------------------------------------------------E-----------E-------------------------------------------------------------------------oo------------------------------------------------------------SS------------------------S-------------------------o----------------------------------------------------------------------<>--<>------------------------------------------------------------o-----------------------------SS---SSS--------------------------------------SS---------------------------------------------------------------------------------------------------------------------------------SS------------------------------------------XXXXX---------------------------------------------------------------
---------------------------------------------------XX----------------------------------------------------------------------------------------------------------------------------------------------------------------------------------------------------------------------------E--------------S----------------------------------------E-----------------------[]------------------------------------------------------------XXXX------------------------XXXXX-----------------------------------------EXXXX----------X-----------------XXXXX------------------------------------------------------------------------------------------------[]---------------E---------------------So-----S----------------XXXXX--------------------------------------------------------------------------------------------------------------------------------------------------------------o--------------------------------------------------------------------------XXXXXXX-------------------------------------------------------------------S-----SS---------S-------------SS------------------------------------------------------------------------------------------------[]--[]-----------E--------------------------------------------------------------S---------------SS---S-------------------------------S--------SS-----------------------------------------------------------------------------------------------------S---------------------------SS-----------------------------------------XXXXXX---------------------------------------------------------------
S-S--------------------------oo------------------X-XX--------------------------------------------------S------------------------------------SSSSSS-------E----------------------------XXXXXX---------SSSSSS--------------------------------o---------E-------XXX-------------E--<>---------oooo-S----ooo----------o------------------E--<>----oo---------E----E--XX-----------------------------E------------------------------------------------------------------------------E----------XX------------XXXXXX-----------------------------XXXX-----------------------------------SS------------------SSSSSS-----------------------------------[]-----------E--<>---------------------SS----So---------------XXXXXXX--------------S------------------------o-------------------------------XX-----------------------------------------------SQSSSSSSSS---------E-----------?------Q------------------------------------------------------------------------------------------------------------So--------------E----------------------S-----SS--?oS---SS-----S-------SS--------E---------------------------E-------------------------------------------------E----E----[]--[]----------<>----------------------------------------------E----------------oo-----------?-SS---So??-----------------E--o--------E-------SS-----------------------------------------------------E--------S-------------------------------------X------E--------?------------SS------------------------------oo--------XXXXXX---------------------------------------------------------E------
-----E-----S----XXXX--SS-------------------------X-XX------------------------------------XX--X--------XS--------Q---SXXQ?-SQ------------------------------XXXX-------------------------------------------------------------------QQQ-------------X--SSSS--------------------<>--[]---------SSSSSS-----------------S?----------------<>--[]----E-----SQS------<>--XX---------Q-QQQQ--QQ--Q------<>---QQ?Q---------------------------------XXX----------------------------------<>----------XX-oo--------XXXXXXX------------XX--XX--S-------XXXX--------------------------------E------E---------------------------Q--Q------------QQQQ----------[]-S--------<>--[]---------------------------SS-----QQQQ-----XXXXXXXX--------SS------E-----------S------------------------------------------------------------------E-----E-----E---------------------------E--<>--------SSS??SSSSSSS----E----------------SS--------------------X----------------SQ?--S?S---------------------------------------SS-------------<>---------SS--<>------SS-----SSSS?SSS--SS-----S--------S----X--<>-----QQQQ--Q----------E---<>-----QQQQ--------------X-----------------E------<>---<>---SXXS-XXS------E--[]---S----------S?S-S---------------------E----<>----------XS---SSSS------------SS---SSS?-----Q--Q-------<>----------SS---E-------SSSSSSS-------------------------------------------<>-----------E---------------------------------XXSSSSSSSSSSSSSSS??SSSSSSSSSS-SS---SSS---------------------ooo---------XXXXXXX------------------------------------S--------------XXXX-SSS-----
-----------------------------------------------X-X-XX-------E------E--------------------XXX--XX-------X-----------------------------------------------------------------X------XXXXXXX----------------------------------------XX-------------------E--------------E---------[]--[]----------------------------------------E---------[]--[]-------------------[]--XX-S--------------------------[]-----------------------------------------------------------------------------[]--------EXXX----------XXXXXXXX------------XX------E-------XXXX-------------------------------<>--------------------------------------------------------------E-[]-----E-E--[]--[]------------------------------------------XXXXXXXXX----------------X-----------------------------------E-----------------------------------------<>----<>----<>------E--------E----------<>--[]--------SS--SSSSSSSSSSS<>-------E-----------------XX---------EXX------------------------------------------------------------------------------[]-------------[]------------------------------------E-------X--[]---------------------<>---[]----------------------XX----------E-----<>------[]---[]-------------E--<>--[]--------------E------------------------<>----[]--Q------XXX----------------------EE--------------------[]-------------XXXX--------------------------------------------------------[]----------<>------X--------------X----------XXXSSSSSSSSSSSSSS---SS---------------------------------E--X-----------EXXXXXXXX-----------------------------------X--------------------E-------
-------------------------------X---------------X-X-XXX-----<>-----<>-------------------XXXX--XXXX-----XX--------------------------------------------------------------XX-----------------------------------------------------XXX---------------------------------<>---------[]--[]---------------------------------------<>---------[]--[]-------------------[]--XX----------------------------[]-----------------------------------------------------------------------------[]-------XXXXX---------XXXXXXXXX--------XX--XX----------E-X-XXXX-------------------------------[]----------------------------------------------------------------[]----<><>--[]--[]------------<>--------------------------EXXXXXXXXXX-------X---------------------------X---------------<>-----------------------------------XXXX--[]----[]----[]-----<>-------<>----------[]--[]--------SS--SSSSSSSSSSS[]------<>-----------------XXX------EXXXX-----------------------E------------------------------------------------------[]-------------[]----X-S-------------------------------------X--[]---------------------[]---[]---------------------XXX----------------[]------[]---[]------------<>--[]--[]---------------------------------------[]----[]--------XXXX--------------------------------------------[]------------XXXXX--------------------------------------------------<>----[]---X------[]------X---------<>---XX--------XXXXSSSSSSSSSSSSSS---SS------------------------------------X---------EXXXXXXXXXX----------------------------------XX-----------XXX------------oo
-------------------------------X------------E--X-X-XXXX----[]-----[]--------E---------XXXXXE-XXXX-E---XX-----------------------------------------------------------EE-XX----------------------------------------------------XXXX---------------------------------[]---E-EE--[]--[]---------E-E-------------E-EE----------[]---E-EE--[]--[]-------------------[]--XX--------X-------------------[]------------------------------------------------------------------------E-E--[]------XXXXXX--------XXXXXXXXXX-------XXX--XX--------------XXXX----------EE-E-----------------[]------------------------EE-E--E-----------------E-EE------E-----[]--E-[][]--[]--[]-----EE-E-E-[]--------------------------XXXXXXXXXXX------XX---------------------------X---------------[]-----------------ooo---------------------[]----[]----[]-----[]-------[]----------[]--[]----------ooSSSSSSSSSSS[]------[]---X-E--------E--XXXX-----XXXXX--------------------------------------------E--------------E-E-E-------EE-E---[]------EE-----[]----X-X-------------------------------------X--[]----------E-E--------[]---[]-----E-E------------XXXX------------EE--[]------[]---[]------------[]--[]--[]--------E-E---E------------E-E--E-EE---[]-E--[]-------XXXXX----------------------------------------E---[]------------XXXXX---------------------------E-EE----EE-E-----------[]----[]-----E----[]------X--EE-----[]---X--------XXXXXSSSSSSSSSSSSSSoooSSE-E------E-E--------E-----E---------X---------XXXXXXXXXXX-------X-------------------------XXX----------X-----------------
XXXXXXXXXX---X-X-------XX---XXXXXXXX--XXXXXXXXXXXX-XXXXXXXXXXXXXXXXX---XXXXXXXXXXXXXXXXXXXXXXXXXXXXXXXXXXXXXXXXXXXXXX----XXXXX--XXX-XXX----XXXXXXXXXXXXXX----XXXXXXXXXXX-----XXXX-------------------XXXXXXXXXX---X-------XXXXXXXXXXXXXXXXX-----XXXXXXXXX-------XXXXXXXXXXXX-XXXXXXXXXXXXXXXXXXXXXXXXXXXXXXXXXXXXXXXXXXXXXXXXXXXXXXXXXXXXXXXXXXXXXXXXXXXXXXX--XX--XXXXXXXXXXXXXXXXXXXXXXXXXXXXXXXXXXXXXX-XXXXXXXXXXXX-----XXXXXXXXXXXXXXX---XXXXX--------------XXXXXXXXXXXXXXXXXXXXXXXXXXXXXXXXXXXXXXXXXXXXXXXXXXXXXXXXXX-XX---XXXXXXXXXX--XXXXXXXXXXXXXXXXXXXXXX----XXXXXXXXXXXXXXXXXXXXXXXXXX---XXXXXXXXXXXXXXXXXXXXXXXXXXXXXXXXXXXX---XXXXXXXXXXXXXXXXX--XX--XXXXXXXXXXXXXXXXXXXXX-XXXXXXXXXXXXXXXXXXXXXXXXXXXXXXXXXXXXXXXXXXXXXXXXXXX---XXXXXXXXX---X--XXXXXXXXXX-XXXXXXXXXXXXXXX------XXX-------------------XXXXXXXXXXXXXXXXXXXXXXXXXXXXXXXXXXXXXXXXXXXXXXXXXXXXXXXXXXXXXXXXXXXXXXXXXXXXXXXXXXXXXXXXXXXXXXXXXXXXXXXXXXXXXXXXXXXXXXXXXXXXXXXXXXXXXXXXX---XXXXXXXXXXXXXXXXX---XXXXXXXX--XXXXXXXXXXXXXXXXXXXXXXXXXXXXXXXXXXXXXXXXXXXXXXXXXXXXXXXXXXXXXXXXXXXXXXXXXXXXXX---XXXXXXXXXXXXXXXXXXXXXXXXXXXXXXXXXXXXXXXXXX----XXXXXXXXXXXX-X-XXXXXXXXXXXXXXXXXXXXXXXXXXXXXXXXXXXXXXXXXX-XX--XX--XXXXXXXXXXXXXXXXXXXXXXXXXXXXXXXXXXXXXXXXXXXXXXXXXXXXXXXXXXXXXXXXXXXXXXXXXXXXXXXXXXXXX---XXXXXXXXXXXXXXXX---XXXX--XXXXX---XXXXXXXXXXXXXXXXXXXXXXXXXXXXXXXXXXXXXXXXXXXXXXXXXXXXXXXXXXXXXXXXXXXXXXXXXXXXXXXXXXXXXXXXXXXXXXXXXXXXXXXXXXXXXXXXXXXXXXXXXXXXXXXXXXXXXXXXXXXXXXXXXXXXXXXXXXXXXXXXXXXXXXXXXXXXXXXXXXXXXXXXXXXXX-XXXXXXXXXXXXX------XXXXXXXXXXXXX----------------------