------------------------------------------------------------------------------------------------------------------------------------------------------------------------------------------------------------------------------------------------------------------------------------------------------------------------------------------------------------------------------------------------------------------------------------------------------------------------------------------------------------------------------------------------------------------------------------------------------------------------------------------------------------------------------------------------------------------------------------------------------------------------------------------------------------------------------------------------------------------------------------------------------------------------------------------------------------------------------------------------------------------------------------------------------------------------------------------------------------------------------------------------------------------------------------------------------------------------------------------------------------------------------------------------------------------------------------------------------------------------------------------------------------------------------------------------------------------------------------------------------------------------------------------------------------------------
------------------------------------------------------------------------------------------------------------------------------------------------------------------------------------------------------------------------------------------------------------------------------------------------------------------------------------------------------------------------------------------------------------------------------------------------------------------------------------------------------------------------------------------------------------------------------------------------------------------------------------------------------------------------------------------------------------------------------------------------------------------------------------------------------------------------------------------------------------------------------------------------------------------------------------------------------------------------------------------------------------------------------------------------------------------------------------------------------------------------------------------------------------------------------------------------------------------------------------------------------------------------------------------------------------------------------------------------------------------------------------------------------------------------------------------------------------------------------------------------------------------------------------------------------------------------
---------------------------------------------oo---------SSSSSSSSSSSSSSSSSSS?SSSSSSSSSSSSSSSSSSSSSSSSSSSSSSSSSSSSSSSSSSSSSSSSSSSSSSSSSS--------------------------------------------------------------SSSSSSSSSSSSSSS-----S?SSSSSS--------------------------------------------------------------------------------------------------------------------------------------------------------------------------------------------------------------------------------------------------------------------------------------------------------------------------------------------------------------------------------------------------------------------------------------------------------------------------------------------------------------------------------------------------------------------------------o----------------------------------------------------------S-----------------------------------------------------------------------------------------------------------------------------------------------------------oo------------ooo---------------------------------------------------S------------------------------------------------------------------------------------------------------------------------------------------------------------------------------------------------------------------------------------------------------------------------------------------------------------------------------------------------------------------------------------------------------------------------------------------------------------
------------------------------S---oo-------------------------------------------------SSS---------------------------------------------------------------------------------------------------------------------------------------------------------------------------------------------------------------------------------------------------------------------------------------------------------------------------------------------------------------------------------------------------------------------------------------------------------------------------------------------------------o---------o--------------------------------------------------------------------------------------------------------------------------------------------------------------------------------------------------------------------------------------------------------------------------------------o------------------------------------------------------------------------------------------------------------------------------------XXX-----------XXXX-------------------------------------------------SS------------------------------------------------------------------------------------------------------------------------------------------------------------------------------------------------------------------------------------------------------------------------------------------------------------------------------------------------------------------------------------------------------------------------------------------------------------
------------------------------------oo----------------oo-----------------------------SSS---------------------------------------------------------------------------------------------------------------------------------E------------------------------------------------------------------------------------------------------------------------------------------------------------------------------E-------------------------------------------------------------XXX------------------------------------------------------------------------------------------oo-----------------------------------------------------------------E-----------------------------------------------Eooo--------------oo---o-----------------------------------------------------------------------------------------------------XXX---------------oo------------------------------------------------------------------------------------------------------------------------------------------------------------------------------------------E------------------------------------------------------------------------SS------------------------------------------------------------------------------------------------------------------------------------------------------------ooo--------------------------oo----------------------------------------------------------------------------------------------------------oo----------------------------------------------------------------------------------------------------------------oo-----------------------------E-----
--------------------------SQ---SS---XXX------XXo--------------------ooooooo-------XXSE-----oooooooo----------------------------------S------E-------------------------------------------------------------------------SSSSS---------------------------------S--------SSQS-------------------------------SSSSSS------------------------------SSSS---SSQ--?---------------------------------------oo------S---SQS-----------E--------------------SSS---------------------------------------------SSQ-----------------SSSSS----------------------------SSS-----------------?----------------------SSS-------SSS--------------------------------------------------------------------------XXXXX-----o------------------XXX----------------------------------------------------------QQQ------------------------------------------X-----XXXX--------------------------------------------------------X-S-S---------------------------------------Q--------------------SQS------------------------?-------SSS--------------SSSS-------SSS----SSSS--------------------------------------------------------------------SS---------S--------SS-----------------------------S-?--------------------------------------------------------------------------------------o-------E----XXXX--------------------XXX-------------SSS---QQQQQQQ--------------XX------XX------------------E---------------------------XXX-------------------------------------------SSSS------------S?---------------?------------------S----------------------XXX--------------SSSS------------------E--E--
---------------------------------------------XSS------------------------------------SX--o-----------------------------------------------------------oooo------------------------------------------------------------------------------------------------------------------------------------------------------------------------------------------------------------------------------XX---------------------------------<>--------------------------------------------------------------------------------------------------------------------E---------------------E------------------------------------------------------------------------Qooo------------------o---------------------------------------------------------------------------------------------------------------------oooo-----------------------------------------------------------------------------E--------------------------------------------------------------------------------------------------------------------------------------------------------------XXX-----------------------o-----------------------------------------SS-----------------------------------------------------------------------------------------------------------------------------o-------------------<>-----------XX--------------XX------------------------------------------------------------X--------------XX-------------------------------------------------------------------------------------------------------------------------------------XXXX----------------------------------------------XXXX
-------------------------------------------XXXX---------------------SSSSSS?---------S--XXX---SSSSSSS--------------------------------------------------------------------------------------E-------------------------------------X----------------------------------------------------------------------------------------------------------------------------------------------------oo----------------------------------[]--------------------------------------------------------------------S----------------------------------------------<>--------------------<>--------------------------------------------------------------------------------------------------------------------------------------------------------------------------------E-----------------------------------------------------------------------------------------------------------------XXXXXXXXX--XQ----------XXS-----------------------------------------------------------------------------------------------------------------------------------------------------------------------------------------------------------------------------------------------------------------------------------------X-------------------------------------E-------------------------------[]----------oo-----------------------------------------------------------------------------------XX------------------o---------------------------------------------------------------------------------------XX-------------------------------------------------------XXXXX----------------------------
------------E---------------S-------------XXXXS--Q------------------SSSSS-----------SE------S-SSSSSS------------------------oooooo---------------E-----------------------------------------E-----E------------ooo----------------------------------------------E---------------------------------o------------------------------oo------------E-------------------------------?--------------------------------------------------------------------------------X-X------------------------oo----E-----------------------SS----------S------E--[]----S---------------[]----------------------------------------E---------------------E-------E------------------ooo------------------------------XX-------------------E-------------------------------<>------------o--------------------E-------E--------------X-------------------------------------------E------E---------------------------XXX--------------------------------------------------------------------------E-------------S-SQ----------------------X--------------------------------------S------------------------------------------E-------------------------E-----SSSSS--------------SS---S----------------------------XX---------------------E------S-------<>-------E-----------------------[]----------------------------XXXXXX---------------------------------------------------------------------------E-------------------------------------------SQSSSS---------E-----SSSSS------------------------XX----------------------------------------------------------------------------------------
-----------<>-------E----E----------------XXXXX-------------------------------------SSS-----------------------E-----S---------------------SS----<>-------------------------------------E--<>----<>------------------------------------------------E------E----<>---QQ?SSS----E--------------------o---------S-----------------E---------E----<>----E-Q--Q-------------Q-Q-----??SSSSSS---------X----XX------S?S--------S---------------------------S----------XX--------------------------------SS--------S---------SSS----------------E--<>--[]-------E---------E--[]-----------------------<>-----------XX-<>---E-----E---------E<>------<>-----------------o------------XXXXX------X---XX----S-------------------<>---------------------S---------[]--------<>-----------XX-SSSS----<>------<>-------------EX----------------XXXXXXXX----------Q-------<>-----<>--------------------------XXXX--E-QQQQ------------------------------QQQQQQ-Q-----------------SSS-------<>---------E----------------------------XX---------------XX------------------------E-----------XS---------------E---------<>---------SS-------SS----<>--------------------------------oo-Q-----------XXX--------XX---SSSS----S----E---<>---------E----[]------<>-E--------XXXXX--------XXX-XXXXXXXX--------XXXXXXX--------------------Q--QQ?-SQQQQ------------XX-----XXX--XXXX-----------------------<>----S-----XXX-X-----XXXX----------------------------E----<>------------Q---------------------XX-----?QQQ--Q-Q--QQ-QQ-------------------------XXXX----------------------XXX---XXX-------
-----------[]------<>-------------------XXXXXXXSSSS---S---E---------------------X-X------------------------XXXXX--------------------------------[]------------E-----------------------<>--[]----[]-----------------------------------------E-----<>-----<>----[]------E-----<>----------------------E--E---E-----------------<>--------<>----[]---------------------------------SSSSS-----S---SS-------------------E------E--------------------E------E------XXX----------------------------------------------------------------------<>--[]--[]------<>--------<>--[]-----------------------[]----------XXX-[]--<>----<>--------<>[]------[]-----E---------------------XXXX-----------------XXX---E-E--------E-----[]------------------------E------[]--------[]----------------------[]------[]----------XX<>X------------------------------------------[]--E--[]-------------------------XXXXX-------------------------------------------------------------------------[]--E-----<>---------------------------XXX----------------------------------------<>----------XX---------------<>---------[]------------------E-----[]--XX---------------E--------------------------XXXX------XXXX-----SS--------<>---[]--------<>----[]------[]<>----<>-----------------------------------------------------------------------------------------------------------------------------[]----------XX---------------------------------------<>----[]--------------------------------XXXXX--------------------------------------------XX--XX--------X----------------------------
-----------[]------[]------------------XXXXXXXX----------<>---------------------X-X---------X---------------------------------------------------[]-----------<>-----------------------[]--[]----[]-----------------------------------------------[]-----[]----[]------------[]-------------X-------------------E---E---------[]--------[]----[]---------------------------------SSSSS----------S------------------<>-----<>--------------------------<>-----XXXX----------------------------------------------------------------------[]--[]--[]------[]--------[]--[]-----------------------[]---------XXXX-[]--[]----[]--------[][]------[]----<>-----------------------------------------------<><>-------<>-----[]---------------------------<>--[]--------[]----------------------[]------[]---------XXX[]X--------------------------o---------------[]-<>--[]------------------------XXXXXX-------------------------------------------------------------------------[]-<>-----[]-----------------X-X------XXXX----------------------------------------[]---------XXX---------------[]---------[]------------------------[]--XX--------------<>----------------------<>-XXXX------XXXXX-----[]--------[]---[]--------[]----[]------[][]----[]-------------------------------------------o---------------------------------------------------------------------------------[]----------XXX-------------XXXX---XXXXX-------XX----[]----[]--------------------------------XXXX---------------------------------------------EX--XX-------XX----------------------------
-------E---[]------[]------X-----------XXXXXXXX--SSSS----[]-----------------EE--X-X--------------------------------EE-E------------E-EE-----E--E[]---------E-[]-----------------EE-E--[]--[]-E--[]-E--------------------------------EE-E------E--[]-----[]-E--[]------------[]-------------X-----------------------X----EE---[]-E-E----[]----[]--------------------------------------ooo-------------------EE---E-[]-----[]--------X---EE-E----------[]----XXXXX----------------------------------------------------E------------E----[]--[]--[]------[]-----E--[]--[]-----------E-EE----E-E-[]------EEXXXXX-[]--[]----[]-E--EE--[][]-E-E--[]----[]-----------------------------------------------[][]-------[]-----[]------------EEEE-----E-X--E[]--[]-----E--[]----------------------[]------[]--------XXXX[]X-------------ooo---------XXX------EE------[]-[]--[]--------------------EE-XXXXXX-------E-----------------------------E-EE-------E------------E-E-------E--[]-[]--E--[]-----E-----E-E---X-X-----XXXXX------------------------------E-E----E--[]--------XXXX-----E-EE-EE---[]------E--[]--E-EE-----------EE-E---[]--XX---E----------[]----------------------[]XXXXX-----XXXXXX--E--[]--------[]---[]--------[]----[]--E---[][]--E-[]----------------------------X-SXXX--------XXX-------------------------------------E-EE------------------------------------E--[]---EE-E---XXX----ooo-----X-------------------------[]----[]---------------------------E-----XXX--------------------E-E--------------------------X-------XXX----------------------------
XXXXXXXXXXXXXXXXXXXXXXXXXXXXXXX----XXXXXXXXXXXXX----XXXXXXXXX-XXX-----XXXXX-XXXXXXXXXXXX-XXXXXXXXXXX---XXX-----XXXXXXXXXXXXXXXXXXXXXXXXXXXXXXXXXXXXXXXXXXXXXXXXXXXXXX---X-X-XXXXXXXXXXXXXXXXXXXXXXXXXXXXXXXXX-----XXXXXXXXXXX-XXXXXXXXXXXXXXXXXXXXXXXXXXXXXXXXXXXXXXXXXXXXXXXXXXXXXXXXXXXX-XXXXXXXXXXXXXXXXXXXXX---XXXXXXXXXXXXXXXXXXXXXXXXXXXXXXXXXXXXXXXXXXXXXXXXXXXXXXX--XXXXXXXXXXXX------XX---XXX--XXXXXXXXXXXXXXXXXXXXXXXXXXXXXXXXXXXXXXXXXXXXXXXXXXXXXXXXXXX-XXXXXXXXXXXX------------XXXXXXXXXXX-XXXXXXXXXXXXXXXXXXXXXXXXXXXXXXXXX-XXX-XXXXXX--XXXXXXXXX-XXXXXXX---XXXXXXXXXXXXXXXXXXXXXXXXXXXXXXXXXXXXXX-XXXXXXXXXXXXXXXXXXXXXXXXXXXXXXXXXXXXXXXXXXXXXXXXXXX-X-----------X-X------------XXXXXXXXXXXXXXXXXXXXXXX-XXXXXXXXXXXXXXXXXXXXXXXXXXXXXXXXXXXXXXXXXXXXX---------XXXXXXXXXXXXXXXXXXXX-XXXXXXXXX-XXXXXXXXXXXX----XXX------------XXXXXXXXXXXXXXXXXXXXXXXXXXXXXX--X-XX---XXXXXXXXXXXXX---EXXXXXXXXXXXXXXXXXXXXXXXXXXXXXXXXXXXXXXXXXXXXXXXXXXXXXXXXXXXXXXXXXXXXXXXXXXXXXXXXXXXXXXXXXXXXXXXXXXXXXSXXXXXXXXXXXXXXXXXXXXXXX--------XXXXX--XXXXXXXXXXXXXXXXXXXXXXXXXXXXXXXXXXXXXXXXXXXXXXXXXXXXXXXXXXXXXXXXXXXXXXXXXXXXX-XXXXXXXXXXXXXXXXXXXXXXXXXXXXXXXXXXXXXXXXXXXXXXXXXXX-XXXXXXXXXXXXXXXXXXXXXXXXXXXXXXXXXXXXXXXXXXXXXXXXXXXXXXXXXXXXXXXXXX--------------------------------------------------------X-XXXXXXXXXXXXQ-QXXXXXXXXXXX----------------------------XXXXXXXXXXXXXXXXXXXXXXXXXXXX--XXX-----------------------XXXXXXXXXXXXXXXXXXXXXXXXX--XXXXXXX--XXXXXXXXXXXX-XXXXXXX--XXXXXXXXXXXXXXXXXXXXXXX--XXXXXXXXXXXXXXXX-XXXXXXXXXXXXXXX-------------------XXXXXX