------------------------------------------------------------------------------------------------------------------------------------------------------------------------------------------------------------------------------------------------------------------------------------------------------------------------------------------------------------------------------------------------------------------------------------------------------------------------------------------------------------------------------------------------------------------------------------------------------------------------------------------------------------------------------------------------------------------------------------------------------------------------------------------------------------------------------------------------------------------------------------------------------------------------------------------------------------------------------------------------------------------------------------------------------------------------------------------------------------------------------------------------------------------------------------------------------------------------------------------------------------------------------------------------------------------------------------------------------------------------------------------------------------------------------------------------------------------------------------------------------------------------------------------------------------------------
------------------------------------------------------------------------------------------------------------------------------------------------------------------------------------------------------------------------------------------------------------------------------------------------------------------------------------------------------------------------------------------------------------------------------------------------------------------------------------------------------------------------------------------------------------------------------------------------------------------------------------------------------------------------------------------------------------------------------------------------------------------------------------------------------------------------------------------------------------------------------------------------------------------------------------------------------------------------------------------------------------------------------------------------------------------------------------------------------------------------------------------------------------------------------------------------------------------------------------------------------------------------------------------------------------------------------------------------------------------------------------------------------------------------------------------------------------------------------------------------------------------------------------------------------------------------
---------------------------------------------------------------------------------------------------------------------------------------------------------------------------------------------------------------------------------------------------------------S------------------------S-----SSSSSS-S--------------SSSSSSSSSSSSSSSSSSSSSSSSSSSS-SSSS-----S---------------------------------------------------------------------------SSSSSSSSSSSSSSSSSSSSSSSSSS----------------------------------------------oo----------------------------------------------------------------SSSSS----------------------------------------------------------------------------------------------------------------------------------------------------------------------------------------------------------------------------------------------------------------------------------------------------------------------------------------------------------------------------------------------------------------------------------------------------------------------------------------------------------------------ooo----------------------------------------------------------------------------------------------------------------------------------------------------------------------------------------------------------------------------------------------------------------------------------------------------------------------------------------------------------------------------------------------------------------------------------------------------------
--------------------------------------------------------------------------------------------------------------------------------------------------------------------------------------------------------------------------------------------------------------SS-----Q----------------------------------------------------------------------------SSS----Q------------------------------------------------------------------------------SSSSSSSSSSSSSSSSSSSSSSSS----o-----o-------------------------------------------------------------------------------------------------------SSS----Q-------------------------------------------------------------------------------o---------------------------------------------------------------------------------------------------------------------------------------------------------------------------------------------------------------------------------------------------------------------------------------------------------------------------------------------------------------------------------------------------------------------------------XXXX---------------------------------------------------------------------------------------------------------------------------------------------------------------------------------------------------------------------------------------------------------------------------------------------------------------------------------------------------------------------------------------------------------------------------------------------------------
--------------------------------------------------------------------------------------------------------------------------------------------------------------------------------------------------------------------------------XXX---------------------------SS-----------------------------------------------XX---------------------------------SS--E-----------------------------------------------------------------------------X----SSSSSSSSSSSSSSSSSSSSSSS---------------------------o-------Eooo---------------------------------------------------------------------------SSS--E------------------------------------------------XX--------------------------X----------E--------------------E-------------------------------------------------------------------------------------------------------------------------------------------------------------------E----------------------------------------------------------------------------------------------------------------------------------------------------------------------------------------------------------------------------------------------------------------------E--------------------------------------------------------------------------------------------------------E---------------------------------------------------------------------------------------------------------------------------------------------------------------------------------------------------------------------------------------------------------------------------------------------------------------
---------------------XXX--------------------------------SSSS?-S??----------------------------------------------------------------------------S-----------------------------------------------------------------------XXX-------------SSS----SQSQS-----------------SS??---------------------SSQQ------------------------------------Q--------------S---SS---------S---SSS---S----------------------------------------------------------SSSSSSSSSSSSSSSSSSSSSSSSSS--SSS------SSS-------------o-------XXXXX------XXX-----------------?SSS--------------------------------------------SS---SS---SSQ--S---S-----S--S---SS??------------------S------------------------------SSS-----S---SQSQ------------S?S-----SSSSSSSSS---------SSS---QQQ---------------------------------SQQQ--?SSS--------------------SSSSS--------------------------------QQ----ES-----SSS--------------SS----------------------SSSSSSS------SSSS------------------------------------------------------------S---SSSS--S-----------------------------------SSS-----------------------------SSS--SSSSSS------------------XXo-----oo---------------------------SSSS-------------SQS--SQS--------------SQS----SSS--X-------SSS-------------------------------------------------------------SS----SSSS----o-------------------------QSQ--?--------------------------------------------------oo-------------SSQQS-?SSS-----------SSSS--------------------XX---------------------------------------S----------------------------SS-Q--------------------------------------------------------------------------
------------oooo--------------------------------------------------------E-------------------------------------------------------XS-S--------------------------------------------------------------------------------XXXXX-----------------------------------------SS------------------------------------------------------------------------------S---SS-------------SS-------------ooooo-------------------------------------------------------------------------------------------------XX------------------XXX-----------------------------------------------------------------SS---SS---S----------------------S-----------------------------------------------------------------------------------------------------------------------------------------------------------------------------------------------------------------------------------------------------------------------------------------------------------------------------------------------------------------------------------------------X----------------------------------------------------------------------------------------------------------------------------------------------------------XXXX------------------------------X-------------------------------------------------------------------------------------------------oooo---------------------------EX-----------------------------------------------------------------XSSS---------------------------------------------------------------------------------------X--------------------------------------------------------
--------------------------------------------------------------------o-----------------------------------------------------------XX---------------------------------------------------------------------------------XXXXX------------S-----------------------------SS------------------------------------------------------------------------------S----S-------------SS-------------------------------------------------------------S--------------------------------------------------------------------------XX-----------------------------------------------------------------SS---SS---S----------------------------------------E------E----o---------------------S--------------------------------------------------------------------------------------------------------------------------------------------------------------------X---------------------------------------------------------X-----------------------------------------------------------------------------------------------------------XX------------------------E--------------------------------------------------------------------------------------------------------------------------------EXXXX-----------------------X------XX------------------------------E------------------------------------------------------------------------------------------------------------------------------------------------------------------XXX----------------------------------------------------------------------------------------XX--------------------------------------------------------
----------E-------------------E-----------------------------------E-EE------------------------------------------o--------------XXX-------------------------E------------------------oooo----E---------------------XXXXXX------------X------------------------oooooSS-------------S--------------E-----------------------------S---------------S-?-So?--SS----S----??-SS--E-----------------------------------E---------------E----------------------------------SSSSSS-----------------------------------------XS--------------------------------E-E---------------E------------X-SSo?-SS---So?--So-----------So?--S-----------E----<>-----?------E-----E--oo----------So?--------------------------------------------------?------------------------------------E--------------------------------------------------E------E--o-----E-------S----------------------oo-------------------------ooo---------------------------E----------------------------------------E-----E-----SS------------------------------XXX--E--S--------------E--<>-------------------------------S--------E---------------------------------E-----SSS------------------------------E-------------XXXXXX------------------------------XX-----------E-----<>-------E--<>---S------------------------------S----------------------------E-------E------------------------------XXX---------------------------------------o----o-----------XXXX----------------------------ooo----------------------------E---------------------------XXX--------------------------------------------------------
---------<>------------------<>-----E----S--------------SSSSSSSSSSSSSSSS--Q-------QQ--------------XXXX------------------------XXXX---------X-S-------E----<>--------XXX-----------E--------<>---E?QQ--------------XXXXXX---------XX---S-----SSQS--------------SSSSSSS-S-------S--------S-------<>---------------SQQ?-E-----------E-Q-----Q----SS--SSS--SS----S---SS--S-----S--------------------------------<>------E-------<>------SSSSSSSSSSSSSSSSQ--SSSSSSSS----------------XX----------------------------XXXX-----------QQQ----------X------<>----------------<>------------X-SSS--SSS--SSS--SSSSS-----S--SSS-ESS-S-------<>----[]-------SSSSSSS---<>-----------S--SSS--SS-----QQQQ--QQ-Q--Q----X--------S----------------S----SSS---------------------E----<>----E?SQS--------------------E----------o--------<>-----<>-------<>---E??SS---Q-Q--Q-QS---------------QS-------------S----------S----------SQS--------E--<>--X------------S----X--X---------------<>----<>-----------S-----E--------<>--------XXXX-<>-----E----------<>--[]------QQQQ--Q----------------XX----------------XXX---XXX------------E----<>---------------------Q--Q--Q--Q------<>-----SSS----XXX-XXX----------------XXXX-SS-------XX----------<>-----[]---E--<>--[]---S--QQQ--QQQQ-------------------SS----------Q--Q--Q---------<>------<>-----E-------------XXX------------------------S?S--------------E------------------------XXXXX---------------------------oo----------Q------------E-----<>----Q----SSS--------------XXXX-----XX--------------------------------Q---------------X
---------[]---------------E--[]---E<>-------------------SSSSSSSSSSSSSSSS-----------------------------------------------------XXXXX--------XX--------<>----[]-------XXXX----------<>--------[]-------------------XXXXXXXX--------XXXXX----------------------------------------------------------[]-----------E--------------E----<>--------------------------------------E--E--------------------------------[]-----<>-E-----[]------SSSSSS-SSSSSS---------------------------------------------------------XXXXXXX--SS--------------------Q--XX--[]----------------[]--E---------X-------------------------E-------------------[]----<>-------SSSS------[]-------E-----------------------------------X-----------------------------------------------------<>----[]----------------------------<>----------E------X-[]-----[]----E--[]-------------------------E--------------------E------E---E--XX-XX-----------------<>--[]--X--------------E--X--XX--------------[]----[]----------------<>--------[]-------XXXXX-[]----<>----------[]--[]----------------------------XXX-------E----------------------------<>----[]---------X---------------------------[]-----------XXXX-XXX------------------------------XX----------[]-----[]--<>--[]--[]-------------------------------------E-----E------------------[]------[]----<>---------XXXXXXXXXXX------------------------------------<>-----------------------XXXXXX-----------------E---------------------------E------E-----[]-------------------------EXXXX------------------------------------------------------XX
---------[]--------------<>--[]--<>[]-------------------SSSSSSSSSSSSSSSS---------------------------------------X------------XXXXXX-------XXX--------[]----[]------XXXXX----------[]--------[]-------------------XXXXXXXX--------XXXXX----------------------------------------------------------[]----------<>-------------<>----[]--------------------------------------------------------------------------[]-----[]<>-----[]------SSSSSSS-SSSSS------------------------------------------------------XXXXXXXXXX----------------------X-X--XXXX[]----------------[]-<>--<>-----X------------------------<>-------------------[]----[]-------SSSS------[]------<>-----------------------------------X-----------------------------------------------------[]----[]----------------------------[]---X---------------[]-----[]---<>--[]-------S----------------<>-------------------<>-----<>--<>---X-XX-----------------[]--[]--X-----------------X--XXX-------------[]----[]----------------[]--------[]------XXXXXX-[]----[]----------[]--[]---------------------------XXXX------<>------------------o---------[]----[]---------X---------------------------[]----------XXXXX-XXX--------XX------------E-------XX----------[]-----[]--[]--[]--[]---------------E--------------X-------------------------------[]------[]----[]--------------------------------------------------------[]----------------------XXXXXXX----------------<>--------------------------<>-----<>-----[]----------------<>------XXXXXX-------------------------------------------------------X
--EE-E---[]--------------[]--[]--[][]---E-EE-------EE-EESSSSSSSSSSSSSSSS------------------------E-EE-------EE--X-----------XXXXXXX------XXXX----E-E-[]----[]-----XXXXXX-----E----[]--------[]------------------XXXXXXXXX------XXXXXXX-------------------EE----E--------E-----E-------E---------[]----------[]-------------[]-E--[]---------------EE------------------------X--------------------------------[]-----[][]--E--[]------SSSSSSSSSSSS------------E-----------------------SS-------------XXXXXXX---XXXX--SSSS----E-------E-E-X-X--XXXX[]-E-E-EE---------[]-[]--[]------------------------------[]--EE--------E-EE---[]----[]-----------oE-E--[]------[]----------------------E-EE---------X----E--------------E--E--E---------------------------[]----[]---------------------E--E-E-[]-E-X----------XX---[]-----[]---[]--[]-------S-----E----------[]-----------------E-[]---E-[]--[]---X--X-----------------[]--[]--X-----------------XE-XXXX-----EEEE---[]----[]----------------[]--------[]-----XXXXXXX-[]----[]------X---[]--[]------------E-E-----------XXXXX------[]---------------------E-EE---[]----[]-------XXX-------E---E--E--EE-E------[]---------XXXXXX-XXX---EE---XX---o----------------XX----------[]-----[]--[]--[]--[]-------------------------E-E-XX----------------------------E--[]-E-E--[]----[]--------------------------------------------------------[]-E-E-E---------------XXXXXXXX----------EE-E--[]--------------------EE----[]---E-[]--E--[]--------EE------[]-----XXXXXXX----------------------------------E-EE------------------
XXXXXXXXXXXXXXXXXXXXXXXXXXXXXXXXXXXXXXXXXXXXXXXXXXXXXXXXXXXXXXXXXXXXXXXXXXXXXXXXXXXXXX-XXXXX-XXXXXXXXXXXXXXXXXXXXXXXXX--XXXXXXXXX----XXXXXXXXXXXXXXXXXXXXXXXXXXXXXXXXX--XXXXXXXXXXXXXXXXXXXXXXXXXXXX-XXXXXXXXXXXXXXXXXXXXXXXXXXXXXXX---XXXXXXXXXXXXXXXXXXXXXXXXXXXXXXXXXXXXXXXXXXXXXXXXXXXXXXXXXXXXXXXXXXXXXXXXXXXXXXXXXXXXXXXXXXXXXXXXXXXXXXXXXXXXXXXXXXXXXXXXXXXXXXXXXXXXXXXXXXXXXX-XXXXX-XXXXXX---X--XXXXXXXXXXXXXXXXXXXXXXXXXXXXXXXXXXXXXXXXXXXXXXXXXXXXXXXXXXXXXXXXXXXXXX----------SX---XXXX------------XXX--X---XXXXXXXXXXXXXXXXXXXXXXXXXXXXXXXXXXXXXXXXXXXXXXXXXXXXXXXX----XXXXXXXXXXXXXXXXXXXXXXXXXXXXXXXXXXXXXXXXXXXXXXXXXXXXXX-XXXXXXXXXXXXXXXXXXXXXXXXXXX--XXXXXXXXXXXXXXXXXXXXXXXXXXXXXXXXXXXXXXXXXXXXXXXXXXXXXXXXXXXXXXXXXXXXXXXXXXXXXXXXXXXXXXXXXXXXXXXXXXXXXXXXXXXXXXX-XXXXXXXXXXXXXXXXXXXXXXXXXXXXXXXXXXXXXXXXXXXXXXXXXXXXX-XXXXXXXXXXXXXX---XXXXXXXXXXXXXXXXXXXXXXXXXXXXXXXXXXXXXXXXX--XXXXXXXXXXXXXX-XX--XX--XXXXXXXXXXXXXXXXXXXXXXXXXXXXXXXXXXXXXXXXXXXXXXXXXXXXXXXXXXXXXXXXXXXXXXXXXXXXXXXXXXXX--XXXXXXXXXXXXXXXXX-XX--XXXXX--XXXXXXXXXXX----XXXXXXXXXXXXXXXXXXXXX-XXXXX------------XXXXXXXXXXXXXXXXXXXXXXXXXXXXXXXXXXXXXXXXXXXXXXXXXXXXXXXXXXXXXXXXXXXXXXoXXXXXXXXXXXXX---XXXX----XX-X-XX--XXXXXXXXXXXXXXXXXXXXXXXXXX-XX--XXXXXXXXXXXXXXXXX-----XXXXXXXXXXXXXXXXXXXXXXXXXXXXXXXXXXXXXXXXXXXXXXXXXXXXXXXXXXXXXXXXXXX-------------XXXXXX----XX---XXXXXXXXXXXXXXXXXXXXXXXXXXXXXXXXX---XXXXXXXXXXXXXXXXXXXXXXXXXXXXXXXXXXXXXXXXXXXXXXXXXXXXXXXXXXXXXXXXXXXXXXXXXXXX-XXXXXXXXXXXXXXXXXXXXXXXXXXX------------XXXXXXX-----XXXX-XXXXXXXXXXXXXX-X-X-XXXXXXXX