------------------------------------------------------------------------------------------------------------------------------------------------------------------------------------------------------------------------------------------------------------------------------------------------------------------------------------------------------------------------------------------------------------------------------------------------------------------------------------------------------------------------------------------------------------------------------------------------------------------------------------------------------------------------------------------------------------------------------------------------------------------------------------------------------------------------------------------------------------------------------------------------------------------------------------------------------------------------------------------------------------------------------------------------------------------------------------------------------------------------------------------------------------------------------------------------------------------------------------------------------------------------------------------------------------------------------------------------------------------------------------------------------------------------------------------------------------------------------------------------------------------------------------------------------------------------
------------------------------------------------------------------------------------------------------------------------------------------------------------------------------------------------------------------------------------------------------------------------------------------------------------------------------------------------------------------------------------------------------------------------------------------------------------------------------------------------------------------------------------------------------------------------------------------------------------------------------------------------------------------------------------------------------------------------------------------------------------------------------------------------------------------------------------------------------------------------------------------------------------------------------------------------------------------------------------------------------------------------------------------------------------------------------------------------------------------------------------------------------------------------------------------------------------------------------------------------------------------------------------------------------------------------------------------------------------------------------------------------------------------------------------------------------------------------------------------------------------------------------------------------------------------------
--------------------------------------------------------------------------------------------------------------------oo---------------------------------------------------------------------------------------------------------------------------------------------------------oo---------------------------------------------------------------------------------------------------------------------------------------------------------------------------------------SSSSSSSSSSSS--------SSSS------S-------------SSSS-----o------------------------------------------------------------------------------------------------------------------------------------------------------------------------------------ooo---------------------------------------------------------------SSSSSSS-------------------------------------------------------------------------------------------------------------------------------------------------------------------------------------------------------------------------------------------------------------------------------------------------------------------------------------------------------------------------------------------------------------------------------------------------------------------------------------SSSSSSSSSSSSSSSSSSSSSSSSSS----------S---------------------------------------------------------------------------------------------------------------------------------------------------------------------------------------------------------------------------------------------------
------------------------------------------------------------------------------------------------------------------------EE-------------------------------------------------------------------------------------------------?-----------------------------o--------------------XXXX-----------------------------------------------------------------------------------------------------------------------------------------------------------------------------------------------------------SSSS----Q---------------ooS----XXX-----------------------------------------------------------------------------------o-----------------------------------------------------------------------------------------------XXXX----------------------------------------------------------------SSSS-----------------------------------------------------------------------------------------------------------------------------------------------------------------------------------------------------------------------------------------------------------------------------------------------------------------------------------------------------------------------------------------------------------------------------------------------------------------------------------------SSSS----SSSSSS----------------------------------------------oo-----------------------------------------------------------------------------------------------------------------------------------------------------------------------------------------------------------------------
-----------------------------------------oo--oo------------------------------------------------------------------------XXXXXXX-------------------------------------------------------------------------------------oo--o--------------------------------------------------------------------------------------------------------------------------------------------------------------------------------------------------------------------------------------------------------------XXX----SSS--EE-------------------S--------------------------------------------------------------------------------------------oo----------------------------------------------------------------------------------------------------oo----------------------------------------oo-oo--o----------SSSS--E-----------------------------------------------------------------------------------oo-----------------------------------------------------------------------------------------------------------------------------------------------------------------------------------------------------------------------------------------------------------------------------------------------------------------------------E----------------------------------------oo-o----------o-------------SSS-----SSSSS-----------X-----------------------------------------------------oo----------------------------------------------------------------------------------------------ooooooo--oo-------------------------------------------------------------------------------------------
----S-SS?---------------SSSS----------------------------------oo------------------------------------------o--------------------------------S---?-------------S--------------------SSSS--------------E-----------XXoo----o--------S--SSS--------------SSS---S----------?SSS------------------------------SSSS------E-------------------XXX-----------o---XXX---------------------------------------------S?SSS--------------------------S-S-----SSS-----------------SSQ--S---------------------SS---SS---S-o--S------SSSS-----------------------------------SS--------S----------------S--------------------S-------XXXX---------------------------------------S---------------------SSSSS--?SSSS---SS-----------------------SSSSS---------SSSSSSSS-?SSSS-----oo---------E-------------SSS---SS------SQS--------S-----------SSS---SSSSSS------------------------------------------X---------------------?--------------XX------------SQS----------------------------Q-------------------S------------------------------S--QS------------------------------------------------------------------SSSSSS----------SQS-SSQS------------------o-----------------X--------------------------------------SSSSSS--------XX----------------------------------------XXXX----------X------------SS----------S---------------SSSS?S-------------------E---------X-------oo---------------------------------------------------------------------------------------------------E--------------------------Q---------------------SSS-------SQS-------------------------------------------
-----------------------------------------------oo-------XXX----------------------------------------------------------------------oo-----------------------------------------------------------------X-XXXXX---------------XXXX--E-------------------------------------------------------------oooo---------------<>--------------oo---XXX-----------------------------------------------------------------------------------------------------------------------------------------------------SS---SS---S-----------ESSS-------------------------------------------------------------------------oo---------------------------SSS-----------------------XSS---------------------------------------------------------------------------------------------------------------X--XXX------SS---ESS------------------------------------------------------------------------------------------------------------Qooo------XXXXX--------------------------XX--------------------------------------------------------------------------------------------------------------------------------------------------------------------------------------------o------XXX--------------------------------------------------XXX--------------------------------------------------------------------------------------------------------------?----------------<>---XXX----------XXX---------------------oooo------------------------------------------------------------E----<>-------------------------------------oo---------------------------------------------ooo-----------------
----------------------------------------------------------------------------------------------------------------XXXXXXXX---------------X--------------------------------------------------------------------------------------XX---------------------------------------------------------------------------------[]------------------XXXX---------------------o---------------------------------------------------------------------------------------------------------------------------S---SS---S----S-SSSS-SS------------------------------------------------------------------------------------------------------------XX------------------------XXX-----------------------------------------------------------------------------------------o----------------------------------SS----SS----------------------------------------------------------------------------------------------------------------------XXXX-------------------------X-oX------------------------------E--------XXX----------------E----------------------------------------------------------------------------------------------------------------------------------------XX------------------E-----------E---XX---------------XXX------------------------------------------------------------------------------------------------------------S------------------[]---------------------------------o------------------------------------XX-------------------------------------[]--------------------------------------------------------------------------------------------------------
----------------------------------XXXXX-----------------------------------------------------------------------------------------------XX--o----------------E-----------X--------------------------------------------------------------------------------SS-------------------------------------------------------[]E---------E--E-E-XXXXX--------------------------E-------------------------------------------------------------------------------------------------S-------------------oS-X-SS---SS?--So??-SoS---E--SS-----------------------------------------------------------------------E-----S------Q--SSS----------XXS--Q--------------------XXXS--------------------------------------SSSSS--------------XXX---------------------------------------XXX----------------------SSS?---S------------------SSSSSS-----------S--SQ------------o-----------------------------------------------------E----------XXXX------------------E--E---EX-----------------------------E--<>--------------------------<>---------------------------------------------------------------------------------E------------------------------------------------------XX-----------------<>----------<>---S--------E-EE---XXXX---------------------------------------------------S-S------------------------------------------------E--E---------------------[]----------XXXX-----SSS----------------E-------------------------------XX-------E---------o-----E----------E--XXX----------------------------------E--------------------------------------------SSSSS-------------------
--------------------------Q-XX-------------------------------------------------------XX---------------XXXXXX-------------------------XXX-XX---------------<>----------XX---------SSQS--------X----------------XXXX--XXX-------------SSS--------E--------SS--------Q--Q-----------------X---------------S---------[]S----------------X-XXX-------------XXXXXXS----E<>-----------------------------EQQQQ------Q--Q-Q--QQ-Q---------------Q-Q--QQ--Q--QQQ?-------------SS-----E-------------SS-X--S---SS---SSS--SSS--XXX-SS---E-----E-------------------------SS--------S----X----S------S-------<>--------------------------XXXXX--------X-o------------XXXX--------------------------------S-----S--------------X-------------------------------SSSS-----------------XXX---------------SSS----SS----SSQ?--QQQ-------------------XXX------------E-------------------------------------------X------------<>---------EXXXX-------------S?SS---------XX-X-------X------SSS-----E--<>--[]-E---------------------E--[]--------SSSSS------------------------------------------------ooQ---------------SSSSS---------------SSS-------------------XXX----------XX-XX----------------[]-------E--[]-------QQQ---------XXXX------------------------------------------XXXX----XXX---SS----------SS--------------------SSSSSSSSSSSSSSSSSS--Q--Q----QQ-------XXX-----X------------------QQQ---S----E<>-----E--------XXX------------XXXX------<>--------------<>-----E---<>-------------------X----------S?S-----<>-----------X-------QQQQQQ--Q--Q-----Q-Qo------------S---------------
-------------------------------------------------------------------------E---------------o----------------------X--------------E----XX[]-XXX--------------[]---------XXX---------------------X------------------------------------------------<>----------S----------------E----------XX-----------E-------------[]S----------------X-XXX----------------------E<>[]------------E-----------------------------------------------------------------------------------------<>----------------X------------------E--E---E---<>----<>-------------------------------------E--E-------------------[]------------------------XXXXXXX-SS---EEX------------XXXXXX----------------------------------------------------------------------------XXX--------------------------------E--------E-------------E-----------------------------XXXX--------X--<>---------------X---------------------------XX-----------[]------E-XXXXX-------E----------------E--XX-XX------X-------------<>--[]--[]<>--------------------<>--[]-------------------------------------E--------------E--------------------------E--------------------------------------X--------------XXX-XX----------------[]------<>--[]-----X-------------XXXX------------------------XXXX-----XX--------------XXXX---------------------------------------SSSSSSSSSSSSSSSSSSS----------------------------------------------------E<>[]----<>-----------------------XXXX---E--[]--------------[]----<>---[]-------------------X------------------[]----------XX-------------------------------------------E------------
--------------------------------XXXX------------------------------------<>---X----------XXXXX-------------------X------------------XXX[]-XXX--------------[]--------XXXX---------------------X---------------------------X--------------------[]--------------------------<>---------XXXE---------<>-------------[]S--------------E---XXX---------------------<>[][]-----------<>-----------------------------------------------------------------------------------------[]--------<>------X-----------------------------[]----[]---------------------------<>-----------X-------------------[]-----------------------XXXXXXXX-------XX-----------EXXXXXX------------------------------------------------------------------------------X---X----------XXXXX----------E-<>-------<>------------------------------------------XXXXX---------X-[]---------------X---------------------------XXX----------[]-----<>-XXXXX---------o---------------X-XX-XX------X-------------[]--[]--[][]--------------------[]--[]------------------------------------<>------X------<>------X-----------------------E---X-<>------------------X--------X-------------XXXX-XXX---------------[]------[]--[]-----X---------E---XXXX-------------------XXXX-------------------------XXXX--------oooX----------------------------SSSSSSSSSSSSSSSSSS----------------------------------------------------<>[][]----[]-----------------------XXXX---E--[]--------------[]----[]---[]---------------E---X------------------[]---------XXX------------------------------------------<>------------
-----------------------E--EE---XX---------------------------------------[]---X----E-----------------------------X-----E-EE--------XXXX[]-XXX---EE------E--[]-------XXXXX---------------------X-------------ooo-------------------E-E-------E--[]-E------------------------[]--------XXXX--------E-[]-------------[]S--------------S---XXX------X-XXX----------[][][]-----------[]-E--------------E----------------------------E--E---------------------E-EE---------------[]--------[]--E-E-X--E--------EE----------------[]--E-[]----E---------------E--E-E-[]------------------E---------E--[]------------------------XXXXXXX---SSSXXX-----------XXXXXXX-SSSSS----------------E-E--------EE----o-----------------------------------XX-X-E-X---------------------------[]-------[]--------------------E--------------------XXXXXX--S---X-XX-[]-----------E---X-----------------E---E-EE--XXX----------[]-----[]XXXXXX--------XX-----------------XX-XX-X---XX-----EE-E----[]--[]--[][]-E------------------[]--[]------E--------E------------EE------[]-------------[]------X---------------------------X-[]--------E-----EE--X--E-E---X------------XXXX--XXXX--------E-E---[]------[]--[]-----X-------------XXXX-------X---------------------------------------XXXX------S----XX----------------------EE-E--SSSSSSSSSSSSSSSSSS-----EE-E---o-------------------------------------E-[][][]----[]-E---------------------XXXX------[]--------------[]----[]---[]-------------------X--X------------E--[]--------XXX-------------------------------------------[]------------
XXXXXXXXXXXXXXXXXXXXXXXXXXXX----------------------------XXX-XXXXX-XXXXXXXXXXXXXXXXXX-------------------------XXXXXXXXXXXXXXXXXXXXXXXX-XX--XXXXXXXXXXXXXXXXXXXXXXXXXXXXXXX---XXXXXXXXX---XXXXXXXXXXXX-------XXX------------------XXXXXXXXXXXXXXXXXXXXXXXXXXXXXXXXXXXXXXXXXXXXXXXXXXXXXXXXXXXXXXXXXXXXXXXXXXXXXXXXXXXXXXXX--XXXXX--XXX-XXXXXXXXXXX---X------XXXXXXXXXXXXXXXXXXXXXXXXXXXXXXXXXXXXXXXXXXXXXXXXXXXXXXXXXXXXXXXXXXXXXXXXXXXXXXXXXXXXXXXXXXXXXXXXXXXXXXXXXXXXXXXXXXXXXXXXXXXXXXXXXXX-XXXXXXXXXXXXXXXXXXXXXXXXXXXXXXXXXXXXXXXXXXXXXXXXXXX-XXXXXXXXXXXXXXXXXXXXXXXXXXXXXXXXXXXXXXXXXXXXXXXXXXXXXXXXXXXXXXXXXXXXXXXXXXXXX-----XXXXXXXXXXXXXXXXXXXXX--SS---XXXXX-X-XXXXXXXXXXXXXXXXXXXXXXXXXXXX--XXXXX--------X----XXXXXXXXXXXXXXXXXXXXXXXXXXXXXXXX-----------XX-X-XXXXXXXXXXXX--XXXXXXXXXXXXXXXXXXXXXXXXXXXXXXXXXXXXXXXXXXX----XXXXXXXXXXXXXX-XXXXXXXXXXX-XXXXXXX-XXXXXXXXXXXXXXXXXXXXXXXXXXXXXXXXXXXXXXXXXXXXXXXXXXXXXXXX-XXXXXXXXXX--XXXXXXXXXXXXXXXXXXXXXXXXXXXXXXXXXXX--XXXXXXX--XXXXXXXXXXXXXXXXXXXXXXXXXXXXXXXXXXXXXXXXXXXXXXXXXXXXXXXXXXXXXXXXXXXX--XXXXXXXXXXXXXXXXXXXXXXX---XXXXXXXXXX-XXXXXXXXXXXXXXXXXXXXXXXXXXXXXXXXX----X-XXXXXXXXXX-XXXXXXXXXXXXXXXXXXXXXXXXXXXXXX-XXXXX-XX-XXXXXXX--XXXXXXXXXXXXXXXXXXXX-----------------------XXXXXXXXXXXXXX--------E-XXSXXXXXXXXXXXXXXXXXXXXXXXXXXXXXXXXXXXXXXXXXXXXXXXXXXXXXXXXXXXX--XX-X--------------XXXX-XXXXXXXXXXXXXXXXXXXXXXXXXXXX--XXX-----XXXXXXXXXXXXXXX---XXXXXXXXXXXXXXXXXXXXXXXXXXXXXXXXXXXXXX-XXXX-XXXXX--X-XXXXXXXXXXXXXXXXXXXXXXXXXXXXXX-XXXXXXXXXXXXXXXXXXXXXXXXXXXXXXX---XXXXXXXXXXXXXXXXXXX---