------------------------------------------------------------------------------------------------------------------------------------------------------------------------------------------------------------------------------------------------------------------------------------------------------------------------------------------------------------------------------------------------------------------------------------------------------------------------------------------------------------------------------------------------------------------------------------------------------------------------------------------------------------------------------------------------------------------------------------------------------------------------------------------------------------------------------------------------------------------------------------------------------------------------------------------------------------------------------------------------------------------------------------------------------------------------------------------------------------------------------------------------------------------------------------------------------------------------------------------------------------------------------------------------------------------------------------------------------------------------------------------------------------------------------------------------------------------------------------------------------------------------------------------------------------------------
------------------------------------------------------------------------------------------------------------------------------------------------------------------------------------------------------------------------------------------------------------------------------------------------------------------------------------------------------------------------------------------------------------------------------------------------------------------------------------------------------------------------------------------------------------------------------------------------------------------------------------------------------------------------------------------------------------------------------------------------------------------------------------------------------------------------------------------------------------------------------------------------------------------------------------------------------------------------------------------------------------------------------------------------------------------------------------------------------------------------------------------------------------------------------------------------------------------------------------------------------------------------------------------------------------------------------------------------------------------------------------------------------------------------------------------------------------------------------------------------------------------------------------------------------------------------
-----oo---------------------------------------------------------------------------------------------------------SSSSSSSSSSSSSSSSSSSSSSSSSSSS----SSSSS-----------------------oo---------------------------oo---------------------------------------------------------------------------------------------------------------------------------------------------------------------------------------------------------------------------------------------------------------------------------SSSSSSSSSSSSSSSSSSSSSSSSSSSS--------------------------------------------------------------------------------------------------------------------------------------------------------------------------------------------------------------------------------o---------------------------------------------------------------------------------------------------------------SSSSSSSSSSSSSSSSSSSSSSSSSSSS--------------------------------------------------------------------------------------------------------------------------------------------SSSSSSSSSSSSSSSSSSSSSSSSSSSSSSSSSSSSSSSSSSSSSSSSSSSSSSSS---------------------------------------------------------------------------------------------------------------------o--------------------------------------------------SSSSSSSSSSSSSSSSSSSSSSSSSSSS------------------------------------------------------------------------------------------------------------------------------------------------------------------------------------------------------------------------------------------------------------
----XXXX----------------------------------------------------------------------------------------------------------------------------------SS------------------------------------E--E--------------------XXXXX-------------------------------------------------------------------------------------------------------------------------------------------------------------------------------------------------------------------------------------------------------------------------------------------------------------------------------------------------------------------------------------------------------------------------------------------------------------------------------------------------------------------o------------------------------E---------------?--------------------------------------------------------------------------------------------------------------------------------------------------------------------------------------------------------------------------------------------------------------------------------------------SSSSS-----------------------------------------------------------------------------------------------------------------------------------------------E--E----------------------------------------------------------------------------------------------------------------------------------------ooo-----------------------------------------------------------------------------------------------------------------------------------------------------------------------------------------
------------------------------------------oooo---------------------------------------------------------------------------------------------S-----------------------------------XXXXXXX-------------------------------------------------------------------------------------------------------------------------------------------------------------------------------------------------E--------------------------------------------------------------------------------------------------------------------------------------------------------------------------------------------------------------------------------------------------------------------------------------------------------------------------------------------------------------------X---o--oooooo--ooo----------------------------------E-----------------------------------------------------------------------------------------------------------------------------------------------------------------------------------------------------------------------------------------------------------SSSSS--------------------------------------------------------------------------------------------------------oo------------------------------------XXXXXXX------------------------------E----------E----------------------------------------------------------------oo--oo-------------------------------------------------------E---------------------------E------------------------------------------------------------------------------------------------------------------------------
---------------------------S-------------------------------------------------------------------------------------------------ooooo----S-oooo--Q----------------------------------------------------S---------------------------SSSSS-------SSSSSS-S------------?------------------S-------SSS---------SSSSSSSS---SSS--------------------------------------------------------------------S---QS-----------------------------------------------------------SSSSS-----------------SSSS----------------------------------------------------------?-----------------SSSS-XX-----SSSS-----------------SSS--------S----------------------------SSSSS-------XXoo----ooo-----SSSS------------SSSSSS------------------------------------SSS-------------SSSSS------X------------------------------------------------------SS--SQS---------------SSSSSSQ?SSQ------SSSSSSSSSS--------------------o---------------SSS-----------------SSSS-------------------------------------------------------------SSQS-------------------------?------------SSSSSSSS--------------ooooo---------oooo---S--ooooooooo-----------oo----------SSSS------------------------------------------SSS-----SSSS-----E----XX------S--------------S---SSS--------------------------------SSSS-------E--SSQSSSSS---SSQ-----------------------S--------------------------SS------------------------------------------XXXX----oo-------------------SSS--SSSS-------------------SSSS-SSSSSS---S-----------------SQQQ---SSSS-------------------------------------S------------------------------------------------
----------------------------o---------------------------------------------------------------------------------------------------------S--------------------------------------------------oo-------------------------------------------------------------------------------------------------------------------------------------------------------------------------------------------------------------------------------------------------------------------------------------------------------------------------------------------------------------------------XX---------------------------------------------------------------------------------------------------------------------------------------------------------------------------------------------------X--oo-----o----------------------------S---------------------------------------------------------------------------------------------------------------------oooo-----------------------------------------------------------------------------------------------------------------X------------------SS------------------------------------------------------------------------------------------------<>---------------------------------------------------------E------------------<>------------------------------------------------------------------------------------------o-----------XXXX----------------XXXX-------------------------------------------------------XXX----------------------------------------------------------------------------------------------------------------
-------------------------S-----------------o---------------------------------------------------------------------------------SSSSS-SSSS-SS-S-------------------------------------------------------Q---------------------------------------------------o-----------------------------------------------------------------------------------XS-----------------------------------------------------------------------------------------------------------------------------------------------------------------------------------------------------------------------XX-----------------------------------------------E-----------------X-----------------------------------------------------------------------------------------------------------------------------------------XXX-------------------------------------------------------------------------------------------------S-------------------------------------------------------------------------------------------X------------------------------------------------------------------------SS-S----------S-----SS---S--SSSSSS-----------S------------------------------------------------------------------------[]--------------------------------------------------------<>------------------[]--------------------------------------------------------------------------------------------------------------------------------------------------o--------------------------------o-------------E------------------------------------------------------------------------------------------------------
------------------------SS--------XXXXX-------------XXX----------------------------------------------E---------------------------SoS--SoSS-S---------------ooo-SSS?------S-SQ-------S------E---------------------------------E-----------------------------------------------------oo----------------------------------------------------XXXX----------------------S---------------------------------------------------------------X----------------------S--------------------------------X-----------oo----------------------------------------------------E-E-EX-XX------SSSS----------------------E-------------------------------XX--S------------------------S------------------------------------------E--------------------------X-------E---------------------------------------------------E--oo------S---------------------------------------------------------------S-S--------------------------------------------X----E--------------------------------------------X---o-------------------E-------E--------------------------------------S----SoS-----------SooSS---So?S-SSSS---E-----------------------------------------------------E--oo----------------------[]-oo---------------------------------X-------------------[]------------------>----------------------------o-----------E-----------------------------------------------E--SSSSSSSS--Q------------------XXXXX---------------XX-------------------------------------------S-------<>------------SSSSSS---------------E---------o--------------------------XX-------------------------E--o-
Q-----------------------SSSSXX------------------------------<>------E-E-----E-----------S--------E--<>---------------E-XXX-X-----SSS--SSSS-SQQQ?S----E------Q--------------------------E--<>--------------------------------<>-S---QQQQQQQ----------SSS-----oo-o-------XXX-XXX-------------S-------XX--------S-----------XXXX------------XXX--------------------------E----------E---------QQQQ------------------------S----------XX-----------XX--X----------------------------S---------XX--------------------------------------------QQQ--QQQ----------------XXX-XX---------------------Q---------<>--------Q---S?S---------------XXX-----E----------XXXX---XXXX-EQQQQ-QQQQ--Q--QQQ-----------------------<>-----E--S---X------------XXXXXXX-SSSSS------------XXXX-------------------------------<>----------SS--S?S-------------------S-S?-QQQQ--Q--Q--Q------------------------------------------------------------------XX---<>-----<>------E------------------------------X--------QQ?QQQQ-------<>------<>----------------------------XX-------------SSS-------S---SSSSSS--SSS---S----<>--------------Q--QQQQ-------------X-X---------------<>-------------E?Q---S?S----[]--------X---------------<>----------XX--QQ--QQQ------E--[]-----E------X-------SS-SS--SSSSS-------------------------SSSSS-------------XX--X----oo----XX--------------<>------------------------XXXXX---------------------EXX-XX----------------QQQ--QQ---XXXX-SSSS--------E----[]----E??SS----------Q------------<>------------X------SS---------------[]------------------------<>----
--------------------------SS----X---------------------------[]-----<>-E----<>----X--------E-----<>--[]--------------XXX--XXX--XX--------------------<>--------------------------------<>--[]--------------------------------[]-S---------------------------X----------XXXX-XXX--------------------XXX----------------------------------XXXXX-------------------------<>------------------------------E--------------------E------XXX----------XXX--XX------------------------------------XXX------------------------------------------------------------------XXXX--XX-------------------------------[]----------------------------EXXXX-------------------------------------------------------------E-------[]----<>------X-----------XXXX----EE---------------------------------------------------[]---------------------------------E-------------------------------------------------------------------------------------XXX---[]-----[]----E<>------------E-----------------X-SS-------------------[]------[]---------------------------XXX----------------------------------------------[]---------------------------------XXXX-----E---------[]--------------------------[]------------------------[]---------XXX--------------<>--[]----<>----E-X-------------------------------------------E-----------------XXX--XX--------XXX--------------[]-------------------------------------------------XXXX-XXX--------------------------------------X--<>----[]--------------------------------[]------------X-----------------------[]------------------------[]----
-------------------------SSS----o---------------------------[]-----[][]----[]----X--------------[]--[]-------------XXXXX-XXX--X---------------------[]--------------------------------[]--[]--------------------------------[]-S----------------X---------XX---------XXXXX-XXX-------------------XXXX--X-----------X-------------------XXXXXX------------------------[]-----------------------------<>-------------------<>--E--XXXX---------XXXX--XXXX--------X------------------------XXXX-----------------------------------------------------------------XXXXX--XX---------X---------------------[]---------------------------XXXXXX------------------------------------------------------------<>-------[]----[]-----XX----------XXXXX--------Eo-oo------------------XXXXX----------<>---------[]----------------------------------------------------------------------------------------------------------------------XXXX---[]-----[]---<>[]-----------<>-----------------X----------------------[]------[]-----------------X--------XXXX----------------------------------------------[]--------S-----------------------XXXXX----<>---------[]--------------------------[]------------------------[]--------XXXX--------------[]--[]----[]--o---XX-----------------------------------------------------------XXXX--XXXX-----XXXX--------------[]------------------------------------------------XXXXX--XXX---------o--------------------------XX--[]----[]--------------------------------[]-----------EX-----------------------[]------------------------[]----
E--E--E-E----------------E-S----X---------------------------[]-----[][]----[]----------------E--[]--[]--------E---XXXXXX-XXXE------------E---E------[]--------------------------------[]--[]-------S---E-EE--------------E--[]------------------X--------XXX--------XXXXX--XXXX-------XX---E----XXXXXE-X----------XX------------------XXXXXXX--------EEEE------EE-E--[]------E-----------------E-EE-[]-----EE----E-E---E-[]----XXXXX-E-EE---XXXXX--XXXX--E----XX------E-EE-E-----------XXXXX--------------------EE---------EE-E------------E-EE-------------XXXXXX--XX----EE--XX--------EE-E--E------[]------------------------X-XXXXXXX--------------------------------------------------E----X----[]---E---[]----[]-E----X---------XXXXXX--SS-------XX--XXX---X------------------------[]---E-E---[]---------------------E-E-----------------------------------------------------------------------E-E-------E----------XXXXXXE--[]---E-[]---[][]-----------[]-----------------X---X---E--------E-EE--[]------[]-E---EE------E---X-------XXXXX------------------E-EE----EE------------------[]----EE-E---------E--------------XXXXX----[]---EE----[]--------------------E-E---[]-----------EE-----------[]-------XXXXX------------E-[]--[]----[]-E-E--X-------------E--------X--------------------------------E---XXXXX--XXXX----XXXXX----------E-E-[]-----------------------------------------------XXXXXX--XXX--------XX-------------------------XXX--[]----[]-----------------------------E--[]------------X-----EE-------------E--[]------------------E-E---[]----
XXXXXXXXXXXXXXXXXXXXXXXXXXXX----------------------------XXXXXXXXXXXXXXXXXXXXXXXXXXX-XXXXXXXXXXXXXX--XXXXXXXXXXXXXXXXXXXXXXXXXXXXXXXXXXXXXXXXXXXXXXXXXXXXXXXXXXXXXXXX---XXXXXXXXXXXXXXXXXXXXXXXXXX-XXXXXXXXXXXXXXXXXXXXXXXXXXXXXXXXXXXXXXXXXXX---XXXXXXXXXXXXXXXXXXXXXXXXX--XXXXXXXXXXXXXXXXXXXXXXXXXXXXXXXXXXXXXXXXX-XXXX-------XXXXXXXXXXXXXXXXXXXXXXXXXXXXXXXXXXXXXXXXXXXXXXXXXXXXXXXXXXXXXXXXXXXXXXXXXXXXXXXXXXXXXXXXXXXXXXXXXXXXXXXXXXXXXXXXXXXXXXXXXXXXXXXXXXXXXXXXXXXXXXXXXXXXXXXXXXXXX-XXXXXXXX-XXXXXXXX-XXXXXXXXXXXXXXXXXXXXXXXXXXXXXXXXXX--XXXXXXXXXXX-XXoXXXXXXXXXXXXXXXXXXXXXXXXXXXXXXXXXXXXXXXXX--XXXXXXXXXXXXXXXXXXXXXXX-X-XXXXXXXXXX---X-X------------XXXXXXXXXXXXXXXXXXXXXXXXXXXXXXXXXXXXXXXXXXXXXXXXXXXXXXXXXXXXXXXXXXXXXX---S---XXXXXXXXX------X----X-X---------------XXXXXXXXXXXXXXXX-XXXXXX--XXXXXXXXXXXXXXXXXXXXXXXXXXXXXXXXXXXXXXXXX--XXXXXXXXXXXX-XXXXXXXXX-----XXXXX-XXXXXXXXXXXXXXXXXXXXXXXXXXXXXXXXXXXXXXXXXXXXXXXXXXXXXXXXXXXXXXXXXXXXXXXX--XXXXXXXXX--X------XXXXXXXXXXXXXXXXXXXXXXXXXXXXXXXXXXXXXXXXXXXXXXXXXXXXXXXXXXXXX---XXXXXXXXXXXXXXXXXXXXXXXXXXXXXXXXXXXXX-XXXXXXXXXXXXXXXXXXXXXXXXXXXXXXXXXXXXXX---XXXXXXXXXXXXXXXXXXXXXXXXX---X-XXXXXXXXXXXXXXXXXXXX---XXXXXXXXXXXXXXXXXXXXXXXXXXXXXXXXXXXXXXXXXXXXX-XXXXXXXXXXXXXXX--XXX--XXXXXXXXXXXXXXXXXXXXXXXXX-----XXXX---XXXXXXXXXXXXXXXXXXXXXXXXXXXXXXXXXXXXXXXXXXXXXXXXXXXXXXXXXXXXXXXXXXX--X-X---------------XXXX--XXXXXXXXXX--XXXXXXXXXXXXXXX---XXXXXXXXX----XXXXXXXXXXXXXXXXXXXXXXXXXXXXXXXXXXXXXXXXXXXXXXXXXXXXXXXXXXXXXXX----XXXXXXXXXXXXXXXXXXXXXXXXXXXXXXXXXXXXXXXXXXXXXXXXXXXXX-XX