------------------------------------------------------------------------------------------------------------------------------------------------------------------------------------------------------------------------------------------------------------------------------------------------------------------------------------------------------------------------------------------------------------------------------------------------------------------------------------------------------------------------------------------------------------------------------------------------------------------------------------------------------------------------------------------------------------------------------------------------------------------------------------------------------------------------------------------------------------------------------------------------------------------------------------------------------------------------------------------------------------------------------------------------------------------------------------------------------------------------------------------------------------------------------------------------------------------------------------------------------------------------------------------------------------------------------------------------------------------------------------------------------------------------------------------------------------------------------------------------------------------------------------------------------------------------
------------------------------------------------------------------------------------------------------------------------------------------------------------------------------------------------------------------------------------------------------------------------------------------------------------------------------------------------------------------------------------------------------------------------------------------------------------------------------------------------------------------------------------------------------------------------------------------------------------------------------------------------------------------------------------------------------------------------------------------------------------------------------------------------------------------------------------------------------------------------------------------------------------------------------------------------------------------------------------------------------------------------------------------------------------------------------------------------------------------------------------------------------------------------------------------------------------------------------------------------------------------------------------------------------------------------------------------------------------------------------------------------------------------------------------------------------------------------------------------------------------------------------------------------------------------------
--------------------------------------------------------SSSSSSSSSSSSSSSSSSSSSSSSSSSS---------------------------------------------------------------------------------------------------------------------------------------------------------------------------------------------------------------------------------------------------------------------------------------------------------------------------------------------------------------------------------------------------------------------------------------------------------------------------------------------S---SSSS----------SSSSSSSS-----------------------------SSSSSSSSSSSSSSSSSSSSSSSSSSSS--------------------------------------------------------------------------------------------------------------------------------------------SSSSSSSSSSSSSS-------------------------------------------------------------------------------------------------------------------------------SSSSSSSSSSSSS------------------------------------------SSSSSSSSSSSSSSSSSSSSSSSSSSSS-----------------oo----------------------------------------------------------------------------------------------------X-------------------------------------------------------------------oo-----------oo---------------------------------------------------------------------ooE------SSSSSSSSSSSSSS?SSSSSSSSSSSSS----------------------------------------------------------------------------------------------------------------------------------------------------------------------------------------------------
------------------------------------------------------------------------------------------------------------------------------------------------------------------------------------------------------------------------------------------------------------------------------------------------------?---------------------------------------------------------------------------------------------------------------------------------------------------------------------------------------------------------------------------------------------------------------------------------------------------------------------------------SSSSSSSSSSSSSSSSSSS----------------------------------------------------------------------------------------------------------------------------------------------------------------------------o----------------------------------------------------------------------------------------------------------------------------------------------------o--------------------------S-------?SS--SSSSSSSSSSSS-----------------------------------------------------------------------------------------------------------------------XX-----------------------------------------------------------------XXXX--------------E--E--------------------------------------------------------------XXXX-------SSS----------------------------------------------------------------------------------------------------------------------------------------------------------------------------------------------------------------------------
----------------------------------------------------------------------------------------------------------------------------------------------------------ooooooooo----------------------------------------------------------------------------------------------------------------------------Eooo------------------------------------------------------------oo-----------------------------------------------------------------------------------------------------------------------------------------E-----------------------------------------------------------------------------------------------------------------------------SSSSSSSSSSSSSSSSSSS---------------------------------------------------------------------------------------------------------------------------------------------------------------------------------------------------------------------------------------------------------------------------------------------------------------------------------------------------------------------SS--SSSSSSSSSSSS--------?-----------------------------------------------------------------------------------------------------------------------------------------------------------------------??--------------oooo-------XXXXXXX-----------------------------------------------------oo--oo-----------ESSS----------------------------------------------------------------------------------------------------------------------------------------------------------------------------------------------------------------------------
--------------------------------------------------------------------------------------------------------------------------------------------------------------------------------------------------XX-----------QQ---SSS-----------S-S-S---------------SSS---------------------------SSSS-------XXXXX-----XX-----------SSSS-----SSS----SSSSS---------------SQ-----------------------------------------------------------------------S----------------SSSS------SS-SSS-------------------------QQQQS------SSSSSSSSSSSS----------------------SSSSS-----------S--------------------SSQQ--------ooo------------------------------SSSSSS---SSQSSSSSSSSSSSSSSSSSSS--QQ-----------------------------------------XXX------XXX--------SSSSS-----------------Q-Q----------------------XX-----------QQS-----------------------SQQQ---------------SSS----SSSSS-------XXo-----oo------Q?SSS-----?SSSSSSSSSSS---------------------QQQQ---------------------------------------------------------SSS-----S?SSS-----?SSS--SSSSSSS------------------------SSSSSSSSS---------?-------XXX------------------------------------S---SQS--------------------------------------------------SS---SS-------------------S-----------------SSSSS--------------S??-E-----------XXX-----------------------------------------------SSS-------SSS-----------o-----oo------SS-------ooooo--------------SSS-----------SSQSSSSS----S--------------------------------?--------S------------------------------------------------------Q----------------------S---E------------------SSSS----------------SSSS---
----------------------------------------------o---------------------------------------------------------------------------------------------X---------------------------------------oo-o---------XXX-----------------------------------------------------------------------------------------------------XX-------------------------SS------------------------------------------------------------------------------------------------------------------------SS----------------------------------------------------------------------------------------------------------------S----E---------------------------------------------------------------------------------o--XXX-----------------------------------XXXX-------------------------------------------------------XX------------------------------------------------------------------------------------------------------------------------------------------------------------------------------------------------------------------------------------------------------------------------------------XXXS-------------------------------------------------------------------------------------------ES----SS----------------------------------E-------------------------XXXX-----------------------------oooo-----------------------------------------E---------------------SS---E--------------------------------XX--------------------------------------------------------------S-----------------oo------------------------------------------------------------------------------------------------------
----------------------------XXXXXXXX-----------------------------------------------------------------------------------------------------------------------------------------------------------XXXXXX-------------------------E--------------------------------------------------------------------------XX-----------------------XX-------------------------------------------------------------------------------------------------------------------------<>-----------------------------------------------------------------------------------------------------------X----oS----------SSS------------------------------------------------------------------------XXX-oo------------------------------------XXX--------------------------------------------------------XX------------------------------------------------------E-----------------------------------------------------------o----------------------------------------------------------------------------------------------------------------------------------------------------------------XXXX-------------------------------------------------------------------------------------------X-S--------------------------------------X-----------------------------------------------------------------------------------------------X-------XXXX--------------------SS-------SSSSS-------------------------------------E--------------------------------------------------------------------------------------------------------------XX------------E-----------------------------------------------
---------------------------X----------------------------------------------------------------------oo----------------------oo----------------------XXXXX---------------------------E-----------XX-XXXX------------------------<>----------------------SSSSSSS-----------------------------S--------------XXX---------------------XSX----------------E---------------E-----E--S--------E---------------E-----------------E------------------------E------------[]----------------------------------------------------------------------------------------------------------XXS-------------S-SSS----------------------------------------------------------EE-------------------------------o------oo---oo--------XXXX---------------------------o---------------------E-E--X-XX-----------------------------------------------------<>SSQ-----SSSSSS--------------------------------------------------------E------------------------------------------------------------------------E------------------------------------------------ooo-----E------------------XXXXX--------SSSSSSS-------------------------------------------------o----------------SS-------XX-S----SS-------E-------------------oo--------------------------------------------------------E-----E---E-------------------------------XX-------------------------------SS------SSSSSS-------------------------------------------------------------X-----------SQ-----------------------Q------------------------E------------------------XX----SS-----------------E---------------------------SSSSSSS--
---------------S----------XX------oo--o-----------------------SSSS-----------------------------E----------------------------------------E---XX-------------XXXXXXXX--------------<>----------XXX-XXXXX-----QQ?--QQ-Q---------[]-----S?SQS------E--S-----------------------------E----------------------XXXX-----------SSS------XXX-XX-------------<>---QQ?SQS----E<>----<>-----E----<>-------E------<>-----------E----<>----------S------------<>-------E----<>-QQ----------------------------SSSS-----XX------SSSSS----------------------X-----S--------SSSS-----------XXXX-SS-SSS-----X-----------S------------------E--S-Q----S?QQS---?SSSSSSSSSSSSSSSSS---Q---QQ------------------------------------------XXXXX--------------S-----S----E-----QQQ--Q-------------------XX------------------E-------------E----S?S-------------[]------------------------XXX---XXX---Q-----Q--Q----------SS-----X-S---<>-----QQQQ--QQQQ-----------------------------------QQQ----------------SSSSSS----QQ-----------------------------------E-----SSSSSSSSSS----------------XXXXX------------------------------------QS--S?S-------E----------------------------XXX-------XXX-SS---SS------<>--S-------SS--------------------------------XXX-----------------------------<>----<>---E--------QQ--------------------XXX----XXX----o--X----XXXX---XXXX-SSSS----------------------E----------Q--Q--SSQS--S?S----Q---------------X-XX-------------------XXX-XXX---------X-------------------E----<>-------------QSQS-----XXXX----------S?S---S--E--<>-----E----S?S-----------------------
------------------E---E--XXX------------E----XXX----------E----SSS----------------------------<>---------------------------------------XXX---------------------------------------[]---------XXXX-XXXXX-----------------------[]---------------<>-------------------------------<>---------------------XXXXX-SXX---------------XXXX-XX-------------[]------------<>[]----[]----<>----[]------<>------[]----------<>----[]-----------------------[]------<>----[]--------------------E------------------XXX--XX--E-----------------------E--X----------------------------XXXXX-SX--------XX----------EE-----------------<>------------------SSSSSSSSSSSSSSSSSS-------------------------------------------------XXXXXX-------E----------------<>-------------------------X----XX-----------------<>------------<>--------------------[]---------------E----------------------------------------------XX-----[]------------------------------------------------------------XXX-?----E---------------------------------------------<>-----------------------------XXXXXXXSSS----------------------X--XX-------------------<>---------------------------XXXX------XXXX--------------[]----------SS-------------------E------------------------------o-------------[]----[]--<>-----------------------------XXXX--X------------------------------------E--------------XXXX?--------------------------------------------X-XX------------------XXXX-XXX-------EXX---E-----------E--<>----[]----------------------XXXX------------------<>--[]----<>------------------------------
-----------------<>--<>-XXXX-----------------------------<>-----SS----------------------------[]--------------------------------------XXXX-----XXXXX------------------X----------[]--------XXXXX-XXXX------------------------[]---------------[]-------------------------------[]-----------------<>-XXXXXX------------------XXXXX-XX----------X--[]------------[][]----[]----[]----[]------[]------[]----------[]----[]-----<>----------------[]------[]----[]--------------------------E-----------XXXX--XXX-----E-------X--------------XX--------------------------XXXXXX-SSS------XXX-----------------------------[]------------------SSSSSSSSSSSSSSSSSS-----------XXXXX--------------------------------XXXXXXX------------------------[]---------------------E---X----XX-----------------[]------------[]--------------------[]--------------<>---------------------------------------------XXX-----[]--------------------------------XXX--------------------------------------E------------------X----------------------[]----------------------------XXXXXXXX---------------------X---X--XXX------------------[]----------X---------------XXXXX--<>-XXXXX--------------[]----------SS----------------------------------------XXXXX-------------------[]----[]--[]----------------------------XXXXX--X------------------------------------------------------------X---------------------------------------X-XXX----------------XXXXX-XXX-------XXX--<>----------<>--[]----[]----------------------XXXX------------------[]--[]----[]------------------------------
---EE-E-EE-E---E-[]--[]XXXXX--------------------------E--[]-----------------------EE---EE-E---[]--------EE---------------------------XXXXXX----XXX----------------------E-EE-E---[]----E--XXXXXX-XXXX------EE---E--EE-E------[]--EE--------E--[]---------------------E--E-EE---[]-----------------[]XXXXXXX-----?-----------XXXXX--XX---------XX--[]------------[][]-E--[]-E--[]--E-[]--EE--[]------[]---E-EE---[]----[]-----[]---------E------[]------[]----[]-E----------------------------E------XXXXXE-XXXXE-------X---X---------E----X------------E-------------XXXXXXX-SSS-----XXXX-----------------------------[]-E--------------SSSSSSSSSSSSSSSSSSSS-----E-----------------------------------------XXXXXXXX-----S--X---------------[]-------------------------X----XX----------E-EE---[]----------E-[]---EE--------E------[]---------E----[]--------------------------------------------XXXX-----[]---------E-E-----------------X----------------E-----------------------------------------X---X------E-E-------E----XXXX---------------------------XXXXXXXX---------------------X---X--XXXX-------E---------[]----------XX----------E--XXXXXX--[]XXXXXX--E--------E--[]----------SS---------------------------------------------------------EE-----[]----[]--[]---------------------------XXXXXX--X---------o---ooo--------------------------------------------X----EE-E--------------X----------------X-XXX--E-------E----XXXXXX-XXX------XXXX--[]-----E----[]--[]-E--[]-E--------E-----------XXXX------------------[]--[]--X-[]-E-E---------E----------------
XXXXXXXXXXXXXXXXXXXXXXXXXXXXXX-XX---------X-----XXXXXXXXXXXXXXXXX--XXXXXXXX--XXXXXXXXXXXXXXXXXXXXXXXXXXXXXXXXXXXXXXXXXXXX-----XXXXXXXXXXXX------------------------------XXXXXXXXXXXXX-XXXXXXXXX--XXXX-XXXXXXXXXXXXXXXXXXXXXXXXXXXXXXXXXXXXXXXXXXXXXXXXXXXXXXXXXXXXXXXXXXXXXXXXXXXXXXXXXXXXXXXXXXXXXXXXXXXXXXX---XXXXXXXXXXXXXXXXX--XXXXXXXXXXXXXXXXXXXXXXXXXXXXXXXXXXXXXXXXXXXXXXXXXXXXXXXXXXXXXXXXXXXXXXXXXXXXXXXXXXXXXXXXXXXXXXXXXXXXXXXXXXXXXXXXXXXXXXXXXXXXXXXXXXXXXXXXX---XXXXXXXXXXXXXXXXXXXXXXXXXX-XXXXXXXXXXX--XXX-XXXXXXXXXXXXXXXXXXXXXXXXXXXXXXXXXXXXXXXXXXXXXXXX--SSXXXXXXXXXXXX-X-XXXXXXXXXX---XXXXXXXXXXXXXXXXXXXXXXXXXXXX-XXXXXXXXXXXXXXXXXXXX-XXXXXXX------------XXXXXXXXX--XXXXXXXXXX---XXXXXXXXXXXXX---XXXXXXXXXXXXXXXXXXXXXXXXXXXXXXX-XXXXXXXXXXXX--X--XXXXXXXXXXXXXXXXXXXXXXXXXXXXXXXXXXXXXXXXXXXXXXXXXXXXXXXXXXXXXXXXXXXXXXXXXXXXXXXXXXX----XX------XXXXXXXXXXXXX----XXXXXXXXXXXXXXXXXXXXXXXXXXXXXXXXXXXXXXXXXXX--XX-------------XXXXXXXXXXXXXXXXX-----XXXXXXXXXX--XXXXXXXXXXXXXXXXXXXXXXXXXXXXXXXXXXXXXXXXXXXXXXXXXXXXXXXXXXXXX----XXXXXXXXXXXXX---XXXXXXXXXXXXXXXXXXXXXXXXXXXXXXXXXXXXXXXXXXXXXXXXXXXXXXXXXXXXXXXXXX--XXXXXXXXX-XXXXXXXXXXXXXXXXXXXXXXXXXXXXXXXXXXX--XXXXXXX---XXX-X-XXXXXXXXX--XXXXXX------------------------XXXXXXXXXXXXXXXXXXXXXXXXXXXXXXXXXX--XXXXX---XXXXXXXX--XX--------XX---XXX------------XXXXXXXXXXXXXXXXX--XXXX----XXXXXXXXXXXXXXXXXXXXXXXXXXXXXXXXXXXXXXXXXXXXXX-XXXXXXXXXX--X-XXXXXXXXXEXXXXXXXXXXXXXXXXXXXXXXXXXXXXXXXXXXXXXXXXXXX---XXXXXXXXXXXXXXXXXXXXXXXXXXXXXXXXXXXXXXXXXXXX--X-XXXXXXXXXXXXXXXXXXXX-XXXXXXXXXXX