------------------------------------------------------------------------------------------------------------------------------------------------------------------------------------------------------------------------------------------------------------------------------------------------------------------------------------------------------------------------------------------------------------------------------------------------------------------------------------------------------------------------------------------------------------------------------------------------------------------------------------------------------------------------------------------------------------------------------------------------------------------------------------------------------------------------------------------------------------------------------------------------------------------------------------------------------------------------------------------------------------------------------------------------------------------------------------------------------------------------------------------------------------------------------------------------------------------------------------------------------------------------------------------------------------------------------------------------------------------------------------------------------------------------------------------------------------------------------------------------------------------------------------------------------------------------
------------------------------------------------------------------------------------------------------------------------------------------------------------------------------------------------------------------------------------------------------------------------------------------------------------------------------------------------------------------------------------------------------------------------------------------------------------------------------------------------------------------------------------------------------------------------------------------------------------------------------------------------------------------------------------------------------------------------------------------------------------------------------------------------------------------------------------------------------------------------------------------------------------------------------------------------------------------------------------------------------------------------------------------------------------------------------------------------------------------------------------------------------------------------------------------------------------------------------------------------------------------------------------------------------------------------------------------------------------------------------------------------------------------------------------------------------------------------------------------------------------------------------------------------------------------------
----------------------------------------------------------------------------------------------------------------------------------------------------------------------------------------------------SSSSSSSSSSSSSSSSSSSSSSSSSSSS------------------------------------------------------------------------------------------------------------------------------------------------oo--------------------------------------------------------------------------------------------------------------------------------------------------------------------------------------------------------------------------oo----------------------------------------------------------------------------------SSSSSSSSSSSSSSSSSSSSSSSSSS----------------------------------------------------------------------------------------------------------------------------------------------------------------------------------------------------------------------------------SSSSSSSSSSSSSSSSSS------------------------------------------------------------------------------------------------------------------------------------------------------------------------------------------------------------------------------------------SSSSSSSSSSSSSSSSSSSSSSSSSSSS------------------------------------------------------------oo----------------------------------------oo--------------------------------------------------------------------------------------------oo--------------------------------------------------------------------------------------oo----------------------
------------------------------------------------------------------------------------------------------------------------------------------------------------------------------------------------------------------------------SS-----------------------------------------------------------------------------------------------------------------------------------------------XXXX-----------------------------------------------------------------------------------------------------------------------------------------------------------------------------------------------------------------------------E--E---------------------------------------------------------------------------------------------------------------------------------------------------------------------------------------------------------------------------------------------------------------------------------------------------------------------------------------------------------------------------------------------------------------------------------------------------------------------------------------------------------------------------------------------------------------------------------------------------------------SSSSSS-----------------------------------------------------------------------XXX--------------------------------------------------------------------------------------------------------------------------------------------o--ooo---?----------------------------------------------------------------------XXXX---------------------
--------------------------------------------------------------------------------------------oo----------ooo---------------------E---------XX---------o--------------------------------------------------------------------SS--SS------------------------------------------------------------------------------------X----------------------------------------oo--oo--oo----------------------------------------------------------------------------------------------------------------------------------------------------------------------------------------------------------------------------------------XXXXXXo-------------------oo---------------------------------------------------------------------------------------------------------------------------------------------------------------------------------------------E------------------------------------------------------------------------E---------------------------------------------------------------------------------------------------------------------------------------------------------------------------------------------------------------------------------------------------------E-------------------------o---o-------o----oo-----------SSS-S----------------E--------------------------------------------------------------------------------------E-oo-------------------------------------------------------------------------X-------------------------------------------------------------------------------------------------------------------------------------------
--------------------------------SS??--------------Q-Q-------------------------------oo----------XXX-----XXX-----SSSSS-----------E--E----------------XXX-----XXX-------------------------------------S-----------oooooo---SS---SS----------S-------------------SSS---?-?SSS--------------------------------------------SQSS-----------S---SSSS-----XXX--------------------------?------------------------S---------------SSSSS-------Q-----------------SSSSQ----------------------SSSSSS-------------------------------------------------------------SSSS---SS--SSSSSS--------------------------------------------------------------------XXXX------------o-----oo----------------------------------------------------------------------------------------------------------------------------------------------SS-SSSQ----------------SSSSSS--------------------------XX-----------------SSSSSSSS--------------SSS--SSSSSSS-----------------------------S---------------------------------------------------------------------------------------------------SSSSSSSSSS------------------------------------------------------------XX---------------------------------------QS--SQS--------SS------------------oo--------ooo----------S-Q--------------SSQS-----SSSS----------------------------------------------------------------------------XXXXX------XX-----------?------------------SS-------------SSSSS----------------SSSS-----------------------------E-----XXSo--------------------------SSSS-----------S------------------------S---------------------------E
------------------SX------------------------------------------oooo--------------------------------------------XX----------------XXXXXXXX--------------------XXSS---------------------------------------------------------SS---SS------------------------------------------------------------------oo-------------oo---------------------------------------------------------------------------------------------------------------------------------------------------------------------------------------------o------o-------------------------------------------------------------------------------------------------------------------------------------------------------------------------------------------------------------------------XX----------------------o-----------------------------------------------------------------E-------------------------XXX-----------------X--------------------------------------------------------------------------------------------------------------------------------------------------------------------------------------------------------------------oooo---------------XXX---------------------------------------------------------------------------------------------------------------------------------------------------------------------------o--------------------------XXXX-----------XXX---------------------------------------------------------------------------------E-----------o---XXXXXX---------------------------------------------------------------------------------------------------X-
--------------------------------------------------------------------------------------------------------------o--------------------------------------------XXXX-------------------------------------S-----------SSSSSSS--SSS--SS----------------------------------------------------------------------------------------------------------------------------------------XXX-------------------------------------------------------------------------------------------------------------------------------------------XX------------------------------------------------------------------------------------------------------------------------------------------------------------------------------------------------------------------------XXX------------------------E----------------------------------------------------------------------------------------XXXX---------------X------------------------------------------------------------------------------------------------------------------------XX--------------------------------------------------------------------------------------------------------------XXXX--------------------------------------------------------S-----------------------------SS-------------------------------------------E---------------------------------------------------------------------------------XXX-----------------------------------X--------------------------------------------------------------------------------------------------------------------------------------------------------------------XXX-
----oo----------XSS-SQ--------------------------------------E-----------------------XXX-----------------------------------------------------X---oo-------XXXXX---------------E--------------S------------------SSSSSSSS?-SSS--ES-------------------X--------S-----------------------------------------------oo----------------------------S----------------------------------SQSQ----------------------ES------ES---------------------------------------------------------------------------S------E-------------SSSSSSS---E---------------------E-----------------------------------------E---------------XXXXX-------------------------------XXXXX-------------------------------------------------------o------------------------------------XXX--------------------E--<>------------------------------E-------------------E-------SSSSSS-----------------------XXXXX------------X------------------S-------------------------------------------------------------------E-----------------------------------XXX------------------------------------------X------------------------------E----S-------------------------------XXXX----------------XX-------------------E-----------------------------------XXXXX--------SS---------------------------------------------------------------E-------------------------------E----------------------------XXXS---------SQSQ----------E----------XX------------------------------------------------------------------------XXXXX----------------------------------------------------------E---------------------------XXXX-
-o-o--o--------XXX--X-----------------------------Q-QQQ----<>-----E---------------------------------XXX----X--------XXXXX-XXXXX----------------o--o-----XXXXXX--------------<>------E---------------SSSS----X---------S--SSS---SX--------SSSS---------------------QQQ--------------------------------------------XXX--SSS----E------QQQ---------X----XXXX---------------------------------------X----------E--<>-------ESQS--SS-----QQQ-------------------QQQ---S---------------XXX---------S--E--<>----------------------<>--------S-----------<>--Q?--Q?QQQQ--Q--Q--Q--Q----------------<>------E-------XX----------------------------XXX----------------XXXX----X-------------X--------------QQQQ-----------------------------------------<>-XXX------QQQ----------<>--[]----------------------E------<>-----XS--S?S------<>-----------------------------------XXXXXXoo---------XXX-XXX-----------o-o-------XXX-X----SS-----XQ---------------------E-------------------<>------<>----------------------S----XXX-X------------S----E---------------------XXX-XX--SSSSS---------EE-------<>-----------------------------------XXXXX---------------XXX---------X---E----<>------QQQ-------S----------XX---------------------XS------SQQQ--Q-------QQ---S?S-Q-Q----------------------------<>------E-----------------------<>---------------------------XXXXX----------------------<>---------XXX----------S-------------------ESSS--Q-------------------XXXXX----XXXX------------XX------------X---------------X-QQQ------------------<>-X------------------------XXXXX-
--------------XXXX---X-------------------------------------[]-----E---E---E----------------------------------------------------------------------------EXXXXXX--------------[]-----<>--------------------E--X----------------E--------------------------------------------------------------------------E-------------------<>------------------------------o------------o----------------------XX--------<>--[]-------------------------------------------------------E----------------------<>--[]-----E----------------[]--------------------[]----------------------------------------[]----E<>------XXX-----E-E-------------------------------------------------------------------------E-----------------------------------------E-----[]-XXX-------------------[]--[]---------------------<>------[]------------------[]----------------------------------XXXXXXX----------XXXX-XXX--------------------XXXX-XX--E------XX---------------------<>-------------------[]------[]-------------------------XXXXX-----------------E<>--------------------XXXX-XX--E----------------------[]--E------E----------------X-------XXXXXX-------------XXXXX--------XX--<>----[]-----------------------------------------------E--X-------------------------------------------------------------[]----E<>---E-------------------[]--------XXXX--------------XXXXXX-SS-------------------[]--------XXXX------------------E-E-------------------------------------------------------------------------XX--------------XX----------------------[]-XXX---------------------XXXXXXX
----------<>-XXXXX-----------S-----------------------------[]----<>--<>--<>---------------------------XXXXX---oo--------------------------------------XXXXXXXX---------X----[]-----[]-----------------------X---------------------------------------------------------------------------------------------------------------[]-----------------------------XXXX---XXX---XXXX--------------------XXX-------[]--[]------------------------------------------------------<>------------------o---[]--[]----------------------[]--------------------[]----------------------------------------[]---<>[]-----XXXX----<><>------------------------o-----------------------------------------------<>----------------------<>----------------<>-----[]-XXX-------------------[]--[]---------------------[]------[]------------------[]---------------------------------XXXXXXXX---------XXXXX-XXX-------------------XXXXX-XXX-------XXX---------<>----------[]-------------------[]------[]-------------------------XXXXX----------------<>[]-------------------XXXXX-XXX------------------------[]-<>-----<>-----------------------XXXXXXX-------------XXXXX-------XXX--[]----[]-------------------------------X------------------X-----------------------------------------<>------------------[]---<>[]--<>-------------------[]----<>-XXX---------------XXXXXXX----------------------[]-------XXXXX-------------<>--<>---------------------------------------------------o----------------------XXX-------------XXX--------------------X-[]-XXX--------------<>----XXXXXXX-
----------[]XXXXXX-SSSSS-------------------------------E---[]----[]--[]--[]-------------XXXXXXXXXXX--------------------------------------------------XXXXXXXXXX-------XXE---[]-----[]-----------------------X------------------X-------------------------------------------------------------------------------------EE-----[]-E-E-----E--------XXXX---------------------------E----EE-E--------XXXX---S--[]--[]-E-----------------X------E-------------EE------------[]----------------------[]--[]----------------------[]-E--E-EE----E----E--[]---------------------------------EE-E-E-[]---[][]----XXXXX----[][]-----------------------X------------------------------------------------[]----------------------[]---E--------E-E-[]--E--[]-XXX----------------E--[]--[]-------------E--E----[]-E----[]------E-----------[]-------E-E-----------E-------E--XXXXXXXXX--------XXXXXX-XXXX--------X--------XXXXXX-XXXX-----XXXXE----EE--[]----E--E--[]------EE-E-E-------[]------[]------------E-----E-EE--XXXXXX----------------[][]------------------XXXXX--XXXX-------XX-E-E------E---[]-[]---E-[]---------------------XXXXXXXXX-------------XXXXX------XXXX--[]---E[]-----------EE-E--------XX---------------------E---X-----EE--------------E--E----------------[]-------E---EE-E-E-[]---[][]--[]-E--------------E--[]----[]XXXX------------------XXXX-----------E-----E-E--[]------XXXXXX---EE--------[]--[]---E-E----------------------E-EE--E-----------o---XXX--------------------XXXX--XX---------XXX--E-E-E--------EE--XX-[]--XX--------E-----[]---XXXXXXXX-
XXXXXXXXXXXXXXXXX--SS--XXXXXXXXXXXXXX-XXXXXXXXXXXXXXXXXXXXXXXXXXXXXXXXXXXXXXXXXXXXXXXX------S-----------------------------------------------XXXXXXXXXXXXXXXXXXXXXXXXXXXXXXXXXXXXXXXXXXXXXXXXXXXXXX--XXXXXXXXXXXXXXXXXXXXXXXXXXXX-----XXXXXXXX----XXXXXXXXX--XXXXXXXXXXXXXX-----XXX--XXXX---XXXXXXXXXXXXXXXXX--XXX---XXXXXXXXXXXXXXXXXXXXXXXXXXXX----------------------------XXXXXXXXXXXXXXXXXXXXXXXXXXXXXXXXXXXXXXXXXXXXXXXXXXXXXXXXXXXXXXXXXXXX--XXXXXXXXXXXX-XXXXXXXXXXXXXXXXXX--XXXX-----XXXXXXXXXXXXXXXXXXXXXXXX--XXXXXXXXXXXXXXXXXXXXXXXXXXXXXXXXXXXXXXXXXXXXXXXXXXXXXXXXXXXXXXXXXXXXXXXXXXXXXXXXXXXXXX-XXXXXXXXXXXXXXXXXXX-----------------------------------X----XXXXXXXXX---XXXXXXXXXXX-XXXX--XXXXX---XXXXXXXXXXXXXXXXXXXXXXXXXXXXXXXXXXXXXXXXXXXXXXXXXXXXXXXXXXX-XXXXXXXX-XXXXXXXXXXXXXXXXXXXXXXXXXXXXXXXXXXXXXXXXXXXXXXXXXXXXXXXXXX-XXXXXXXXXXXXXXXXXXXXXXXXXXXXXXXXXXXXXXX--XXXXXXXXXXX-XXXXXXXXXXXXXX--XXXXXXXXXXXXXXXXXXXXXXXXXXXXXXXXXXXXXXXXXXXXXXXXXXXXXXXXXXXXXXXXXXXXXX-XXXX-XX-X-XXXXXXXXXXXXX---XXXX-----XXXXXXXXXXXXXXXXXXX--XXXXXXXXXXo-EXXXXXXXXXXXXXXXXXXXXXXXXXXXXXXXXXXXXXXXXXXXXX-----XX-----XXXXXXXXXXXXXXX-XX--XXXXXXXXXXXXXXXXXXXXXXXXXXXXXXXXXXXXXXXXXXXXXXXXXXXX------------------------XXXXXXXXXXXXXXXXXXXXXXXXXXXXXXXXXXXXXXXXXXXXXXXXXXXXXXXXXXXXXXXXXXXXXXXXXXXXXXXXXXXXXXXXX-XXXXXXXXXXXXXXXXXXXXX-X-----X-XXX-XXXXXXXXX-----XXXXXXXXXXXXXXXXXXXXXXXXXXXXXXXXXXXXXXXXXXXXXXXXXXXXXXXXXXXXXXXXXXXXXXXXXXXXXXXXXXXXXX------XXXX----------------------XXXXXXXXXXXXXXXXXXXXXXXXXXXXXXXXXXXXXXXXXXXX--XX--XXXXXXXXX-XXX-XXXXXXXXXXXXXXXX