------------------------------------------------------------------------------------------------------------------------------------------------------------------------------------------------------------------------------------------------------------------------------------------------------------------------------------------------------------------------------------------------------------------------------------------------------------------------------------------------------------------------------------------------------------------------------------------------------------------------------------------------------------------------------------------------------------------------------------------------------------------------------------------------------------------------------------------------------------------------------------------------------------------------------------------------------------------------------------------------------------------------------------------------------------------------------------------------------------------------------------------------------------------------------------------------------------------------------------------------------------------------------------------------------------------------------------------------------------------------------------------------------------------------------------------------------------------------------------------------------------------------------------------------------------------------
------------------------------------------------------------------------------------------------------------------------------------------------------------------------------------------------------------------------------------------------------------------------------------------------------------------------------------------------------------------------------------------------------------------------------------------------------------------------------------------------------------------------------------------------------------------------------------------------------------------------------------------------------------------------------------------------------------------------------------------------------------------------------------------------------------------------------------------------------------------------------------------------------------------------------------------------------------------------------------------------------------------------------------------------------------------------------------------------------------------------------------------------------------------------------------------------------------------------------------------------------------------------------------------------------------------------------------------------------------------------------------------------------------------------------------------------------------------------------------------------------------------------------------------------------------------------
----------------------------------------------------------------------------------------------------------oo------------------------------------------------------------------------------------------------------------------------------------------------------------------------------------------------------------------------ooo----------S-S-----SSSSSSSSS----------------------------------------------------------------------------------------------------------------------------------------------------------------------------------------------------------------------------------------------------------------oo--------------------------------------------------------------------------------------------------------------------------------------oo------------------------------------------------------------------------------------------------------------------------------------------------------------------------------------------------------------------------------------------------------------------------------------------------SSSSSSSSSSSSSSSSSSSSSSSSSSSS-------------------------------------------------------------------------------------------------------oo-------SSSSSSSSSSSSSSSSSSSSSSSSSSSS----------------------------------------------------------------------------------------------------------------SSSSSSSSSS-----SSSSSSSSSSSSS------------------------------------------------------------------------------------------------------------------------------------------------------------------------
--------------------------------------------------------------------------------------------------------------E---------------------------------------o--------------------------------------o--------------------------------------------------------------------------------------------------------------------------------------XXXX----------SS-----Q----------------oS-----------------------------------------------------------------------------------o----------------------------------------------------------------------------------------------------------------------------------------------------------------------E--------o-------------------------------------------------------------------------------------------------------------------------------------------------------------------------------------------o----------------------------------------------------------------------------------------------------------------------------------------------------------------------------------------------------------Q-------------------------------------------------------------------------------------------------------------------------------------------------------XXXX-----------------------------------------------------------------------------------------------------------------o-------------------------------------S-------S--SSSSSSSSSSSS-------------------------------S----------------------------------------------------------------------------------------------------------------------------------------
-------------------------------------------------------------------oooooo--oo--------------------------------XXX-------------------------------------------------------------------------------------------oooo------------------------------------------------------------------------------------------------------------oooo-------------------SS-------------------------------------------------------------------------------------------oo--oo--ooo--------------oo--oo--------------------------------------------------------------------------------------E----------------------------------------------------------------XXX----------------------------E-----------------------------------------------------------------------------------------------------------------------------------------------------------------------------------------------------------------------------------------------------------------------------------------------------------------------------------------------------------------------------------------------------oo---S-?--------------------------------------------------------------------------------------------------------------------------------------------------------------------------------------------------------------------------------------------------------------------------------------SS------S---SSSSSSSSSSSS----------------------------------------------------------------------------------------oo---------------Eooo-----------------------------------------------------------
---oo----QQQQ-----------------------------------------------------------------------XXX------XX----Sooo----X-------------------SSSSSSS----------------XXX--------SX-----------------------SSSS-------------XXXX-----------------------------------S------SS--------------------------------------X-------------------------XXXX-------XX--------------SSS---------------SSS-------------S---SSSSSS---SSQ----------?SSS--SSSSSSS--------------------------------ESSSS----------------------------------------SSS---------SSSS--------SSSSSSSSSS--------------------SSQSSS-------S---------------------SSSSSSS-XXo----XXX--------------------------XXX----------------S---SSS----SSS---------SSSSS---SSQ---------------?------------SSS-------------XXX------Xoo--XXXXX------o-----------------------------------------------------------SSSSS----------------SSSSS-----E--S------------------------------------------SQ----------------------------------------------------SSSSSSSSSSSSSS-----S-----SSSS-----------------------------------------oo---------------E--?----------SSS-----------------S----------------------------------SS---SSS---------------------------------------------S-----------------------S--------------------------------?SSS---S-Q------SSSS--------------------------------SSSS-S---SS--------------SSS---SSSSSS----SSSS------------------o-------------SSSSSSSSSSS-----------Q----SS-----------SS-Q------------S---SSS---------------------SSSSS----S-----XXXX-E--E--------XXXXX----------------------------------------------------------
---------------------------------------------oooo--------------------------------------------------------------------------------------------------------------------XXX---------o-------------------------------o-----SSS------------------------------------------------------------------------------------------------------------XXSS------------SSS---------------SSS-------------------------------------------------------------------------XX-------E--------------------------------------------------------------------------------------------------------------------------------------------------------------XXX-X-----------------------------------------------------------------------------------------------------------------XXX------------------------XXX------------------------------o------------------------------------------------SS----<>-----------------XSS---------------------------------------------------------------------------------------------------------------------------------------------------------------------<>------------------------------------------------------------------------------------------------------------------------------------------------------------------------------------------------------------------------------------------ES--------------------------------------------------------ES----------------SS------------------------------------S-------------------------------oooo--------------------------------XX-------------------ooo----------------------------------------------
-----------------------X----------------------------------------------------------------------------------------------------------E--------------------------------o-o-------------------------------------------------X-------------------------------o------------------------------------------------------------X----o------------XXX-------------SSS-----S---------SSS------------------------------------------------------------------------------X-XXXXX-------------------------------------------------------------------------------------------------E---------------------------------------------------------oo-o-----------------------------------------------------------------------------------------------------------------XXXX------------------------------------------------------------------------------------------------------------S----[]---------------XXXX----------------------------------------------------------------------------------------------------------------------------------------o-----------------------------[]----------------------------------------------------------------------------------------o------------------------------E-Q----------------------------S------------------------------------------------------------------------------------S--E----------------------------------------------------S-S----------------SS------------------------------------S-E---------------------------------------------------------------------------------------------------------------------------------------
-----------------------X---------------------------------------------------------o--------------------XXX--------------------------------S------SSS--------------------------------E----------------------o-----------X----------SSSSSS---------------------S------------------------E--------------------XXX-------------------------XXX---------ooooSSS----oS--oo-----So??----------------------------SSSSQS----------------------Q---------------------------XXX--------------------------------------oo----------------------------------E-------------------------------------------------------SSSSS-------------------------XX----------------------------E---------------S-------------------------E------------------------------------XXXX-------------------------XX---------------XXXXXX----------------------------------------------------ooo----SS-------------S-------XXXS-----------------E--S----------------------------E-EE-E----------------------------------E--------------------------------------------------------------XX------------[]----------------------------------------------------------------------------------------------------------------------<>-----------------E----SSSSSSSS---------------------------------------------------------------------------------------------------E----------XX-----------------------------E--E-----------ooooSS--QE------------------------E-------S-------------------Q---------E----------------------------------------------------------------------------------------------------E------
-----XXX?SSSQQQ--S---X-XX-------------------S-------------------XXXXXX--------------XX-----XXXXXXXX----------XXX---E------------S?S-----------------------XXXXX--S?S--------------<>------E--------------------------XX------------------------------SSS-------E-----------E---E----<>-----------XX-------------------X---------------XX-----------SSSSSS---SSS--SS-----SSS?--------------------SSS--------------------------------------------XXX----------------------------------------------------E----------------X-SSSS-------E--XXX-SSSSS-----------------ESSSS?SQ-----E-----------------XX---------X-----XXXXXXXXXX-------------------------S-----------<>--Q---SSS----XXX-XX----------------S----<>----Q-----Q----------XXX---S------XXXXXX----------XXX---XXXX------------XXX------------------------------------XX--X----------------------E----S----S-----XSoS--o-------X-XXX-----------------<>-----E-QS-Q------------------------X--XX-----------------XX-------X--SSSSS-----QQQ--QQQQ-------------------E--------S------------------------XXXX-----------------ESS----------------QSSS------E------------S----------E----XXXX--S--XXXX-XX--------QQQQ-------------SS-----[]-S--------------<>------------SSSS------o-E-----------------QQQ--S?S------------XX--XX----------E----S-----------------SSS--S---<>---------XXX-----Q--QQQQ-----Q--------------SS-----E--?-SSSSSS-SSSS----------Q-Q---S-----<>-------SSS-E---------S--------------<>------------------------------XXXXX---XXXX-XXX---------<>------------------------------------------<>------
--------------------EX-XX-----------------------------------------------------------------------------------------<>------------------E--------------------------------X----------[]----E<>-------------------------XXX--XX-----------------------------------<>----------<>--<>----[]--------------------E-----------X--------------XXX------------------------------E--------------------------------X------------------------------------------------SS-------------------------------------------<>---------------XX-------------------E---------E-----------------------<>-----------------XX--------XX---X------------------------------------------------[]------------XXX--XX---------------------[]-------------E----XX-------------XXXXXXXX------------------------------------X--------------------------------XXX--XX--------------------<>----------oo---E-----E----<>-XXXXX-----------------[]-----------------------------X------X-XX------------XXXX-XX-------X----------------------------------------------------E----------------------------------------------------------------------<>---E-----E----------XXXX--X---------------XX----------------------------X---[]ES--------------[]-----------------------------S--E----------------------------XXX--XX----E----<>-------------------------------[]--------XXXX-----------------------------EE------X<>-----------E-------------------------[]--E---------------------------------[]-------------------------------------------------------[]------------E---------------E-------------[]--E---
-------------------X-XXXX---------------------------------------------------------------------------o-------------[]------------------X-------------------------------XX----------[]---<>[]------------------------XXXX--XXXX------------------------------X--[]----------[]--[]----[]-------------------<>-----------XX-------------XXXX-------------------------------------------------------------XX-------------------------------------------------S-------------------------------------------[]--------------XXX-----------------------E---X---------X---------------[]----------------XXX-------XXXXXXXX-----------------------------------------------[]-----------XXXXX-XXX---------X----------[]------------<>----XX------------XXXXXXXXX--------------------------------------------------------------------XXXX--XXX--------XX---------[]----------<>--------<>----[]-XXXXXX----------------[]---------------------------XXXXX----X-XXX----------XXXXX-XXX------X---------------------------------------------------<>-----------E----------------------------------------------------------[]--<>----<>----------------X-------------XXXXX-----------------------------X-[]SS--------------[]------------------------------------E-----------------------XXXX--XX---<>----[]-----XX------------------------[]-------XXXXX---------------------------------E---X[]----------------X-<>-----------------[]-<>---------------------------------[]------------------------------------------------XXX----[]-----------<>--------------<>-------------[]-<>---
----------------E----XXXX-------------------E---------------------------------------------------------------------[]-------------------------------------------------XXX------E-E-[]---[][]-----------------------XXXXX?-X-XX------------------------EE---XX--[]-----E-EE-[]--[]-E--[]-------------------[]-----------X--------------XXX-------X--E-EE--------------------------E----E--E-E-----------XX-----------E-E-------------------------------------------------------------------------EE-E--[]----------E---XXX--------------------------XX---------X--------------X[]-E----------E---XXX------XXXXXXXX------------------------------ooo--------EE-----[]-----E----XXXXX--XXXX--EE---XX---EE-----[]-------E--E-[]----XX-----------XXXXXXXXX----XXXXX----------------------------------------------------E-EE---XXXXX--XXXXE-EE---XX---EE-E--[]----------[]-----E--[]----[]XXXXXXX--------XX------[]-E--------------EE---E-----XXX--------XXX--E-E----XXXXX--XXX--E---X-------------------------------EE-E----------EE----[]-----------S------o-o--------------------------------------E----------[]--[]----[]--------------XXX---------------XXX---E-S-E----------E-----E--X-X-[]SS-E------------[]----------------------------E----S----------------------E--XXXXX--XX---[]----[]-----XX-----------E-E-------E--[]------XXXXXX-------------------------------------X[]----------E-----X-[]-EE-E------E-----[]-[]---EE-------------------------E--[]---------------------------ooo----XXXX---------------E-[]-----------[]--------------[]---E---------[]-[]-E-
XX--------XXXXXXXXXXXXXXX--XXXXXXXXXXXXXXXXXXXXXXXX---XX--XXXXX----------X-XX-----------------------------------XXXXXXXXXXXXXXXXXXXXXXXX----X-X-XXXXXX-X--------XXXXXXXXXXXXXXXXXXXXXXXXXXXXXXXXXXX--XXXX---XXXXXXXXXXXXXXXXXXXXXXXXXXXXXXXXXXX--XXXXXXXXXXXXXXXXXXXXXXXXXXXXXXXXXXXXXXXXXXX----?---XXXXXXXX---------XX----XXXXXXXXXXXXXXXXXXXXXXXXXXXXXXXXXXXXXXXXXXXXXXXXXXXXXXXXXXXXXXXXXXXXXXXXXXXXXX-XXXXXXXXXXXXXX-XXXXXXXX--XXXXXXXXXXXXXX-----XXXX-XXXXXXXXXXXXXXXXXXXXX-----XX-XXXXXXXXXXXXXXXXXXXXXXXXXXXXXXXXXXXXXXXXXXXXXXXXXXXXXXXXXXXXXXXXXXXXXXXXXXXXXXXXXXXXXXXXXXXXXXXXXXXXXXXXXXXXXXXXXXXX---------------XXXXX----------XXX-XXXXXXXXXXXXXXXXXXXXX-XXXXXXXXXXXXX--XXXXXXXXXXXXXXXXXXXXXXXXXXXXXXXXXXXXXXXXX-XX---XXXX-XXXXXXXXXXXXXXXXX--------------------------------------------------------XXXXXXXXXXXXX--XXXXXXXXXXXXXXXXXXXXXXXXXXXXXXXXXXXXXXXXXXXXXXXXXXXXXXXXXXSX--XXXXXXXXXXXXXXXXXXXXXXXXXXXXXXXXXXXXXXXX-X--------X--XXXXXXXXXXXXXXXXX--XXXXXXXXXXXXXXXXXXXXXXXXXXXXXXXX----XXXXXXXXXXXXXXXXXXXXXXXXXXXXXXXXXXXX--X------XXX------XXXXXXXXXXXXXXXXXXXXXXX----XXXXXXXXXXXXXXXXXXXXXXXXXXXXXXXXXXXXX-----XXX------XXXX----XXX------XEXXXXXXXXXXXXXXXXXXXXXXX-XXXXXXXXXXXXXXXXXXXXXXXXX-XXXX-XXXXXXXXXX-----X------XX-XXXXXXXXXXXXXXXXXXXXXXXXXXXX--XXXXXXXXXXXXXXXXXXXXXXXXXXXXXXXXXXXXXXXXXXXXXXXXXXXXXXXXXXXXXXXXXXXXXXX---XXXXXXXXXX--XXXXXXXXXXXXXXXXXXXXXXXXXXXXXXXXXXXXXXXXXXXXXXXXXXXXXXXXXXXXXXXXXXXXXXXXXXXXXXXX--XXXXXXXXXXXXXX--XXXXXXXXXXXXX-XX--XXX---------------------XXXXXXXXXXXXXXXXXXXXXXXXXXXXXXXXXXXXXXXXXXXXXXXXXXXXXXXX