------------------------------------------------------------------------------------------------------------------------------------------------------------------------------------------------------------------------------------------------------------------------------------------------------------------------------------------------------------------------------------------------------------------------------------------------------------------------------------------------------------------------------------------------------------------------------------------------------------------------------------------------------------------------------------------------------------------------------------------------------------------------------------------------------------------------------------------------------------------------------------------------------------------------------------------------------------------------------------------------------------------------------------------------------------------------------------------------------------------------------------------------------------------------------------------------------------------------------------------------------------------------------------------------------------------------------------------------------------------------------------------------------------------------------------------------------------------------------------------------------------------------------------------------------------------------
---------------------------------------------------------------------------------------------------------------------------------------------------------------------------------------------------------------------------------------------------------------------------------------------------------------------------XXX------------------------------------------------------------------------------------------------------------------------------------------------------------------------------------------------------------------------------------------------------------------------------------------------------------------------------------------------------------------------------------------------------------------------------------------------------------------------------------------------------------------------------------------------------------------------------------------------------------------------------------------------------------------------------------------------------------------------------------------------------------------------------------------------------------------------------------------------------------------------------------------------------------------------------------------------------------------------------------------------------------------------------------------------------------------------------------------------------------------------------------------------------------------------------------------------------------------------------------------
-----oo---------------------------------------------------o-------------------------SSSSSSSSSSSSSSSSSSSSSSSSSSSS----------------------------SSSSSSSSSSSSSSSSSSSSSSSSSSSS----------------------------------------------------------------------------------------------------------------SSSSSS-----------SSSSSSSSSSSSSSSSS------SSS------SSSSSSS----------------------------------------------------------------------------------------------------------------o----------------------------------------------------------------------------------------------------------------------------------------------------------------------------------------o----------SSSSSSSSSSSSSSSSSSSSSSSSSSSSSSSSSSSSSSSSSSSSSSSS-------------------------------------------------------------------------------------------------------------------------------------------------------------------------------------------------------------------------------------------------------------------------------------------------------------------------------------------------------------------------------------------------------oo--------------------------------------------------------------------------------------------------------------------------------------------------------------------------------------------------oo-----------------------------------------------------------------------------------------------------------------------------------------ooo-------------------------------------------------------------------------------------------
---------E--EE---------------------------------------------------------------o----------SS-----------------------------------------------------------------------------------------------------------------------------------------------------------------------------------------------------------------------------------------------------------------------------------------------------------------------------------------------------------------------------------------------------------------------------------------------------------------------------------------------------------------------------------------------------------------------------------------------------S----------------------------------------------------------------ooo-------------------------------------------------------------------------------------------------------------------------------------------------------------------------------------------------------------------------------------------------------------------------------------------------------------------------------------------------------XXXX------------------------------------------------------------------------------------------------------------------------------------------------------------------------------------------------XXXX----------------------------------------------------------------------------------------------------------------------------------------XXXX------------------------------------------------------------------------------------------
--------XXXXXXXX------X---------------------------------------------oooo----------------SS--E------------------------------E---------------------------------------------------------------------------------------------------------------------------------------------------------------------------------------------------------XX----------------------------------------------------------------------------------------------------------------------------XXX------------------------------oo--oo-------------------------------------------------------------------XXX-------------o----ooooo----------------------------------------------------------------------------------------------------------------XX--------------------------------------------------------------------------------------------------------------------------------------------------------------------------------------------------------------------------------------------------------------------------E-----------------------------------------------------------------------------------------------------------------------------------------------------------------------------oo----------------------------------------------------------------------------------------------------------------------------------------------------o--------------------------------------------------------------------------------------------------------------------------------------o-----------------------------------------------------------------------------------------
o-------------------------S-------------------------------XXX-------------------ooo----S----S---Q--------------------------QS--SQS--------SS---E--------------------------------------------------------------------------------------------SSSS-SSSS-SSS------------------------X---------------------------------------------------------------------------Q------------------QS----------------------SSSSS-------SSSS-----SSSSS--SSSS-QS--------------SSSSSS-------?-------oo----XXX-------------------------------------------------------------S-----o--XXXX----oo----------------------XX----XX------o----------------------------SSSSSQS---?-------X----SSS----------S----------------SSS------E------------------------------------------------------oo---XX-----ooo-------oSS--SQS-----------------------SS----------------------------------------------------SSS------------------SSS------------------------------ESQ-----------------------------------------------------------------SQS--SSSSS------------------------SSS--------o------------------XXX---------------------------------S-S?SS-------------------------------------QSQ--SSSS--------------------------------------SSQS------------------------------?SSS------------------------------------------------------------E---------SSSSS-------SSS----oo------o---S--------------------------Q------------------SSSS----S----S--------------SSS---SS------E----------------------XXX-----------o----XXXX--------------QQQQ-------------SSS-----E--S-----------------QQ-------------------------
X-----------------oo-----------------------------------------------------XXXX----------S-----------------------------------------------------------------------------------------------------------------------------------------------------------------------------------------X------------E-----------------------------------o------------------E------------------------------------------------------------------------------SS--------------------------XXX--------------------------------------------ooo-----------------oo-------------------XXX---------------------E--------------------------X-----------------------------------------------------------------------------------------<>-----------------------------------------------------XX-------<>----------XXXS--------------------------------------------------------------------------oooo-----ES---------------------------------------------------<>S--------------------------------------------------------------------------------------------------------------XX-------------o---XXXX----------------------------------------------------oo--------------EE------------------------------------------------------------------------------------------------------------------------------------------------------<>-----------------------------------XX------------------S--------------------------oo---------E---------------------------------<>-----------------------------------XX----------------------------------------------<>----------------XXX----------------------------
XXXXXXXXX-------------------------------------XX-------------------------------------SSS-----------------------------------------------------------------------------------------------------------------------------------------------------------------------------------------X-----------<>-----------------------------------XX---------------XSS--o----------------------------------------------------------------------------S-------------------------------------------------------------------------E-----------------------------------------------------------------------------------------------------------------------------------------XXX-----------------------------------------[]--------------------------------------------------------------[]-----------o------------------------------------------------E-------------------------------------S---------------------------------------------------[]S-----------------------------------------------------------------E--------------------------------------------XX-----------------XXXX-------------------E----------------------------------E-----------XXSS------------------------------------------------------------------------------------------------------------------------------------------------------[]-----------------------------------o-------------------------------------------------------------------------------------------[]----------------------------------------------o------------------------------------[]-----------------------------------------------
----------------------------------------------XX---------------------------------XXXX--So??------------------------------------------------X----XXS-Soo--------------------------------------------------------------E-----------------------------S-------------------------------X---------[]-----E---------------------------------------------XXX----------------------------------------------------------------EE-------------SS------------------------------------------------------XX-------------------------------------------------------------------------XXXXX-------------------XXXXXX-----------------------------------E----------E----XXXX-----------------------------E-----------[]---------------E----------------------------------------------[]-------------ES------------o----------------------------E--S--------------------------E----------SS----------------SSSSSS-----S--------------------E--[]S---------S-S-------------------E---------------------------E----<>-------------------S-----------------------XXX----------------XXXXX------------------<>---------------SSSSSS---------E--<>----------XXXX-------------------------------------------------------S--------------E----------------------------------------------o-----------------oo---------------X-------------------------------------XS-SQS----------XS--SQ---------------S--------------oo---S-----------------------------E-->------------------------------------------------------------------------------------[]-----------------------------------------------
--------oo---------------EE-------------------XX--------XX----XXXX------------------X--SSS--S--S?SQS---------SSS--------------------------XX---XXX--------------------------------------------E-----X---------------<>---------------------XX------S--SS-S-----------------------XXX---------[]----<>-------------E------------------------------XXXX--S-----S----------------S?S--QQ------QQQQ--QQQQ-----SSS-------E-----EX----S---SS--SSS--------------------X----------------XXXXX--XX---S----------------E-E-----E----------XX--------------------------XXXXXXXX---------------------XXX---------------------E-----S----------------XS--S?S---------XXXX------------S---------------<>----S----SS[]SS-----S------<>----------------------------------------XXXX--XXX----XXX-----SS--S?S----E------------SSS-QQQQ--EQQ-----<>---------------E---------E--<>----------SS--SSS---------Q-----------------------E--------<>--[]S-------E--o-------------------<>------S------E------------<>----[]-----EQQS--QQQ--------------------S-------XXXX---------------XXXXXX------------------[]------------E--------E-------<>--[]----------XXXX-SS---SS-------------------------------------------<>---S---<>-------<>-------Q--Q--Q---------------------QQQQ------------------------------------------X-------------S---------XXXXX---S--------o--o--------XXX--X-------SSS------------------------------SS----------SS--------S--<>------XXX-------------------XXXXX---------XXXXXXX--------------SQSS------------------SS[]SS----------------X-QQQ------------------------
----------------------XXXXXX----------------XXXX-----------XXXX---------------------XX---------------------------------------------------XXX--XXXX-------------------------------------------<>-----X---------------[]-------------------XXXX--X---E--E---E--------------------XXXXX--XXX----[]----[]------------<>------o----------------------XXXXX-------------X-------------------------------------------------E--EX-XX------E---------------X----E------XX-------E-----------------------------E-----E<><>----<>--------XX----------------X---------------------------------------------------------------<>--------E---E-E-----------------------XXXX----------------------------[]-----------[]--------------[]-----------------------------------------------------------------E-----<>------E-----------------------[]--<>----------<>--------<>--[]-------------------------------------------------<>--------[]--[]S----XX<>---------E------------[]------------<>-------E----[]----[]----------------------------------------XXXXXX--------------XXXXXXX-----------E------[]-----------------------------[]--[]--------XXXXXX------------X-----------------------------------o--[]-------[]-------[]--------------------------------------------------------------------------------XX---X-----------------------------------------------XXXX--XX-------------E----------------------------------------------SS--[]----------------------------------------------------------------------------------E----[]-------E-------E--X-------------X--------------
--------------------------------------------XXXX------------------------------------XX--------------------------------------------------XXXX-XXXXX------------------X------------------------[]-----X---------------[]------------------XXXXX--X--X------------------------E---XXXXX----X----[]----[]------------[]-----XXXXX-------------------XXXXX--SSSS-------X---X---------------------------------------------------XXX------------------------------E-XXX------<>----------------------<>----<>----<>[][]----[]--XX----------------------X--------------------o-----------------------o------------------[]-------<>--<><>-----------------------XXXX----------------------------[]-----------[]--------------[]--------------------------X-------------------------------------<>-----[]-----<>-----------------------[]--[]----------[]--------[]--[]----------------<>-------------------------------[]--------[]--[]S--XXXX[]----------------------[]------------[]------<>----[]----[]--------------------------------------XXXXXXXX-------------XXXXXXXX----------<>------[]-----------------------------[]--[]--------XXXXXX------------X---X------------------------------XXX-[]-------[]-------[]--------------------------------------------------------------------------------XX---------------------------XXX-----XX-------------XXXXX--XX------------<>-----------------------------------X----------SS--[]---------------------------------------------------------------------------------<>------------<>------<>--X----------------------------
--------------------------------------------XXXX----------XX------------------------XX---------------------E--E----E-EE----------------XXXXXXXXXXX----------E-E-----X--------E-EE------EE----[]----XX------EE-E-E---[]------------E-EE-XXXXXXE-X--X---------------------------XXXXXX----X-E--[]----[]---E-E---E--[]--------------------------E--XXXXX-------------X-E-X----E----------------------------------------------XXX-------E-E-----------X----------XXX------[]----------------------[]----[]--E-[][][]--E-[]--------------------------X-----XXXXX---------XXX-------------XXXXXX-XXXX-----------------[]-------[]--[][]-------E---------------XXXX-------X----------E---------[]--------E--[]-----------E--[]----------------------EE--X----------ooo------------------------[]-----[]-----[]-------------------E---[]--[]----------[]-----E--[]--[]-------EE--E----[]-------------------------EE-E--[]--E-----[]--[]SXXXXXX[]----------------------[]--E-E-------[]----E-[]----[]----[]-----------E------------E-EE-E---E---XXXXXXXXX-----------XXXXXXXXXX------X---[]------[]-------EE--------------------[]--[]--------XXXXXX------------X-E-X----E-----------------------------[]-------[]-------[]-----E-------------------------E---------------------------------------------E--XXE----E-E---------------------------XX------------XXXXXX--SXXX----EE----[]---------------------E-E-------E---X-ES-------SS--[]------------------------XX-------------------------------E-EE-E-----EE-E---------[]-E----------[]------[]--X----------------------------
----X-XXXXXXXXXX---XXX------XXXXXXXXXXXXXXXXXXXXXXXXXXXX----------------------------X-XXXXXXXXXXXXXXXXXXXXXXXXXXXXXXXXXXXXXXXXXXXXXXXXXXXXXXXXXXXX------XXXXXXXXXXXXXXXXXXXXXXXXXXXXXXXXXXXXXXXXXXXX--XXXXXXXXXXXXXXXXXXXXXXXXXXXXXXXXXXXXXXoXXXXXXXXXXXXXXXXXXXXXXXXXX-XX-XXXXXXXX------XXXXXXXXXXXXXXXXXXXXXXXXXXX--------------XXXXX--XXXXXXXXXXX------XXXXXXXXXXXXXXXXXXXXXXXXXXXXXXXXXXXXXXXXXXXXXXXXXXXXXXXXXXo--X--XXXXXXXXXXXXXXXXXXXXXXXXXXXXXXXXXXXXXX------XXXX----XX------------XXXXXXXXXXXXXXXXXXXXXXXXXXXX-----------XXX--XXXXXXXXX-------------------------------XX------S-------------------XXXXXXXXXXXXXXXXXXXXXXXXXX--XXXXXXXXXXX--X--XXXXXXXXXXXXXXXXXXXXXXXXXXXXXXXXXXXXXXXXXXXXXXXXXXXXXXXXXXXXXXXXXXXXXXXXXXX--XXXXXXXXXXXXXXXXXXX----XXX---------------------XXXXXXXXXXXXXXXXXXXXXXXXXXXXXXXXXXXXXXXXXXXXXXXXXXXXXXXXXXXXXXXXXXX-XX--XXX-XXXXXXXXXXXXXXXXXXXXXXXXXXXXXXXXXXXXXXXXXXXXXXXXXXXXXXXXXXX--XXXXXXXX-XXXXXXXXXXXXXXXXX-XXXXXXXXXXXXXXXXXXXXXXXXXXXXXXXXXXXXXXXXXXXXXXXXXXXXXXXX------X-XXXXXXXXXXXXXXXXXXXXXXXXXXXXXX--XXXXXXXXXXXXXXXXXXXXXXXXXXXXXXXXXXXXXXXXXXXXXXXXXXXXXXXXXXXXXXXXXXXXXXX-XXXXXXXXX--XXXXXXXXXXXXXXXXXXXXXXXXXXX--XXXXXXXXX-----------XXXXXXXXXXXXXXXXXXXXXXXXXXXXXXXXXXXXXXXXXX---XXXXXXXXX--XXXX----XXXXX--XXXXXXXXX----XXXXXXXXXXXXXXXXXXXXXXXXXXXXXXXXXXXXXXXX----------EXXXXXXXXXXXXXXXXXXXXXX------XXXXXXXXXXXXXXXXXXXXXX----XX---XXXXXXXXXXXXXXXXXXXSXXXXXXXSSXXXXXXXXXXXX-----XXXX---XXXX-----------------------------XXXXXXXXXXXXXXXXXXXXXXXXXXXXXXXXXXXXXXXXXXXXXXXXXXXXXX-XXXXXQ-XXXXX----XXXXXXXXXXXXX