------------------------------------------------------------------------------------------------------------------------------------------------------------------------------------------------------------------------------------------------------------------------------------------------------------------------------------------------------------------------------------------------------------------------------------------------------------------------------------------------------------------------------------------------------------------------------------------------------------------------------------------------------------------------------------------------------------------------------------------------------------------------------------------------------------------------------------------------------------------------------------------------------------------------------------------------------------------------------------------------------------------------------------------------------------------------------------------------------------------------------------------------------------------------------------------------------------------------------------------------------------------------------------------------------------------------------------------------------------------------------------------------------------------------------------------------------------------------------------------------------------------------------------------------------------------------
------------------------------------------------------------------------------------------------------------------------------------------------------------------------------------------------------------------------------------------------------------------------------------------------------------------------------------------------------------------------------------------------------------------------------------------------------------------------------------------------------------------------------------------------------------------------------------------------------------------------------------------------------------------------------------------------------------------------------------------------------------------------------------------------------------------------------------------------------------------------------------------------------------------------------------------------------------------------------------------------------------------------------------------------------------------------------------------------------------------------------------------------------------------------------------------------------------------------------------------------------------------------------------------------------------------------------------------------------------------------------------------------------------------------------------------------------------------------------------------------------------------------------------------------------------------------
----------------------------------------------------------------------------------------------------------------------------------------------------------------------------------------------------------------------------------------------------------------------------------------SSSSSSSSSSSSSSSSSSSSSSSSSSSS-----------------------------------------------------------------------------------------------------------------------------------------------------------------------------------------S------------------------------------------------------------------------------------------------------------------------------------------------------------------------------------------------------------------------------------------oo----------------------------------------------------------------------------------------------------------------------------------------------------------------------------------------------------------------------------------------------------------SSSSSSSSSSSSSSSSS?SSSSSSSSSS---------------------------------------------------------------------------------------------------------------------------------------------------------------------------------------------------------------------------------------------------------------------------------------------------------------------------------------------------------------------------------------------------------------------------oo-------SSSSSSSSSSSSSSSSS?SSSSSSSSSSSSSSSSSSSSSSSSSSSSSSSSSSSSSS----------------------------
------------------------------------------------------------------------------------------------------------------------------------------------------------------------------------------------------------------------------------------------------------------------------------------------------------------------------------------------------------------------------------------------------------------------------------------------------------------------------------------------?--o--E--E----------------------------------------------------------------------------------------------------------------------------------o---------------------------------------------------------------------------------------------------------------E--E----------------------------------------------------------------------------------------------------------------------------------------------------------------------------------------------------------------------------------------------------SS------------------------oS----------------------------------------------------------------------------------------------------------------------------------------------------------------------------------------------------------------------------------------------------X-----------------------------------------------------------------------------------------------------------------------------------------------Q---------------------XXXX-------SSSS-------------------------SSSS------SSSSSSSSSSSSS-SS----------------------------
------------------------------------------------------------------------------------------------o--------------X-------------------------------------------------------------------------------------------------------------------XX-------------------------------------------------------------------------------------------------Eoo------------------------------------------------------------------------------------------------------------------------------------------------------------XXXXXXX----XXX--------------------------------------------------------------------------------oo------------------------------------------------------------------Eooo---------------------------------------------------------oo--oo---oo--oo--------XXXXXXo------------------------------------------------------------------------------------------------------------------------------------------------------------------------------o-------------------------------------------------------------------SS-------------------------SE--------------------------------------------------------------------------------E-----------------------------------------------------------------------------------------------------------------------------------------------------------------------------------------------------------------------------------------------------------------------------------------------------------oo------------------E------------------SSSS--------------------------SSSS--E---SSSSSSSSSSSS-SSS----------------------------
--------E------XXX-----oo-------------------------------------SSSSS-----------------XX--------------E------------------------------SS-----E-----------------QQ--------------------QQQQ--------------------------------------------------------------------------------------------------------------ooooooo-----ooooQ-----------------XXXXX-------------------------------------------------------------------------------------------------------E----ooo----------------------------------X------------------------------SSQS-----------------SSSS----------------------------------------------XXSXS-----------------------------------SSS--------------------------XXXXX---------X-o------------------------------------o-------XX-----------------------------------E---------------------------------------------------------------------------------SSSSS-------SS-S------------SSSSS-----------------SSSS---------------------------XXX------SS---------------SSSS-----------------SSS-----------S---?--------------------oooo------SSSSSS---------------------?SSSS----------------------------------------------------SSSS---------------------------------------------S----------------------------------------------------SSSSSSSSSSS-------------------------XX--------E---SSSSSS--------------------------------------X?---------------------SSSS---------------------------------SSS------------------QQQQ-----XXooo-XXXX-------------------------E--E-----------------SS---SS---o-oooo---SS-oooo---S-----------------S----SS----------------------------
-------<>---------------------------------------------------------------------------------------------XXX-------------------oo-----SS----<>------------------------------------------------------------------------------------------------------------------------------------------------------------------------------------------------------------------------------------------------------------------------------------------------E--o------------------------ooooo----------------------E------------oo-----o-----------------------------------------o-------------------------------------------------------------------------------------------------------------------------------------ooo---------------------------------------------------------------<>--------------------------------------o---------------------------------------------------------------------------------------------------------------X-------------------------XX--------------------------------------------------------------------------------SS------------------------------------------------------------------------------------------------------------------------oooo------------------------------------------------------------------------------------------------XX--------------------------------------------------------XX------------------------------------oooo-------------------------------------------------------------------------------------XXXXXX-------------SS-----------------SS-------------SS-----------S----SS----------------------------
-------[]-----------------------------------------------XX-----------o-------------------------------------------------------------SS----[]------------------------------------------------------------------------------X--------------------------------------------------------------------------SSSSSSS---S-SSSS-----------------------------------------------------------------------------X---------------------------------------XXXXXXX-------------Eo-------------------------------XXXXXX--------------------------------------------------o-----------------------------------------------------------------------------------------------------------------------------------------------------------------------------------------------------------------[]--------------------------------------------------------------------------------------------------------------------------------------------------------------------------------o-----------------------------------------------------------------------SSSSS------S----------------E-------------------------------------------------------------------------------------------XX------------------------------------------------------------------------------------------------------------X-XX---oX---------------------------------------------------XX------------------------------------------------------------------------------------------------------------------------------------------------SS---S----S-SSSS-SSSS-SS-S---------------------S----SS----------------------------
-------[]---------------------------------------------------------------------------------XX-------------XXXXX------------E--------S-----[]o---------E---------------------E---------------S---------------------------------o----X----------------------------------------E----------XX-----------SSSSSSSS---SoS--S----------o---------------------------------------------oo----o--------------X--ooo-----E------<>-------E--------------------------------------------------------------------------------E--o----ooo-------------X-E-X--------------------E-------------------------oooo-----------------------------------------ooo-SSSS----------E--S-SSSSSS--E------------------XX-----------------------------E------------------------XX--------XXXX-----------[]-------SSS------o-----------------------------------------------oo---------------------------X---------E---------------------E---------------------E------SSS---------------------S------------------------E------------------------------------------SoSQ-SS------S-XE------------<>---------------------------------E-----------E--------ooo---------------------------------XXX-----------------oo------------X-------------------S--------------------------------------------------------XXXX----S---------------------------------------------E----XXX------o-------------------------------------------------EX--------------------------------------------------------------------------------XXX-ooSS---So---SoS--SoS--SoS?-----------------ooooooS---oSS----------------------------
--E--SS[]SS--------------XXX--Q---------------------------X--XX--SSSSS----X--X------XX---------XXXX----------------------<>--------SS----[]S--------<>-----QQQQ-----------<>---QQ?SSSS---E----E--S----------------------XX----------------------------------QQQ-----------<>---------XXX----------------------SSS--S-------------------------------Q-Q----------------<>---Q---------------------X---------<>------[]------<>----SQQ--XX-------ooo----XXXXXXX---------------------------XXX-----------------<>------------ESQS------XX--XX----S-----SS-------<>-----------------S--------------XXXX-SSS---------------------------------------S-------<>------------E-------XX------------------------------E-------E<>--------------XXX--------------------------------XXS----------------------------------X---XX--------------------------------------------S------XX---E----<>-----QSQS-----------<>------S-S-----------<>----------------XXXXX--SS--------E--------------------<>-----SSS---------QQQQ--QQQ----------------SSS--SS---X--SSSXS--------E--[]-----------SS-----------SSS-----<>---QQ?Q---<>-----E---------------S---------------------XXXX-SX-----------E----S----------XXX-------Q--QS---------E-------SS-------XX--X---SSSSSS-----------------------XXXX-SS-S---SQQ--SSQSS------X-----------E------------<>---EXXX-----------------X-----------X-------------------------<>X----------------------QQQ---------XXXXXX---------------------XXXXXXX-----------------SSSS--SS---SSX--SSS--SSS-------SS---------SSSSSSS---SSS-E-------------Q------------
-<>----[]-------E-----------E-----------XXXX?------------XXX-----EE------XX--XX------------------------------------------[]--------------[]S--------[]---E----------------[]------------<>---<>-------------------------XX-------------E----------------------------------[]--------XXXX------------------------------------------------------------------------------[]-------------------E-----X---------[]------[]------[]--------------------E-------------------E------E----------XXXX--------------E--[]---------------------XXX-XXX-------------------[]------X------------------------------------------XXXXXX-?---E--------------------------[]---------------------------------------------------<>------<>[]----------------------------------------E--------------------E-----------XXXX?-------XXX------------------------------------------------------XXX--<>----[]--------------------[]-----------E--------[]-----E---E-------------------X--<>-----------E--------[]---------------------------------------XX--------E--X---SS----E----<>--[]--------------------------------[]----------[]----<>---------E-E------------------------XXXXX-SXX----E-----E--------------XXXX--------------------<>-------E------XXXX--XX-----------------------------XXXXXX-------------E----------XX---------<>------------[]--<>XXX-----------------X----------XX-------------------------[]X---------------------------------------------------------------------------------------------XX---------------E---------------------------------------------------------
-[]----[]------<>------------------------------------X---XXX------------XXX--XXX-------o---------------------------------[]--------------[]S--------[]--------------------[]------------[]---[]-------------------------XXX-----------<>----------------------------------[]----<>-XXXXX------------------------------------------------------------------------------[]-------------------X-X-X-X---------[]------[]------[]-------------XXXXXXXXX-----------oo----<>-----<>---------XXXXX-------------<>--[]-------------------XXXXX-XXXX------------------[]----------------------------------------E---o--------------<>--------------------------[]-----------XX--------------------------------------[]------[][]------------------XX-------------------<>-------------------------------------------XXX-----------------------------------------X---X--------XXXXo-[]----[]--------------------[]----------<>--------[]----<>--<>------------------XX--[]----------<>--------[]---------------------------------------XXX----------X---SS---------[]--[]-------------------------------->-----------[]----[]--------<>-------------------------XXXXXX-SXX---<>----<>-------------XXXXX--------------------[]-------------XXXXX--XXX----------------------------XXXXXX------------------------XXX--------[]------------[]--[]XXX-----------------X---------X-X---<>--------------------[]X-----------------------------------------XX------------------------XXXX---XXXXX-------------XXX-X-----------------------------------------------------------------------
-[]----[]------[]------------------------------------X---XXX-----------XXXX--XXXX-----XX--------------------------E------[]--------------[]S-EE-E---[]-----------E--------[]------------[]---[]-------------EE----------XXX-----------[]----------------------------------[]----[]-XXXXX---------------------------------------------------------------E--------------[]-------------------XXX-XSX---------[]------[]------[]---------------------------------XX----[]---E-[]--E-----XXXXXX-------------[]--[]-----------E------XXXXXX-XXXX--EE-----E--E-----[]------------E------------------------------XX--------------[]--------------------------[]----------XXX---------X----------------------E-----[]------[][]-----S-XXXXXX---------------------E--E-[]------------------------------------------XXXX---------------------------------E-----E-E-E-X-------XXXXX--[]----[]--------------------[]----------[]---X----[]----[]--[]-----------------XXX--[]----------[]--------[]---E----------------------------EE---E-XXXX--E-E----X---SX---EE-E--[]--[]--------------------E--E--------------------[]----[]--------[]---------------EE-E-----XXXXXXX--SXE--[]-E--[]------------XXXXXX----E-EE-------E----[]-E----------XXXXXX--XXXX-------XX-------------E---XXXXXXX------------------------XXXX----E--[]-E-E-----E--[]--[]XX--------------X---X-----------X---[]----E---------------[]X----------------------------XXXXX-------------------------o---------------------------EE---XXXXXE------------E------------------------E-------------------------E-------
-XXXXXXXXXXXXXXXXXXXX-------XXXXXX---XX-----XXXXXXXXXX---XX-----XXXXXXXXXXXXXXXXXXXX----------------------------XXXXXXXXXXXXXXXXXXXXXXXXXXXXXXXXXXXXXXXXXXXXXXXXXXXXXXXXXXXXXXXXXXXXXXXXXXXXXXXXXXXXX---XXXXXXXXXXXXXXXXXXXXXXXX--XXXXXXXXX-XXXXXXXXXXX---X-XXXXXXXXXXXXXXXXXXXXXXXXXXXXXXXX--XXXXXXXXXXXXXXXXXXXXXXXXXXXXXXXXXXXXXXXXXXXXXXXXXXX-XXXXXXXXXXX-XXXXXXXXXXXXXXXXXXXX--XXXXXXXXX--XXX------XXXXXXXXXXXXXXXXXXXXXXXXXXXX----------------------------XXXXXXXXXXXXXXXXXXXXXXXXXX---------XXXXXXXXXXXX-XXXXX--XXXXXXXXXXXXXXXoXXXXXXXXXXXXXXXXXXXXXXXXXXXXXX---XXXXXXXXXXXXXXXX--XXXXX---XXXXXX---XXX---------XX-XXXXXXXXXX----XXXXXXXXXXXXXXXXXXXXXXXXXXXXXXX-XXX---------------------XXXXXXXXXXXXXXXXXXXXXXXXXXXX----------------------------XXXXXXXXXXXXXXXXXX-XXXX-----XXXX----XXX-----XXXXXXXXXXX--------X----XXXX--X--------X--X-XXXXXXXXXXXXXXXXXXXXXXXXXXXXXXXXXXXXXXXXXXXXXXXXXXXXXXXXXXXXXXXXXXXXXXXXXXXXXXXXXXXXXXXXXX-XXXX------XXXXXXXXXXXXXXXXXXXXXXXXXXXXXXXXXXXXXXXXXXXXXXXXXXXXXXXXXXXXXX---XXXXXXXXXXXXXXXXXXXXX--XXXXXXXXXXXXXXXXXXXXXXXXXXXXXXXXXXXXXXXXXXXXXXXXXXXXXXXXXXXXXXXXXXXXXXXXXXXXXXXXXXXXXXXX-o-XXXXXXXXXXXXXXXXXXX--XXXXXXXXXXXXXXXXXXXXXXXXXXXXXXXXXXXXXXXXXXXXXXXXXXXXXXXXXXXXXXXXXXXXXXXX--XXXXXXXXXXXXX----XXXXXXXXXXXXXXXXXXX-XXXXXXXXXXXXXXXXX----XX-XXXXXXXXXXXXXXXXXXXXXXXXXXXX-XXXXXXXXXXXXXXXXXXXXXXXXXXXXXXXXX--XXXXXXXXXXXXXXXXXXXXXXXXXXXXX---XXXXXXX---XXXXXXXXXXXX-------------------------------XXX------------------------XXXXXXXXXXXXXXXXXXXXXXXXXXXXXXXXXXXXX---XXXXXXXXXXXXXXXXXXXXXXXXXXX---XXXXXXXXXXXXXX