------------------------------------------------------------------------------------------------------------------------------------------------------------------------------------------------------------------------------------------------------------------------------------------------------------------------------------------------------------------------------------------------------------------------------------------------------------------------------------------------------------------------------------------------------------------------------------------------------------------------------------------------------------------------------------------------------------------------------------------------------------------------------------------------------------------------------------------------------------------------------------------------------------------------------------------------------------------------------------------------------------------------------------------------------------------------------------------------------------------------------------------------------------------------------------------------------------------------------------------------------------------------------------------------------------------------------------------------------------------------------------------------------------------------------------------------------------------------------------------------------------------------------------------------------------------------
------------------------------------------------------------------------------------------------------------------------------------------------------------------------------------------------------------------------------------------------------------------------------------------------------------------------------------------------------------------------------------------------------------------------------------------------------------------------------------------------------------------------------------------------------------------------------------------------------------------------------------------------------------------------------------------------------------------------------------------------------------------------------------------------------------------------------------------------------------------------------------------------------------------------------------------------------------------------------------------------------------------------------------------------------------------------------------------------------------------------------------------------------------------------------------------------------------------------------------------------------------------------------------------------------------------------------------------------------------------------------------------------------------------------------------------------------------------------------------------------------------------------------------------------------------------------
----------------------------SSSSSSSSSSSSSSSSSSSSSSSSSSSS--------------------------------------------------------------------------------------ESSSSSSSSSSSSSSSSSSSSSSSSS--------------------------------------------------------------------------------------------------------------------------------------------------------------------------------------------------------------------------------------------------------------------------------------------------------------------SSSSSSSSSS--SSSSSSSSSSSSSSSS----------------------------------------------------------------------------------------------------------------------------------ooo-----------------------------------------------------------------------------------------------------------------------------------------------------------------------------------------------------------SSSSSSSSSSSSSSSSSSSSSSSSSSSS----------------------------S--SSSSSSS--------------------------------------------------------------------------------------------------------------------------------------------------------------------------------------------------------------------------------------------------------------------------------------------------------------------------------------------------------------------------------------------------------------------------------------------------------------------------------------------------------------SSSS-----SS-----------------------------------------------------------------------------------------------------
------------------------------SSSSS--SS--SSSS--------------------------------------------------------------------------------------------------SSSSSSSSSSSSSSSSSSSSSSSSS-----------------------------------------------------------------------------------------------------------------------------------------------o----------------------------------------------------------------------------------------------------------------------------------------------------------------------------------------------------------------------------------------------------------------------------------------------------------------------------------XXXX---------------------------------------------------------------------oo--------------------------------------------------------------------------------------------------------------------------------------SSSSSSSSSSSSSSSSSSSSSSSSS--------------------------------------------------------------------------------------------------------------------------------------------------------------------------------------------------------------------------------------------------------------------------------------------------------------------------oo---------------------------------------------------------------------------------------------------------------------------------------------------------------------------------------------------------------------------S-----Q--------?-------oS------------------------------------------------------------------------------------
------------------------------SSSSS--SS--SSSS---------E-------------------------------------------------------------------------------------X--SSSSSSSSSSSSSSSSSSSSSSSSS------------------------------------------------------------------------E---------------------------------------------------------------------------------------------------------------------------------------------------------------------------------------------------------------------------------------------------------------------------------------------------------------------------E-------------------------------------------------------------------------------------o-----------------------------------------------------------------------------------oo-------------------------------------------------------------------------------------------------------------------SSSSSSSSSSSSSSSSSSSSSSSSS------------------E-----------------------------------------------------------------------------------------------------------------------------------------o-----------------------------Eooo-------------------------------------------------------------------------------------------------------------------------------o----------------------------------------oooo----------------------------------------------------------------------------------------------------------------------------------------------------------------------------S------------------------S------------------------------------------------------------------------------------
----------------------------S--SSSS---S----------E----S-------------E--S-----------------------------------------------------------------------SSSSSSSSSSSSSSSSSSSSSSSSS---------------------------------------S------------------------------SSSS------SSSS---------------------------------------------SSS----SSSSSSSS------------SSSSSS------------------------------------------------SSSSSS-----SSS------------QQQQ-----?SSS-------------------------------Q?SSS---?--SSSS--S---?--------oS---------Q-Q----------------------------------------Q?SSSQS---------------SSSSSS--------------------------------------------------------SSS-----------oo-----oo-----------------------------SS--S?SSS---------------------------------XXX-----oo------------------------------------SS---S?--?SSS---------Q-----------------------E-------------------------SSSSSS---SSSS--SSSSSSSSSSSSSSSSSSSSSSSSS-SQS-------------SQSSSSS---------------------------SSQQQ-------------------------SSS-----------SSS---------------------------------------XXX----------------------------------------------XXXXX-----------S----SSS--------------SSSS-------E--------?-----------------------SS---------------------------SSSSS---SS---------XXXX-----XX-------------------------------XXXX-----------------------------------------SSS-------------S---------------------SSSSS--------------------------SSSS--------------------------SS----------------------------------SS---------S---S-----------S---?SSS-------------------------------------------------SQ--------------------
------------------------------------------------------S---E--------<>--------------------------------------------------------------ooo-------------------------------------------------------------------------------------------------------------------------------------------------------------------------------------------------------------------------------------------------------------------------------------------------------------------------------------------------------------------------------------------------------------------------------------------------------------------------------------------------------------------------XXXX------------------------------------------------------------XXX------------------------------------------------------------------S----------------------------<>--------------------------------------------------------------------------------------------------------------------------------------------------------------------------------------------------------------------------------oooo------ooo--------------------------------------------------------------<>-----------XXX------------------------------------------------------------XXXX----------XXX----------------------------------------E--E--------------oooo-------------------------------------------------------------------------------------------------------------------------------------------------------------------S-------------------------------------------------------------------------------------------
------------------------------------------------------S--<>--------[]--------------------------------------------------------------------------S----------------------------------------------------------------------------------------------------------------------------------------------------------------------------------------------------------------------oo-----------------------------------------------------------------------------------------------------------------------------------------------------------------------------------------------------------------------------------------------------------------------------------------------------------------------------------------------------------------------------------------------------------------------E---------------------------------[]-----------------------------------------------------------------S-----------------------------------------------------------------------------------XX----------------------------------------------------------------------------------------------------------------------------------------------------[]---------------------------------------------------------------------------------------EEXX-------------------------------------XXXXXXX-------------------------------------------XSS--o------------------------------------------------------------------------------------------------------------------------------------SS------------------------------------------------------------------------------------SSS--o
-----------E-----------oo-------------------?----So??-So-[]--------[]----------------S-SSS-------------------E-------------------E--------------------------------------------------------------------------------------------------------E--E------------------------------------------S--------E---------------SSS----------E---------------------------------------------------E----------------------------------------------------E------------------------S-S---------------------------------------------------------------------------------E---------------------SSSSSS-----E---------------E---------------------------------------------------------------SS--------------------SSSSSS--------------------------------------------------------oo----o----------------------------------------o----------S-------------]----------------------------------------------------ooo-ooo-o-o------------------------------------S--------------------------------------------------S------------------------------------------------------S---------E-------E---------------------oo---oo--------------------------------XS--------------[]-------------------SQS--------------------------------E-------------------------------XXXXX--------------oo--------------------X-------------------E-----------------------------XXX-------------E--S------E--<>-----------------oo---------------------------------E----------------------------------X-------S----ooo---?-SS--------------------------------------------------------E---------------------------XX--o-
----------<>------E-------------S----------SS?---SSS--SS-[]-------SXXS--------------------------S----X------<>---------------E--<>---------------SS--S---------SSSSSSSS-----------------------E--S--S----------Q-----------------S----E--<>---------ES-------------------------------------E----<>-----QQQQ--S---------------<>--------S-S-----X--------------------SSS----------<>---E---S------S----E-------------QQQQ--------------<>-------QS------------------SSE---------QQQQ--Q--------SSSS------EQQQ--------------XX------------------------XS--S?S-------------------------<>--------------<>----------------------XXX-------------------XXXX--XXXX----XXX-Q------------------------------E-----Q--Q--Q-QQ--S-------------------------------------------------------X-----------Q--QS?S----E-------Q--o-----------S-------------------------------------------X------S-SS--E?SSSSSSSSSSSSS-SSSS-------------S----X----X--------E--------------SSSSS-----------E--S----------------QQQQ--------------------------E-------------------------E----<>---E--<>-----------Q-------------------S?S-------QQ-Q----QS--------XXX-XX-----X----SXXXS-Q--Q------------------------------------X---------<>--------SSS-------------------XXXXXX-----------------------------------EX------------------<>----------------------------XXXX-SS---------<>-----E--<>--[]--------------E---------------S--<>----------------<>----E?S----------------S---------XX----------E---------------SS---QQQQ--SQQ-------------------------------S-----<>-----QQQ----SS------------XXX---E
----------[]----E<>--------------------------XXX---------[]-------------E---------E------------------Q--XXX-[]--------------<>--[]-----------EE------oXoo--------------------------------<>--<>------------------------------E-------<>--[]--------<>-------------------------------------<>----[]---------------------------[]--------E------XX---------------------------X-----[]--<>--------------<>-------------------------------[]--------------------------------------------------------------------------------------------------------------------------------------------[]--------E-----[]-----------------------------X-XXX----------------------------------------------------------<>-------------------------------------------------------------------------X---------------------<>-----------------------------------------------------------E-----XX--------SS---------------------------XX--------E--E-E--X-------<>-----------E--E--------------<>----------------------------------X-------------<>------------------------<>----[]--<>--[]----------------------------------------------------------XXXX-XX-----X---------------------------------XX---X----------XX---------[]-----------------------------XXXXXXX-------EX------------------E------XXX------------------[]---------------------------XXXXX------------[]----<>--[]--[]-------------<>------------------[]----------------[]----------E---------------------XXX---------<>------------E-----------------------------E-----------------------[]--E---------------------XXXXX----
----------[]---<>[]--------------------SSS---------------[]------------<>--------<>------------------X--XXX-[]--------------[]--[]----------------------X---X----------------------------[]--[]-----X--------------------<>-<>-------[]--[]--------[]----<>-------------------X---X-------[]----[]---------------------------[]--------------XXX---------------------------X-----[]--[]--------------[]-------------------------------[]---------------------------------------------------X---------------------------------XXXX---------------------------------------------XX----[]-------<>-----[]--------------------------XXX----------------------------------------------<>---------------[]-----------------------X-------------------------------------------------X---------------------[]----------------------------X-----------------------------<>-----XX--------SS--------------------------XXXX---------------X-------[]---X---X--<>-----------------[]-----------------------------E----X-------------[]------------------------[]----[]--[]--[]---------------------------------------------------------XXXXX-XXX----X--------------------------------XXX---X---------XXX---------[]----------------X-----------XXXXXXXX-------XX-----------------<>-----XXXX------------------[]--------------------------XXXXXX--S---------[]----[]--[]--[]-------------[]------------------[]----------------[]-------------------------------XXXX---------[]-----------------------------------------<>-----------------------[]-<>---------------------XXXXX----
----E-EE--[]---[][]----------------------------------E---[]------------[]--------[]----E----EE-------XE-XXXX[]-E------------[]--[]--------EE------------X-E-X-------------------E--------[]--[]-----X----EE-E------E-----[]-[]----E--[]--[]-E------[]----[]-----EE-E----------X-E-X-------[]----[]------------------E--------[]-------------XXXX------------E-E-----------XX--E--[]--[]--------------[]-------------------------------[]--E-E-----E-EE---------X-E-----------------E-EE-E-XX------------------------EE------------------------------EE-E---------------------XXX-E-E[]-----E-[]-----[]-------------------o---------------------ooo-------------------------------[]-----X---------[]-----------------E----XX------------------------------------E-------EE---X----E-------------E--[]----------------------------XE------------EE----X-E-------[]------X-------E------------E-E-----E------XXXXX-----E----X----X--E----[]---X-E-X--[]----------E-EE---[]----------E-E-E------------------------EE-------[]------------------------[]----[]--[]--[]------------------------------------XX------E-----------XXXXX--XXXEE--X------E---------------E--------XXXX---X--------XXXX---------[]-E-EE----------XX----------XXXXXXXXX------XXX-----------------[]----XXXXX------------------[]-------E-------------E---XXXXXXX--S--EE-----[]----[]--[]--[]-------EE-E--[]----------EE-E----[]----E--E-E------[]---------------EE-E--E--------XXXXX---EE-E--[]----------------------E-E----------------[]-------E-E-------E-----[]-[]--------------------XXXXXX----
XXXXXXXXXXXXXXXXXXXXXXXXXXXXXXXXXXXXX-----XXXXX--XXXXXXX-XXXXXXXXXXXXXXXXXXXXXXXXXXXXXXXXXXXXXXXXXXXXXXXXXXXXXXX---XXXXXXXXXXX--XX----XXXXXXXXXXXXXXXXXXXXXXXXXXXXXXXXXXX---XXXXXXXXXXXXXXXX-XXXXXXXXXXXXXXXXXXXXXXXXXXXXXXXXXXXXXXXXXXXXXXXXXXXXXXXXXXXXXXXXXXXXXXXXXXXXXXXXXXXXXXXXXXXXXXXXXXXXXXXXXXXXXXXXXXXXXXXXXXXXXXXXXXXXXX-XXXXXXXXXXXX--XXXXXXXXXXXXXXXXXXXXXXXXXXXXXXXXXXXXXXXXXXXXXXXXXXXXXXXXXXXXXXXXXXXXXXXXXXXXXXXXXXXXXXXXXXXXXXXXXXXXXXXXXXX-XXXXXXXXXXXXXXXXXXXXXXXXXXXXXX--XXXXXXXXXXXXXXXXXXXXXXXXXX------------XXX--------XXXXXXXXXXXXXXXXXXX---XXXXXXXXXXXXXXXXXXXXXXXXXXXXXXXXXXXXXXXXXXXXXXXXX---XXX-------------------XXX------------------XXXXXXXXXXXXXXXXXXXXXXXXXXXXXXXXXXXXXXXXXXX-XXXXXXXXXXXX----XXX-XXXX-----XXX--------XXXXXXXXXXXXXXXXXXXXXXXXXXXX---XXXXXXXXXXXXXXXXXXXXXXX--XXXXXXXXXXXXXXXXXXXXXXXXXXXXXXXXXXXXXXXXXXXXXXXXXXXXXXXXXXXXX--XX---XXXXXXXXXXXXXXXXXXXXXXXXXXXXXXXXXXXXXXXXX--XXXXXXXXXXXXXXXXXXXXXXXXXXXXXXXXXXXXXXXXXXXXXXXXXXXXXXXXXX---XXXXXXXXXX---XXXXXXXXXXXXXXXXXXXXXXXXXXXXX----------X-[]-XXXXXX-XXXXXXX-XXXX---XXXXXX-XXXXX---XXXXXXXXXX----X-XXXXXXXXXXX---XXXXXXX--XXXXXXXXXXXXXXXXXXXXXXXXXXXXXXXXXXXXXXXXXXXXXXXXXXXXXXXXXXXX-XXXXXXXXXXXXXXXXXXXXXXXXXXXXXXXXXXXXXXXXXXXXXXX--XXXXXXXXXXXX-XXXXXXXXXXXXXXXXXXXXXXXXXXXXXXXXXXXXXXXXXXXXXXXX----XXXXXXXXX--XXXXXXXX--XXXXXXXXXXXXXXXXXXXXXXXX-XXXXXXXXXXXXXXXXXXXXXXXXXXXXXXXXXXXXXXXXXXXXXXXXXXXXXXXXXXXXX-XXX-XXXXXXXXXXXXXXXXXXXXXXXXXXXXXXXXXXXXXXXXXXXXXXXXXXXXXXXXXXXXXXXXX--XXXXXXXXXXXXXXXXXXXXXXXXXXXXXXXXXXXXXXXXXXXXXXXXXXXX----XXXXXXXX---XX