-------------------------------------------------------------------------------------------------------------------------------------------------------------------------------------------------------------------------------------------------------------------------------------------------------------------------------------------------------------------------------------------------------------------------------------------------------------------------------------------------------------------------------------------------------------------------------------------------------------------------------------------------------------------------------------------------o?---------------------------------------------------------------------------------------------------------------------------------------------------------------------------------------------------------------------------------------------------------------------------------------------------------------------------------------------------------------------------------------------------------------------------------------------------------------------------------------------------------------------------------------------------------------------------------------------------------------------------------------------------------------------------------------------------------------------------------------------------------------------------------------------------------------------------------------------------------------------
-------------------------------------------------------------------------------------------------------------------------------------------------------------------------------------------------------------------------------------------------------------------------------------------------------------------------------------------------------------------------------------------------------------------------------------------------------------------------------------------------------------------------------------------------------------------------------------------------------------------------------------------------------------------------------------------------?-S--------------------------------------------------------------------------------------------------------------------------------------------------------------------------------------------------------------------------------------------------------------------------------------------------------------------------------------------------------------------------------------------------------------------------------------------------------------------------------------------------------------------------------------------------------------------------------------------------------------------------------------------------------------------------------------------------------------------------------------------------------------------------------------------------------------------------------------------------------------------
---ooo----------------------------------------------------------------------------------------------------------SSSSSSSSSSSSSS-------------------------------------------------------------------------------------------------S-------------------------SS---------------------------------------------------------SSSSSSSSSSSSSSSSSSSSSSSSSSSSSSSSSSSSSSSSSSSSSSSSSSSSSSSS-----------------------------------------------SSSSSSSSS------------------------------------------------------------------------------------------------------------------------------------------------------------------------------------------------------------------------------------------------------------SSSSS--Q----------------XSSS--------------------------------------------------------SSSS---------------------S--------------------------------------------------------------oo-------------------------ooo--------------------------------------------------SSSSSSSSSSSSSSSSSSSSS-------S-ESSSSSSSSSSSSSSSSSSSSSSSSS-----oo-------------------------------------------------------------------------------------------------------------------------------------------------------------------------------------------------------------------------------------------oo----------------------------------------------------------------------------------------------------------------------------------------------------SSSSSSSSSSSSSSSSSSSSSSSSSSSS----------------------------------------------------------------------------------------------------------------
---XXXX-----------------------------------------------------------------------------------------------------------------------------------------------------------------------------------------------------------------------oS----------------------------------------------------------------------------------------------------------------SSSSSSSSSSSSSSSSSSSSSSSSSSSS----------------------------------------------------------------------------------oo--------------------------------------------------------------------------------------------------------------------------------------------------------------------------------------------------------------------------------SSSS-------------------------------------------------------------o--------------------------------------------------------------------------------------------------------------E--E-------------------XXXX--------------------------------------------------------------------------------SSSSSSSSSSSSSSS--------------XXX-----------------------------------------------------------------------------------------------------------------------------------------------------------------------------------------?-----------------------------------Q-----------------------------------------------------------------------------------------------------------------------------------------------------------------------------------------------------------------------------------------------------------o---------------------------------------------------
------------------------------------------------------------------------------------------------------------------------------------------------------------------------------------------------------------------------------------------------E-----------------------------------------------------------------------------------------------SSSSSSSSSSSSSSSSSSSSSSSSSSSS-------------------------------------------------------------------oo--------------X--------------------------------------------------------------------------------------------------------------------------------------------------------------------------------------------------------------------------------SSSS------------------------------------------------------------------o--oooooo------------------------------------------------------------------------------------------------XXXXXXX-----------------------------------------------------------------------------------------------------SSSSSSSSSSSSSSo--------------------------------------------------------------------------------------------------------------------------------------------------------------------------------------------------------------X------------------------------------oo---------------------------------------------------------------------------------------------------------------------------------------------------------------------------------------------------------------------------------------------------------------------------------------------------------
-------------------------------------------------SSSSSS-----------------------------------------------------QQQQ---------------------SSS------XXoo--XXXX-----------------SSS---SS---S-Q--S-----S----SS?---------------------SS?-----S---------SSQSSSQ?----------SSS---?SSS--------------------------SS-------------------------------------S----SSSSSSSSSSSSSSSSSSSSSSSSSSSSSSSS----------------S-------Q--------------------?------XX-----------------------------?-------------S---SSSS--S---SSS------SSSSSSSSSSSS------------------------------------------------SQS---SSS---------------------------------S---SS--------------------SSSSS------------------------------SS-------XX------------SS---S---oo-------------SS------------QQQQ-----------------oo---XXXX-----XXX-----oQQQ--------------SSSSSS---------------------------------------------------------------------------------------------------------SS--SSSS-------------------------------S-------------------------------SSSSSSSSSSSSSSS-------------------------------------E-------SSS----------------------------------------------SSSSS-------------------------------------------------------------------------------SS-------SSS-----E--?-------SSSSSS--?-------Q-Q--Q-QQ----E--o---XXXX-------------------S----XXX-----------------SSSS-------------S---SSS------------------------------------------------------------S----------------SSSSS---SSQ----------------------------S-SQS-----S---SQQSS--?SSS---SS----------------SSSS----SQ--SSS------XXX-------------o-----------------SSSSSSS----
-------------------------------------------------------------------------------------------------------------------------------------------------------------------------------S----S---------------ES----------o-----------SS--------------------------------------------------------------------------X-------------------------------------------------------------------------------------------------------------------------------------------XXX------------------------------------------------------------------------------------------------------------------------------------------------------------------------------------------------------------------------------X------------SS---S------------------------------------------------XX------------E-----------XX-----------------------------------------------------------------------------------------------------oooo-------------------------------------------------------------------------------------------------------------------------E-------------------------------------------------------------------------------------------------------------------------------------------------------------------------------------<>----------------------------------------XXXX--------------XSS-----------------------------------------------------------------------o---------------------------------------------------------------------------------------------------------------------------------------------------------------XXX----------X----------XX----------------------------
--------------------------------------------------------------------------------E---------------------------------------------------------------------------o---XX-------------S----S-S-------------------------------S-----SS-----------------------------------------------------------------------EXX-------------------------------------------------------------------------------------------------------------------------------------------oo----XXX----------------------------------------------------------------------------------X--------------E-------------E-----------------------------------------------------------------------------------XXXX-----------------EXX-----------SS---S----------<>---E---------------------------------------------<>-------------------------------------------------------------------------------------------------XXXXXXX----------------------------------------E-----------------------------------------------------------------------------------------------------------------------SX-------------------------------------------------------------------------------------------------------------E-----------------------XXS-------------------[]---------------------------------------------------------XXX----------------------------------S------------------------------------XXX---X---------------------------------------X----------------------------------------E-------------------------------------------------------------------------------------------------------------------------------
---------------E------------------------------------------E-----E--------------<>-----------E--o-------------------------------oo---------X----------------------X--oo---------SS---SoS--------------S--------E-----SSS-----SS-S----------------------------S------------------------E--------------XS-------------------------oo----------E-----E-----------?------ooooo----------------------------------------S-----------------------XX----------------------SQSQ-------S-----------------------------------------------------------------X-----S-------<>------------<>---------SS------------------E---------------------------S---------------------------------------------E-XX---------XoSS---So----o----[]--<>------------------------------E--------------[]----------------------------------E-E---------------oo------------------------------------------------------------------------S-------E--S--E--<>--------------------------------------oo-------------------------------------------------------------E--S--E----------------------------------------------------------SSSSSSS---------------------------------------------E-------E--<>--------o----------EX-XXX--------------------[]------------EE-----EE-E--?------------------------------XXXS--------------------------------------------------------------------------------------------------------------------XX------------E---------------------E----<>--------E--------------------------------------------------------------SSSS-S-------------------------------------------EEE----
-Q------------<>--------XX-X----------<>----QQQ--Q-Q-----<>----<>-------E------[]---X------<>--------------SSSSS----------------Q--------XXX------XXXX-----------X-------------SS---SSS----SS---ESS-SS-------<>------SS-----SSSS----X---------SSSSQSQS---------QQQQ--Q--------------<>-------------XXX-XX-------------------------------SSSSSS-------X--SSSSS??SSSSSSSSSSSS-----------XXS-----------Q---SS-----E--------XXXX---S----XX------XXXXXX-----------------------------E--S-------SS---SSS------------?SSSS-------------------------XXX--------E----[]------SS-E--[]----------------------------<>------SSSS-----E--S--E---E--------SoQQo-------------------------------XX--XXX---------XSSS---SSS--------[]--[]----X----------<>-QQ--QQQS---<>--------------XXX----XXX-----SSSS----X---E-------SSSSSS-------E----------------------------------------QQQQ---------------------E---------------E----<>----<>--[]--------QQ-------------QQQ-------------------------------E--E?S-S---SS------------------Q--Q--------<>----<>---------X-------XX-----------XX---------Q-------------------------------E-----S------Q--QQ-Q--Q------------E<>------<>--[]------------------<>XXXXX-------------S?S----XXS---------SSSSSS--SSSSSS-Q--Q--QQQQ--Q-------XX--SS----XXXXX------------X-----------------------SSS------------------------------EXX------------------------------------------XXXX---QQQQ----<>-------ES-S-----S---<>----[]-------<>-------ESSS--E-----EESSSSS-S---------------------------S?QQQ?S--------------XXXXX----------oo-------XXX-X-----SSSSS--X
--------------[]-------XXXXX----------[]-----------------[]----[]------<>---E--[]---X------[]----------------------------E--------------XXXX--------------------SS-SS----------------------------------------[]---------------SS-E-XX-----------------------------------------------[]-----------XXXXX-XX----------------------------S--E---------EXXXX-XSSS---SS--------------X------------------------------<>-----------------------------------------S--------------------<>----------SS----------XXX-----------------------------------XXX-------<>----[]--------<>--[]-------E--------------E-----[]--------------<>----<>--<>----------------E--E-----------------------XXX--XXX---------X-----------<>----[]--[]----X----------[]------------[]----------------------------------E--E--------E-EE-------------------------------------------------------------E--------------E<>--------XX----<>----[]----[]--<>--------------------------------------------------------<>--------------E---------------------------[]----[]--------XXX----------------EX-XX---------------------------------------------------------------------------<>[]-----E[]----------------------[]XXXXX--------------------------------SSSSSS--SSSSSS------------------------------XXXXXX-SSS--------------------X-----------------------------------------XXXXXX-------------XXXXX-------E-------------XXXXXXX-----------[]------<>------------[]----[]-------[]--XXX-EE----<>----E--------------X-----------------------------------------------------------------XXXX-XX---EE------X
--------------[]------XXXXX-----------[]-----------------[]----[]------[]------[]---E------[]---------------------------<>-------------XXXXX-----------XXXX-----SS---S-----------------------------------XXX-[]--------------SSS--XXXX-------------------------------------X--------[]----------XXXXXX-XXX---------------------------------------oXXXXX--SSS---SS--------------X------------------------------[]------------------------o--------XX------X--------------------[]----------SS---------XXXX--X------------------------------X--XX-------[]----[]--------[]--[]------<>-------------<>-----[]--------------[]----[]--[]------------------------------------------XXXX--XXX---------X-----------[]----[]--[]----X----------[]------------[]------------------XXXX---XXX---------X---------------E--X-----------------------------------------------------<>-------------<>[]--------XX----[]----[]----[]--[]--------------------------------------------------------[]------------------------------------------[]----[]-------XXXX-------------------XXX--------------------------------------------------------------------------[][]----[][]----------------------[]XXXXX-------------------<>-----------SSSSSS--oSSSSS--------------------------E--XXXXXXX------------------------X-----------------------------------------------------------------------<>------------XXXXXXXX-----------[]------[]------------[]----[]-------[]--XXX-------[]-------------------X----------------------------------------------XXXX--------------XXXXX-XXX------E---X
-----------E--[]-----XXXXX-----EE-E---[]-----------------[]----[]------[]------[]----------[]--E-------------------EE-E-[]------------XXXXXX--Soo---------------SS-E------E-EE-E----------E-E-------E-EE-XXX-[]--------------ES--XXXXX---EE----------------X---------------X--------[]-E--E-E--XXXXXX--XXXX--------X-----------------------------XXXXXX-----oooSSS------E--E---X-------E----------------------[]E----------------------XXX---------------X---------E-------E--[]-E--------SS-E-E----XXXXXE-X--X---E-------E-----E----E-E-E---X--------[]----[]--------[]--[]------[]-------------[]--E--[]---E----------[]-E--[]--[]----E-----------------------EE-----------XXXXX--XXX---EE-E--X-EE--------[]-E--[]--[]-----------E---[]-----EE-----[]-----oo----XXXX------------XX--------X------------------X-----------------------------------------------------[]-------------[][]--------XXX---XXX---[]----[]--[]-------S------------------------------------------------[]----------------------------E-------E-E-E-[]----[]------XXXXXX------------------XXX---EE-----------------------S---------------------------EE----------------[][]----[][]-------------E-----E--[]XXXXX-------------------[]-----------SSSSSSSSSSSSS---------------SXSooo--------XXXXXXXX--SS?-------------------------E----EE------------------------X----------------------------E-E---[]-----------XXXXXXXXX-------E-E-[]------[]------X-----[]----[]-------[]--XXX-------[]-------------------X------------E-E------------------------XXX---------------------XXXXXX-XXXX-----Q---X
XXXX---XXXXXXXXXXXXXXXXXX---XXXXXXXXXXXXXXXXXXXXXXXXXXXXXXXXXXXXXXXXXXXXXX-XXXXXXXXXXXXXXXXXXXXXXXXXXXXX-XXXXXXXXXXXXXXXXXXXXXXXXXXXXXXXXXX---XXX---------------XS------XXXXXXXXXXXXXXXXXXXXXXXXXXXXXXXXXXX--XXX-XXXXXXXXXXXXXXXXXXXXXXXXXXXXXXXXXXXXXXXXXXXXXXXXXXXXXXXXXXXXXXXXXXXXXXXXXXXXXXXXXXXX--XXXXXXXXXXXXXXXXXXXXXXX---XXXX----XXXXXXXXXXXXX--X---XXXXXXXXXXXXXXXXXXXX-XXXXXXXXXXXXXXXXXXXXXXXXXXXXXXXXXXXXXXX-----XXX---X---------------------X--XXXXXXXXXXXXXXXXXXXXXXXXXXXX---XX-XXXXXXXXXXXXXXXXXXXXXXXXXXXXXXXXXXXXXXXXXXXXXXXXXXXXXXXXXXXXXXXXXXXXXXXXXXX-XXXXXXXXXXXXXXXXXXXXXXXXXXXXXXXXX-XXXXXXXXXXXXXXXXXXXXXXXXXXXXXXXXXXXXXXXXXXXXX--XXXXXXXXXXXX--XXXXXXXXXX-XXXXXXXXXXXXX-XXXXXXXXXXXXXXXXXXXXXXXXXX--XXXXXXXXXXXXXXXXXXXXXXXXXXXX--XX----------------------XXXXXXXXXXXXXXXXXXXXXXXX---XXXXXXXXXXXX-XXXXXXX-XXXXX---XXXXXXXXXXXXXXXXX---XXXXXXX---XXXXXXXXXXXXXXXXXXXXXXXXXXXXXXXXXXXXXXXXXXX-XXXXXXXX-XXXXXXXXXXXXXXXXXXXXXXXXXXXXXXXXXXXXXX----XXXXXXXXXXXXXXX--XXXXXXXXXXXXXXXXXXXXXXXXXXXXXXXXXXXXXXXXXXXXXXXXXXXXXXXX-------XXXXX-X--XXXXXXXXXXXXXXXXXXXXXXXXXXX--XXXX-XX-XXXXXXXXXXXXXXXQ--XXXXXXXXXXXXXXXXXXXXXXXXXXXXXXXXXXXXXXX----XX-XXXXXXXXXXXXXXXXXXXXX--XXXXXXXXXX-XXXXXXXXXXXXX--XXXXXXXXXXXXXXXXXXXXXXXXXXXX---X------XXXXXXXXXXXXXXXXXXXXXXX---X-XXXXX-XXXXXXXXXXXXXXXXXXXXXXXXXXXXXXXXXXXX---X-XXXX-----------------------XXXXXXXXXXXXXXXXXXXXXXXXXXXXXXXXXXXXXXXXXXXXXXXXXXXXXXXXXXXXXXXXXXXXXXXXXX--XXX-XXXXXXXXXXXXXXXXXXXXXXXXXXXXXXXXXXXXXXXXXXXXXXXXXXXXXXXXXXXXXXXXXXXXXX------------------XXXXXXXXXXXX--XXXXXXXXXXXX-X