------------------------------------------------------------------------------------------------------------------------------------------------------------------------------------------------------------------------------------------------------------------------------------------------------------------------------------------------------------------------------------------------------------------------------------------------------------------------------------------------------------------------------------------------------------------------------------------------------------------------------------------------------------------------------------------------------------------------------------------------------------------------------------------------------------------------------------------------------------------------------------------------------------------------------------------------------------------------------------------------------------------------------------------------------------------------------------------------------------------------------------------------------------------------E-----------------------------------------------------------------------------------------------------------------------------------------------------------------------------------------------------------------------------------------------------------------------------------------------------------------------------------------------------------------------------------------------
------------------------------------------------------------------------------------------------------------------------------------------------------------------------------------------------------------------------------------------------------------------------------------------------------------------------------------------------------------------------------------------------------------------------------------------------------------------------------------------------------------------------------------------------------------------------------------------------------------------------------------------------------------------------------------------------------------------------------------------------------------------------------------------------------------------------------------------------------------------------------------------------------------------------------------------------------------------------------------------------------------------------------------------------------------------------------------------------------------------------------------------------------------------------------------------------------------------------------------------------------------------------------------------------------------------------------------------------------------------------------------------------------------------------------------------------------------------------------------------------------------------------------------------------------------------------
---------------------------------------------------------------------------------------------------------------------------------------------------------------------------------------------------------------------------------------------------------------------------------------------------------oo-----------------------------------------------------------------------------------------------------------------------------------------------------------------------------------------------------------------------------------------------------------------------------------------------------------------------------SSSSSSSSSSSSSSSSSSSSSSSSSSSS-----------------------------------------------------------------------------------------------------------------------------------------------------------------------------------------------------------------------------------------------------------------ooo--------------------------------------------------------------------------------------------------------------------------------------------------------------------------------------------SSSSSSSSSSSSSSSSSSSSSSSSSSSS----------------------oo------------------------------------------------------------SSSSSSSSSSSSSSSSSSSSSSSSSSSS---------------oo------------------------------------------------------------------------------------oo-----------------------------------------------------------------------------------------------------------------------------------------------------SSSSSSSSSSSSSSSSSSSSSSSSSSSS
-----------------------------------------------------------------------------------------------------------------------------------------------------EE-EE----------------------------------------------------------------------------------------------------------------------------------------------X--------------------------------------------------------------------------------------------o------------------------------------------------------------------------------------------------------------------------------------------------------------------------------------------------------------------------------------SSSSSSSSS--SSSSSSSSSSSSSSS---------------------------------------------------------------------------------------------------------------------------------------------------------------------------------oo-----------------------------------------------------------------------------XXXXX--------------o------------------------------------------------------------------------------------------------------------------------------------------------oooS--------------------------SSSSS----SSSSSSSSSSSSSSSSS--------------------------E----------------------------------------------------------SSSSSSSSSSSSSSSSSSSSSSSS----------------------E--E---------------------------------------------------------------S----------------------------------------------------------------------------------------------------------------------------------------------------------------------------SSSSSSSSSSSS---------
------------------------------------------------------------------------------------------------------------------------oo--------------------------XXXXXXXX--------------------------------------------------------------------E----------------------------------------------------------------------------------------------------------------------------------------------------------------------------------------------------------------------------------------------------------------------------------------------------------------------------------------------E------------------Eooo------------------------------------SSSSSSSSSSSSSSSSSSSSSSSSSS----------------------ooo--------------------------------------------------------------------------------------------------------------------------------------------oo---------------------------------------------------ooo--------------------------------------------------------------------------------------------------------oo------------------------------------------------------------------------------------oooo------------------------------------SSSS-EE-SSSSSSSSSSSSSSSSS-------------oo--oo------XXX--------------------------------------------------------SSSSSSSSSSSSSSSSSSSSSSSS--EE------------------XXXXXXX--------------------oo---------------------------------------------oo------------------------------------------------oo------------------------------------------------------------------------------------------------------------------?SSSSSSSSSSSS---------
---?-------------SSSSSSS---------------------------------------------E-------------------------------------------------XXXX------XX---------o---------------------------------------------------------S------------------SSS---------------------------SSSSSSSSS----------S--SSSSS---S----oo----SQS------E-----oo---SS-------------------------------------SSSSSSSS-------------SQS---------XX----SSSS------------SQS-------------------------------------------------------------------------SSS----------SSS------SSSS-------------------?SSS-------------------------------SQ------------------XXXXX--------------------SSS-------------SS-SSS---SSSSSSSSSSSSSSSS---------------------XXXXX--E-----------------oo-------------SSS--?SSS--------------------S----SSSSSSS-----S---S----------------------------SSS------------------------------------XXXX-----------------------------------XXXX-----------QQQQ----------------S?--------------S---SSS---SS?SSS---?-SSSSS---------------XXX----XXXX------o-------------------------------SSS--SSSSS---------------QQQQQQ--?-----o-----XXXo---XXXX----o--SS---S----o----S---------S---S----SSSS-SSSSSSSSSSSSSSS-----ooo-----XXX---------------------------------------S----------------------------SSSSSSSSSSSSSSSSSSSSSSSS--SS-----------------X-------------Xoo--XXXX----------------------------------------------------XXX------XX--------------------SSS-------------S--------------------------------SSS---?SSS-------------------------SSS--SSS-------SS-------------------SSSSS---------SSSSSSSSSSSSSS--Q------
----------------------------------------------XX-----------o--------<>----------------E------------------------------------------XX------------------------------ooo---------------------------------------------------------------------------------------------------------------------------------XXX------------------oooo-------------------------------------------------------------XXX------------------------------------------------------------------o----------------ooo----------------------------------------------------------------------------------------------------------E------------------------------------------------------------------------------------------------------------------------------------------------------------------------------------------------------------------------------------------------X-XX------------------------------------------------X----------------------------E--------------------SS-----------------------------------------------------------XX--------------------------------------------------------XXXX-----------------------X-------------------------------S----SSS---------------S-XX---XX--------------------------------------------------------------------------------------------------S----SS----------------------------------------------------------------------------------------------------XXX-----------------------------------------------E---o-----------------------------------------------------------------------------------------------------------------------------
--------------------------------------------XXXX----------XXX-------[]--o------------<>------------------------------------------XX---------XXXXXXXX------------------------------------------------------------------------------------------------------------------------------------------------------------------------------------S------------------------------------------------EXXXX---------------------------------------------------------E--------XXXXXXX----------------------------------------------------------------------------------------------------------------------<>-----------------------------------------------------------------------------------------------E---------------------------------------------------------------------------------------------------------------------------------------------------------------------------------------------------EX-------------------------------------------------SS-----------------------------------------------------------------------------------------------------o---------------o------------------------Eo----S---S-S--S-S--------------S-S----SSS---------------S-------------------------------------------------------------------------------------SSSS--E---S----------S----SS-----------------------------------------------------------------------------------------------------XX------------------------------------------XXXXXXX-XXX----------------------------------------------------------------------------------------------------------------------------
-S------------------------XX---------E------XXXX--------------------[]---------------[]----------------------------------E--E-E--XX--------------------------E-E-------------oo-----------------Q-------------E---------------------------------------E--?-S---------o--------------------------------------------------E---------o-----------------------------------------------------XXXXXX-------S--S--------E---------S------SS---------------------------------------------------------------------------------------------------E------------------------E----------------oo----------[]----------------E--------------------------------------?--------E-----------------------------XX------------------------------------------------------------------------------------X-----------------------oo-----XXX------------E--------------SSSS---------------------------------------------<>X---E-------------------------S-------------------SS---XXSSSS---------------------------------------------------------------------------SSS-----------------------------------------------------------oS----SoS--SoS--------E-------So----SS----------So-?-S-------------------XXXX------------------------------------------------E----------------------ES----?-----So??-SSSS------E--XXX------------------------------------SQ----S----------------------SSSSS--------------XXXXX----------------------------------E-------------------------------------------------------------------------------------X-------------------E-----E------------------------------
--------------------------XX----------------X-XX-------------------SXXS--------------[]--------------------------------------XX--XX----------------------E--<><>------------o----------XX--XX---------------X<>----------o----------SS--------E------<>-----S--------------XXXX--SS---------XXXX------------XXX--------<>-------------E------SS-S--QQ--------------------------SSSS----XXX-XXX-------------E----<>-------E----E-----Q------------E-E---E---------------------------------------------------------SS------QQQ----------<>----------XX-----------<>--------S-------------------XXX----XXX-------<>-----E------S-------------SSSS--SS-SSSSSSSSSSSSSSS---QQ---------------------XXX--------------------------------QQQQ--Q-Q-------------E----------------------------XX------------------E-------------------XXX---<>------XXX------------------------------------------------------[]X--<>---QQ?SSQS---E------------S--SS---------S--------XXX-----EQQQ--Q---------------------XXXX-----XXXX----------------------------------------------S--S----E----S?SQ----------------XXXXXXXXXXXX---?-SS---SSS--SSS--S----<>-------SSS---SSSS--SS----S-S--SS--------XXXXXXXX---------------------X-------S----X--XXSQS-----------<>-----E--S----SSSSSSSSSSSSSSS??SS--SSS--SSSS-----<>-----------XX--SSS-------XXXX--------X------------E-------------------------------------XXXXXX------------------------E--S-----<>--XXXX-----------XXX--------------SQS-----S------------------QQQQ--Q-----S----------XXQQQ------------E--<>----<>-----XXX---S--SSSSS----------Q
------------------------EXXX----------------X-XX--------E----------------E------E----[]--------------E-----------------------XX--XX----------------E----<>--[][]---------------------XXXXXXXX-----oo------XXX[]---XX-------------------------<>------[]------------------------E-------X-------------------------------[]------E----E<><>---------------------------------------------XXXX-XXX------------<>----[]------<>---<>-----------------<><>--<>--<>-----------E--------------XXXXXX------------------------------------------[]---------XXX----E------[]---------------------------------------------[]----<>-------------------EE--------SS------------------------------E-------XXXX------E-------------------------------------E--------<>-------------X-------------XXX-----------E--------------------------------[]-------------------------------------------------------------XX[]X--[]--E---------<>----------------------------------XXXX---------------------------------------------------------------------------------------------------<>---------------------------------------X---------------------[]--XX----SS-----SS-----------------------------------------------XXX--XX-----------X--XX--------------[]----<>-------SSSSSSSSSSSSSS---SS----------------[]----------------------XXXX----------XX-----------<>---E--------------------------------XXXXXXX-SSS---EX--------------<>--------[]--------------------------------------------E--X--XX-------------------------------XXX--------------<>--[]----[]----EXXX----------------------
----------------------EXXXXX----------------X-XX--------XXXX------------<>-----------[]--------------------------------------XX--XX---------------<>----[]--[][]------------------XXXXXXXX-XX----oS------XXXX[]---XXX------------------------[]------[]--------------------------------X-------------------------------[]-----<>---<>[][]----------------------X---------------------XXXXX-XXX------------[]----[]------[]---[]-----------------[][]--[]--[]-----------------------------------------------------------X--------------[]--------XXXX---<>------[]---------------------------------------------[]----[]---------------------------XXSS-----------------------------<>------XXXXX-----<>------------------------------------<>--------[]-------------X---XXX------XXXX----------<>--------------------------------[]------------------------------------------------------------XXX[]X--[]-<>---------[]---------------------------------XXXXX---------------------------X-----------------XXXXX---o---------------------------------------------[]-------------------------------------o-X---------------------[]---------S-----SS--------------------------------o-------------XXX---XX-----------X--XX----------<>--[]----[]-------SSSSSSSSSSSSSS---SS--------<>------[]-------------------XXXXX-----------XXX-----------[]--<>-----------XXXX----------------XXXXXXXX-------XX--------------[]--------[]-------XXXX---------XXXXX--oo------------------X--XX--------------------------------X---------------[]--[]----[]--oXXXXXX--SS-----------------
---------E-EE----E----XXXXXX--------------E-X-XX---E-E------------------[]-----------[]--------------------------------------X---XX----EE-E-------[]-E--[]--[][]-------E-------XXXXXXX?----XX--EE-S-E-EE-XXXX[]E--XXXX---------X-E-EE--------[]------[]--------------------------------X-oooo-----------------------E--[]-----[]---[][][]----------------E-E-E-X------E-EE----E-----XXXXX--XXX-----E--XX--[]----[]------[]---[]---E-EEE-E-------[][]--[]--[]---------------------------------E-EE------E---------EE-E-XX--------------[]-------XXXXX---[]--E---[]---------------------------------------------[]----[]----E-E-----E-------------------o-------------------EE------[]-----XXXXXX---E-[]------------------------------------[]--------[]-----EE------X-E-XXXXE---XXXXX----EE----[]--------------------------------[]----------------------------------E-------EE-E-------------XXXX[]X--[]-[]---------[]----------E----------E-----E----XXXXXX----------------------E---XX--ooo--XXXXXXX---------------E-----------------------------------------[]-------------------oo---oo----------XXXX--E--EE-------EE-E---[]---X-E--------E----------EE-------XXXX----------XXX-----------XE-X-E-XX-----------X---X-----E----[]--[]----[]-E-----SSSSSSSSSSSSSSoooSS--------[]------[]-------------------XXXX-----------XXXX---SSSSS---[]--[]------------------------------XXXXXXXXX----SSXXX-E-EE---------[]-E------[]-S----------XXXX-----------------E-----E-E-E---X--X----------E-----E-EE---------E---X------------E--[]--[]----[]--XXXXXXX-----------E---------
XXXXXXXXXXXXXXXXXXXXXXXXXXXXXXXXXXXXXXXXXXXXX-XXXXXXXXXX-------------XXXXXXXXX-XXXX--XXXXXXX-XXXXXXXXXXXX---XXXXXX--XXXXX-X--XX--XXXXXXXXXXXXX--XXXXXXXXXXXXXXXXXXXXXXXXXXXXX-XXXXXXXS?----X----X-XXXXXXXXX--XXXXXXXXXXXXXXXXXXXXXXXXXXXXXXXXXXXXXXXXXXXXXXXXXXXXXXXXXXXXXX-----XXXXXXXX-XXXX-----------------------XXXXXXXXXXXXXXXXXXXXXXXXXXX-----XXXXXXXXXXXXXXXXXXXXXXXXXXXXXXXXXXXXXEoXXXXXXXXXXXXXXXXXXXXXXXXXXXXXXXXXXXXXXXXXXXXXXXXXXXXXXXXXXXXXXXXXXXXXXXXXXXXXXXXXXXXXX--XXX------XXXXXXXXXXXXXXXXXXXXXXXXXXXXXXXXXXXXXXXXXXXXXXXXXXXXXXX-XXXXXXXXXXXXXXXXXXXXXXXXXXXXX---XXXX-XXXXX--XXXXXXXXXX--XXXXXXXXXXXXXXXXXXXXXXXXXXXXXXXXXX-XXXXXXXXXXXXXXXXXXXXXXXXXXXXXXXXXXXXXXXXXXXXXXX--XXXXXXXXXXXXXXX-----XXXXXXXXXXXXXXXXXXXXXXXXXXXXXXXXXXXXXXXXXXXXXXXXXXXXXXXXXXXXXXXXXXXXXXXXXXXXXXXXXXXXXXXXXXX-------XXXX--XX--XX----------XX--XXXX-XXXXX---XX-XXXXXX--XXXXXXXXXXXX---XXXXXXXXX-XXX-XXXXXXXXXXXXXXXXXXXXXXXXX--XXXXXXXXXXXXXXXXXXXXXXXXXXXXXXXXXXXXXXXXXX---XXXXXXXXXXX--XX------------------------XXXXXXXXXXXXXXX----XXXXXXXXXXXXXXXXXXXXXXXXXXXX--XXXXXX--------XXX----X-------------XXXXXXXXXXXXXXXXXXXXXXXXXXXXXXXXXXXXXXXXXXXXXXXXXXXXXXXX----------------------------XXXXXXXXXXXXXXXXXXXXXXX-XXXXXXXXXXXXXXXXXXXXXXXXXXXXXXXXXXXXXXXXXXXXXXXXXXXXXXXXXXXXXXXXXXXXXXXXXXXXXXX------XXX-----------XXXXXXXX---------XXXXXXXXXXXXXXXXX----------XXXXX--X-XXXXXXXXXXXXX---XXXXXXXXXXXXXXXXXXXXXXXXXXXXXXXX----------------------------X-XXXXXXXXXXXXXXXXXXXXXXXXXXX-XXXXXXXXXXXXXXXXXXXXXXXXXXXXXXXXXXXXXXXXXXXXXXXXXXXXXXXXXXX-------XXXXXXXXXXXXXXXX