----------------------------------------------------------------------------------------------------------------------------------------------------------------------------------------------------------------------------------------------------------------------------------------------------------------------------------------------------------------------------------------------------------------------------------------------------------------------------------------------------------------------------------------------------------------------------------------------------------------------------------------------------------------------------------------------------------------------------------------------------------------------------------------------------------------------------------------------------------------------------------------------------------------------------------------------------------------------------------------------------------------------------------------------------------------------------------------------------------------------------------------------------------------------------------------------------------------------------------X--Q----------------------------------------------------------------------------------------------------------------------------------------------------------------------------------------------------------------------------------------------------------------------------------------------------------------------------------
-------------------------------------------------------------------------------------------------------------------------------------------------------------------------------------------------------------------------------------------------------------------------------------------------------------------------------------------------------------------------------------------------------------------------------------------------------------------------------------------------------------------------------------------------------------------------------------------------------------------------------------------------------------------------------------------------------------------------------------------------------------------------------------------------------------------------------------------------------------------------------------------------------------------------------------------------------------------------------------------------------------------------------------------------------------------------------------------------------------------------------------------------------------------------------------------------------------------------o---------X------------------------------------------------------------------------------------------------------------------------------------------------------------------------------------------------------------------------------------------------------------------------------------------------------------------------------------
-------------------------------------------------------------------------------------------------------------------------------------------------------------oo--------------------------------------------------------------------------------------------------------------------------------------------------------------------------------------------------------------------------------------------------------------------------------------------------------------------------------------------------------------------------oo-----------------------------------------------------------------------------------------------------------------------------------------------------------------------------------------------------------------oo----------------------------------------------------------------------------------------------------------------------------------------------------------------------------------------------------------------------------------------------------------------------------------------------------------------------------------------------------------------------SSSSSSSSSSSSSSSSSSSSSSSSSS-S-------------------------------------------------------------X----X--------------------------------------------------------------------------------------------------------ooo-------------------------------------------------------------------oo---------SSSSSSSSSSSSSSSSSSSS---SSSSS--------------------------------------------------------SSSSSSSSSSSSSSSSSSSSS-------SSSSSSSSSSSSSSSSSSSSSSSSSSSS
------------------------------------------------------------------------------------------------------------------------------------------------------------------------------------------------------------------------------------------------------------------------------------------------------------------------------------------------------------------------------------------------------------o-------------------------------------------------------o-------------------------------------------------------------------XXXX--------------------------------------------------------------------------------------------------------------------------------------------------------------------------------------------------------------------E--------------------------------------------------------------------------------------------------------------------------------------------------------------------------------------------------------------------------------------------------------------------------------------------------------------------------------------------------------------------SSSS------?oS--SSSSSS---SSS-----------------------------------------------------------X------XXoX-X---------------------------------------------------------------------------------------------------XXXX--------------------------------------------------------------------X----------SS------------SS--------oS-------------------------------------------------------------------------------------SSSSS--------SSS-----------
----o--------oo--oo---o------------------------------------------------------------o---------------------------------------E--------------------------------------------------------------------------------------------------------------------------------------------------------------------------------------------------------------------------------------------------------------------------------------------------------------------------------------------------------------------------------------------E--------?-----------------------------------------------------------------------------------------------------------------------------------------------------------------------------------------------------------------------------XXXXXXX-----o------------------------------------------------------------------------------------------------------------------------X-----------------------------------------------------------------------------------------------------------------------------------------------E--------------------------------------------------------------------------------SSSS------?SS--SSSSSS---SSS--------------------------------------------------------o-----------oo--X----------------------------------------------------------------------------------------------------------------------------------------------------------------E---------------ooo-SSS--E----------S--------SS-----------E-------------------------------------------------------------------XXX--ESSSSS---------SS---------E-
--XXXXX-------------------------------------------------SSSSS-------SS----SSS------o------------------XXX-----------------SQS--SQS-----------------------------XXX---------------------------XXXXX----------------------------------------------------------------------------S-------S-----XXXX------------------------------------------XX------------------------------SS-----------SS--SSSSSSS----SS--SSS----------SSSSS-SS--------S?SQS---SSSSS-------------?SSS------SSSS-----SSSSS-------------------------------S---SQS-S?X----------------E?SSS---SS---SSS--------SS---------------------E--------------------------------XXS-----X-oo----------oo---XXX---------S---------------------------------------------------------------------XXX------------------------------------------------------------S--------------------------------E------SSS---SSSSS------S------------------------------SQSSS------------Q-Q-Q-------------QQQQQQ-----------------------------S---------S-S--------------------SSSS--------------------E---------SSSSQS-----SSSS------------------oo----------------X----------------------------------------------------SS-----S--------------------------------------------------------XXX----------XX-------------------------------XXSSS-----------------------------SS-----------------------------------------------------------XXooo--XXXX-----oo---------------SSSQS--------------XXX------SSS-----oo----------SS-----------SS--SSSS-------------------Q---------------------------------------------SS-------Sooo--------S----SS
--------------E------------------------------------------------------------------XXX-------------o----XXX-------------------------------------------------------XX--------------------------------------------------------------------Qooo--oooo------------------------------------------------E-----------------------------------------XX-----------------------------------------------------------------------------------------------------------------------------------------------------------------------------------------------------------------------------------------------------<>---------------------E----------XX-----------------E------------------------------------------------------------------------------------------------------------------ooooo----------------------------------------------------------------XXX--------------------XXX-------------------------------------------------------------------------------------------------------------------------------------------------------------<>-----------------------------------------------------------------------XXX-----------------oo------------S-------SSS----S-------------------------------------------------------------XXXXX------------------------oooo----------------------------------------------------------------------------E---------------------------------------------------------------------------------------SS--------------------------------------------------------------------------------------------------------SS-------SS---------------SS
-------------<>---------XXXX-----------------------------------------------------oo------------------XXXX------------------------------------------------------XXX--------------------------------XX-------------------------------------------------------------------------------------------<>----------------------------------------XXX-----------------------------------------------------------------------------------------------------------------------------------------------------------------------------------------------------------------------------------------------------[]-------------------XXXX-XXX-----XX----------------<>------------------------------------------------------------------------------------------------------------------------XXXX---------------------------------------------------------X----------------------oooo--------------------------------S-----------------------------------------------------------------------------------------------------------------------------[]------------------------------------------------------------------------------------------------------------------SS----S-------------------------------------------------X-------------------------------------------------------------------------------------------------------------------------------------------------------------------------------------------o---------------------S------SSSS--SS------------------------------------------------------------------------------------------SS------SSSS--------------S-
---------XXX-[]--------------------------------------------------------------------------------EE-E-XXXXX-------------------------------------SS---------------XXX----------E--------------------XXX------------------S-SQ----------E--S-----------------------------ooo-----------------------[]---------------------------------------XXXX---------------E-------------------------------------------------------------------------------------E-----------------------------------SSSSS------------------------------S--------------E------------------------------------------------------E--XX-------------------------------XXX----------------[]--------------------------------------E--------------------------------S------------E------------SQ-SSS--------------------------------------------E-------------------E----------------------------------------------------------E------------------------------------------------------------------------------------------------------------------------------SSS----EE----XX-----------------------------------------------------------------------------------------------------------??-oooSS---E-S-o------------------------------------------------------------XXX-----XXXX--------------E-------------------------------------------------------S------------------------------------------------------------------------------------------------------------------S-----o---So-S------X------------------------------X--------------E-ooo--------oo------ooo---------------SE------SSSS---------So---SS
XX-----------XXX----XX---------------------------------X------------XXXXXXX--XX---------------------X-XXX---------------QQ--Q--S--------------------------------XX---------<>-------------------XXXX----------------XX-------------<>-----E--------------------------------XXX---S-------------XXX--------------------------------------XXXX--------------<>---S-----------------QQ-----X--X----------------------------QQ?----------XX---S----S-S----XX----------SSSS------X--X------------S--QQQ--Q---------------Q--QXS--S?SSS--SS----X--X-----------Q-QQQQ--Q--Q---S---------------------<>--XX------------------------------XXXX----------XXXX--XXX----XXX-----------SQS-----<>--------<>------QQQ--------------------------E--------<>------------------------------------------------------E------<>---Q--------------<>-----------------Q-----S---XXXX--SSS----------Q--Q-------<>-------------S?S--Q--Q------Q--QQQQ--Q-------QQ??SQQQQ--Q------------------------S---------ESSo----------XXX-XX------------------------X----------------SSSS---------QQQQ--QQQ-----------XXXX---------------XX---------------------------------S---X--SS---SSSSS--SSSS--------------------------XXQ----XXX----------X---------XXX----------------------------<>----------------------X-----------XX--X-------------------------------------------------------------------------XXX---XXXXX----------------XXXX--SSS-----X--X----------------ESSS---SS------XXS---QQQQ--Q-Q---SSSS-------------------------<>----------------------------------S---SSSS-----S-----SS----SSS--SS
------------------------------------------------------XX-------------------------------------XX---XXXXXXX------------------------------------------------------XXX---------[]------------------XXXXX-----------------X-------------[]----<>--------------XXX--------------------------E-----------------E--------------E--------------XXXXXX--------------[]------E-E-----------------XXX--XX---------------------------------------XXX------------E--XX-------------------XX--XX-----------------------------------------------------E--X--XX-----------------------------------------------[]--XX-----------------------------XXXXX---------------------------------------------[]--------[]--------------------------------------------[]---------------E---E---------------------------------<>---E--[]-----------E------[]----------------X-----E-----------------X----------------[]------------------------------------------------------------------------------------------<>SS----------XXXX-XXX--------E--------------X---X-----------------------------------------------------------X---S----------------------------------XXX--XX------------EE-E------------------X---XX-----------------------XXX--------------------------------------[]------E--------------XX----------XXX--XX-----------------------------------E--------------------------------XXXXX--------------------E------------------XX--XX--------------<>-------------EXXX----------------------------------E---------[]---------------------------XXX--------E----------SE---------------
---o-------------X-----------------------------------XXX--------------------------EX--------XXX---XXXXXXX------------------------------------------------------XXX---------[]------<>---------XXXXXX--------------<>-X-------------[]----[]-------------XXXX-------------------------<>----------------<>-------------<>--------------XXXXXX--------------[]-----<><>----------------XXXX--XXX---------X---------------X-----------XXXX---------------XXX-----------------XXX--XXX-------------------------------------------------------X--XXX----------------------------------------------[]--XX----------------------------XXXXXX---------------------------XXXX--------------[]--------[]--------------------------------------------[]--------------<>--<>---------------------------------[]------[]----------<>------[]----------<>----X----------------------XX-----<>---------[]------------------------------------------------------------------------------------------[]SS---------XXXXX-XXX-----------------------X---X-------------------------------------------------------E---X-----------XXX-----------------------XXXX--XXX---------------------------------XX--XXXX---------------------XXX-----------o--------------------------[]-----<>-------------XXX---------XXXX--XXX---------------------------------<>-------------------------------XXXX---------------------<>-----------------XXX--XXXX------------[]--------------XXX------------------------<>-------<>---------[]------------------------------------------E-----------------------
-------------------------------------E-----------------X--------------------------XX-------XXXX---S--XXXX------X------------E---------E-E-E-------X------------XXX------E--[]----E-[]--------XXXXXXX--------------[]------------E--[]----[]------------XXXXX-------------------------[]----------------[]-------------[]---------E?---XXXXXX-------EE-E-E-[]-----[][]-E-E------EE---XXXXXE-XXXX--EE---XX-E-E-------E-E-X---E-EE---XXXXX---------------XX---EE--E---------XXXX--XXSS-----E--------E-E----E---------------E------------E---X--XXXX------EE--------E-----E----------------------[]--XX----EE-E-------------------XXXXXXX---XXXX--------------------------E-----------[]--------[]-E---------------------------X--------------[]--------------[]--[]-----------------------EE-E------[]------[]----------[]------[]----------[]----X---------------------XXX-----[]---E-E---[]--------E--E-----------------E-EE-----S------EE-------E-E-------E----EE-E-EE-E--EE-E------[]SS---EE---XXXXXX-XXX---------X-------------X---X---EE-E-E--------------------E--------------o--------------X---X------------------------------E-XXXXX--XXXX--------------------------------XEE-XXXX---------------------XXX---EE-E---X---------------------------[]---E-[]------------XXXX---EE-E-EXXXX--XXXX-------XX--------------EE-E-----[]------E--E-EE-E--E-------------XXXX---------------------[]----------------XXXX--XXXX--------E---[]--------------XXX---------E-----E--------[]-----E-[]---E--E--[]--------------------------------------------------------------EE--
--------------------------------XXXXXXXXXXXXXXXXXXXXX---XXXXXXXXXXXX-----------XXXXXXXXXXXXXX-----XX--XXXXXXXXXXXXXXXXXXXXXXXXXXXXXXXXXXXXXXXX--------X-X------XXX-XXXXXXXXXXXXXXXXXXXXXXXXXXXXXXXX-XXXXXXXXXXXXXXXXXXXXXXXXXXXXXXXXXXXXXXXXXXXXXXXXXXXXXXXXXXXXXXXX---XXXXX-XXXXXXXXXXX--XXXXX-X----XXXXXXXXXXXXXXXXXXXXXXX-X----XXXXXXXXX--XXXXXXXXXXXXXXXXXXXXXXXXXXXXXX-X-XXXXXXXXXXXXXXXXXXXXXXXXXXXXXXXXXXXXXXXXXXXXXXXXXXXXXXXX---XXXXXXXXXXXXXXXXXXXXXXXXXXXXXXXXXXXX--XXXXXXXXXXXXXXXXXXXXXXXXXXXXXXXXXXXXXXXXXXXXXX-----XXXXXXXXXXXXXXXXXXXXXXXXXXXXXXXXXXXXXXXXXXXXXXXXXXXXXXXXX--XXX-XXXXXXXXXXX-XXXXX---X-XX-X-XXXXXXXX--X------X----------------------XXXXXXXXXXXXXXXXXXXXXXXXXXXXXX-XXXXXXXXXXX---XXXXXXXXXXXXXXXXXXXXXXXXXXXXXXXXXXXX---XXXXXXXXXXXXXXXXX---XXXX--XXXXXXXXXXXXXXXXXXXXXXXXXXXXXXXXXXXXXXXXXXXXXXXXXXXXXXXXXXXXXXXXXXXXXXX-------XXXXXXXX---XXXXXXXXXXXXXXXXXXXXXXXXXXXXXXXXXXXXXXXXXXXXXXXXXXXXXXXXXXXXXXXXXXXXXXXXXXXXXXXXXXXXXXXXXXXXXXXXXXXXXXXXXXXXXXXXXXXXXXXXXX--XXXXXXXXXXXXXX---XXXXX-X--XX--XXXXXXXXXXXXXXXXXXXXXXXXXXXXXXXXXXXXXXX----XXX-------X-XXX--X-------------XX---X-XX-XX---XXXXXXXXXXXXXXXXXXXXXXXXXXXXXXXXXX-XXXX---X-XXXXXXXXXXXXXXXX--XXXXX-----XXX--XXXXXXXXXXXXX----------------------------XXXXXXXXXXXXXXX---XXXXXXXXXXXXXXXXXXXXXXXXXXXXXXXXXXXXXXX---XXXXXXXXXXXXXXXXXXXXXXXXXXXXXXXXXXXXXXXXXXXXXXXXXXXXXXS--------------------XXXXXXXXX------XXXXXXXXXXXXXXXXXXXXXXXXXXXXXXXXXXXXXXXXXXXXXXX-XXXXXXXXXXXXXXXXXXXXXXXXXX--XXXXXXXXXXXXXXXXXXXXXXXXXXXXXXXXXXX---------------XXXXXXXXXXXXXXXXXXXXXXXXXXXXXXXX