------------------------------------------------------------------------------------------------------------------------------------------------------------------------------------------------------------------------------------------------------------------------------------------------------------------------------------------------------------------------------------------------------------------------------------------------------------------------------------------------------------------------------------------------------------------------------------------------------------------------------------------------------------------------------------------------------------------------------------------------------------------------------------------------------------------------------------------------------------------------------------------------------------------------------------------------------------------------------------------------------------------------------------------------------------------------------------------------------------------------------------------------------------------------------------------------------------------------------------------------------------------------------------------------------------------------------------------------------------------------------------------------------------------------------------------------------------------------------------------------------------------------------------------------------------------------
------------------------------------------------------------------------------------------------------------------------------------------------------------------------------------------------------------------------------------------------------------------------------------------------------------------------------------------------------------------------------------------------------------------------------------------------------------------------------------------------------------------------------------------------------------------------------------------------------------------------------------------------------------------------------------------------------------------------------------------------------------------------------------------------------------------------------------------------------------------------------------------------------------------------------------------------------------------------------------------------------------------------------------------------------------------------------------------------------------------------------------------------------------------------------------------------------------------------------------------------------------------------------------------------------------------------------------------------------------------------------------------------------------------------------------------------------------------------------------------------------------------------------------------------------------------------
----------------------------------------------------------------------------------------------------------------------------------ooo--------------------------------------------------------------------------------------------------------------------------------------------------------------------------------------------------------------------------------------------------------------------------------------------------------------------------------------------------------------------------oo-------------------------------------------------------------------------------------------------------------------------------------------------------------------------------SSSSSSSSS---SSSSSSSSSSSSSSSS----------------------------SSSS-S--SSSSSSS----SSSSSSS---------------------------------------------------------------------------------------------X---------------------------------------------------------------------------S----------------------------------oo---------------------------------------------------------------------------------------------oo------------------------------------------------------------------------------------------------------------------------------------------------------------------------------------------------------------------------------oo-------------------------------------------------------------------------------------------------oo--------------------------------------------------------------------------------------------------------------------------------------
----------------------------------------------------------------------------------------------------------------------------------XXXX------------------------------------------------------------------------------------------------------------------------------------------------------------------------------------------------------------------------------------------------------------------------------------------------------------------------------o-----------------------------------------XXXX------------------------------------------?--------------------------------------------------------------------------------------------------------------------------------------------S-SSSSSSSSSSSSSSSSS-------------------------------------------------------------------------------------------------------------------------------------------------------------------------------------------------------------X----------------oS---------------------------------XXXX-------------------------------------------------------------------------------------------------------------------------------------------------------------------------------------Q--------------------------------------------------------------------------------------------------------------------------------------XXX----E------------------------------------------------------------------------------------------XXXX---------------------------------------------------------------------------------------------------------------------------------?---
-------------------------------------------------------------------------------------------oooo--------------------------E---------------ooo---------------------------------------------------------------------------------------------------------------------------------------------------------E-------------------------------------------------------------------------------------------------------E---------------------------------oo--oo--------------------------------------------------------------------------------------------------------------------------------------E----------------------------------------------------------------------------------------------------------------SSSSSSSSSSSSSSSS----------------------------------------------------------------------------------------------------------------------------------------------E-------------------------------------------------------------------------------ES----------------------------------------------------------------oo----------------------------------------------E------Eoo-----------------------------E----------------------------------------------------------------------------------------------------------------------------------------------------------------------------------------E-------oo-----------------------------------------------------------o--------------------------------------------------------------------------------------------------------------------------------------------------------------------------------------
--------------------------------------------SS------------------------------SSS------------XXXX--------XXX--------------SQS-E----oo-----------S-Q--SS?-------------------------------------------------o---SSQS----------XX----------------------SSSSS---SSS-----------------------------------------E--E-E------o--------------------------------------------------------------------------XX--------------SQS----SSS--XX------S-------------SQS-----------------SSS------------XXX--------------S---?--------------------------------------------S--SS--S---?---------------------------SQS--SQS------------SSS------SSSSSSSSSSSSS-------------------------------------------------------?--Q-S--SS---SSSSSSSSSSSSSSSSSSSS--------------------------------S-------------------------------------------------------ESSSSSQQQ---------------------------------------------SS---Q-------------------S--QS------------------------------SSS-----o---------SSSS--S---S--------------SSS-------------------------------S--------------------------------------------------------S---S--XXXX------XX-----SS----SSS-----SSS--------?-------S-?-------------S--SSS-----------------------------------------------------------------SS----?SSS--XX---------------S-----SS--------------SSSSSS--------------SSo----------SQS-XXX------X---------------------------------E---------------------------------------------------------------------------------------S---?-----------------------------------------SS-------------------------------------SSSSS----SSSS-oo----?-------
-----------------------------------------------------------------------SSS----------------------------XXXX------------------XXXXX-------------S----SS---------------------E---------------------------------------------XXX----------------------------------------------------------------------------XXXXXX----------------------------------------------------------------------------o---X--------------------------XX-------------------------------oooo-------------------XXXX------------------------------------------oooo-----------------------------------------------------------------------------------------------------------------------------------------------------------XXX---------------------------------------------------------------------------oooo-------------------------------------------------------------------------------------------S----S-----------------------------------------ooo----------SS----------------SS----------------------------------------------------------------------------------------------------------------------------------XXX-----------------------------------------------------------------------------------------------------------------------------------------XX-----------------------------------------------------------------------------------X--------------------------------<>---------------------SS-----------------------o---------------------------------------XX------Qooo----------------------------------------------------oooo----------------------------------------------
-----------------------------------------------------------------------XX----------------------------XXXXX-----------X------------------------S-S----------------------------------------------------------------------XXXX-----------------------------------------------------------------------------------------------------o---------------------------------------------------------X-XXX-----------------------XXXX-----------------------------------------------------XXXXX-----------------------------------------------------------------------------------E---------------------------------------------------------------------<>-----------------------E-----------------------------------------------------------------------------------------------------------------------------------------XX--------------------------------------------------------S----S------S--------E---------------------------------------S----------S-----SS---------------------E-----------------------------------S------------------------------------------------------------------------XXX----------------------------------------------------------------X----------------------------------------------------------------------EXXX-----------------------------------------------------------------------------------XX-------------------------------[]---------------------------------------------XXX------------------------------------XX-S-------------------------------------------------------X--------------------------------------------------------
----------------------------------------------------SS-S----oo--------XXXS-----------o---oo---------XXXXXX-----------X-------------XXXXXX---?-So??--S--------------------SQSQ----------------------X------------------XXXXX-----------------------------o-------------------------E-----------------------------------------------------------S-------------------------X-------------E-----XXX---------------------XXXXXX-----------------------------E-----E---------------XXXXXXX----------------------------SS----------E-------o-o----------E--------------------<>-----S---------------------------E-----------------------------------[]-------E--------------<>----------------------------E----------?----------------E-----------------------------------------E--------------------------------------S------------------S---------oo---oo------------X---------SS---SoS--So--------<>---------------------------------------S----------S-----SS-----------------E--<>-SQ--S---S-----------------------XX-------------------SSSSSSSSS--o-----------------------------------------XXXX---------------------------------------------------------------XX-S-SSS----------------------S------------------------------------E----XXXX--------------------------------E---------------------------------E-----------E--XXXX-------------------------------[]--o-------------------------------------------------oo-------S---------------------XXX--XS---------------------oo--X-S------------------------XX----E------E----------------S---------------------------
----------oooo-----------------E-----E-----S-------------oooo-------X-XXX--------------------------EXXXXXX----------XXXXX--X-XXX--------------SSS--SS----E--S-------------------------------------XX-----XXX--S-S----EXXXXX------------------------------------------Q----E------<>------------XXX---------E------------------SSSSS---------E--------------<>-----------XX-X---------<>----XXXX-----------ESSSS-----XXXXXX--------------------XXXX---E<>----<>--------------XXXXXXXX--------------SQS------E---------------<>-------------E-----<>-S----S?SQS------E--[]-----------E-----E-------E------<>----------------------------XX-----[]------<>--------------[]--------------------------SSSSS--SSSSSS??SSSSSSSSSS----<>------QQQ-------------------S--------E--<>---------------------Q-----SS---E-X---S-----QQ?SSSQS--------E--S--------------------X-X---------SS---SSS--SSSE---E--[]------QQQ--Q---------E-----------------SS--------SS-----SSSS---?SSSS------<>--[]------------E-----E-------------XXX---------------------------------------------------------SS--SXS-------XXXXX-----------------QQQQQ--Q-QQ--QQQQ----S--------E--------------XXX------------S--------------X---E------S----E---------E-----QQQQ------XXXXX-------------QQQ--QQ-Q--------E<>---QQ--SSS-----------XXXX--SSS---XS--S?S--------XXXX-----------QQ-----------E------<>-------------XX----XX-------------------------------------------------------------XXXXX----------------S----------XX---------------E---------XXX---<>-----<>------E-----------------Q--XX---------------
-------XX---E-------o-o-------------<>-----------------------------EXXXXX-------------------------XXXXXXXX----------------------------------------------E----------------------------------------XXX----------------XXXXXXX----------------E--------E--------------------<>------[]--E--------------------<>-------------------------E-----<>--------------[]-----------XX-----------[]--XXXXXX-------------------XXXXXXXX--------------------E----E<>[]----[]-------------EXXXXXXXX----------------------<>---------------[]-----E------<>-----[]-S--------------<>--[]----------<>----<>------<>------[]-------------X-------E-----XXX-----[]------[]--------------[]--------------------------SSSSS--SSSSS-----------------[]------------------------------E-----<>--[]-------------------------------<>-----XX-------------------<>-----------------------X-X-------X-----------------<>--[]--------------------<>------------------------------------SS--------------[]--[]-----------<>----<>------------XXXX----------------E-----------------------------------------------------XXXXXX-----------------------------------------E----<>-------------XXXX-----------------X--------XX--------------<>--------<>--------------XXXXXX---------X-------------------<>[]-----------------------------------------------XXXXX-SSS-------------------<>----X-[]-XXX--------------XXX--SSS----S--------------------------------------------------XXXXXXX-----------E-------------EXX--------------<>--------EXXXX--[]-----[]----E<>-------------------------------------
------XXXXXXXX----XXXXX---o---------[]---------------------------EXXXXXXX--------ooo----------<>-XXXXXXXXX--------------------------------------------------------------------------------------XXXX----------------XXXXXXX---------------<>-------<>--------------------[]------[]-<>--------------------[]--------XX--------------<>-----[]--------------[]-----------XXX----------[]--EXXXXX------------------XXXXXXXXX--------XX--------------<>[][]----[]-----------EXXXXXXXXXX-------X--------------[]---------------[]----<>------[]-----[]-S--------------[]--[]----------[]----[]------[]------[]-----------XXX---X--------XXXX-----[]------[]------<>------[]------------------------ooSSSSS--SSSSS-----------------[]--SS-------------------------<>-----[]--[]-------------------------------[]-----XXX------------------[]-----------------------X-X-------X-----------------[]--[]--------------------[]----------X-------------------------SS--------------[]--[]-----------[]----[]-----------XXXXX---------------<>--------------------------------------------------XXXXXXXXX----------------------------------------<>----[]------------XXXXX-------------E---X-------XXX--------------[]--------[]-------------XXXXXXX--------XX-------------------[][]----------------------------------------------XXXXXX-----------------------[]---XX-[]--XS-------------XXXX---SS------------------------------------------------------XXXX-XXX----------<>-------------XXX--------------[]------EXXXXXX--[]-----[]---<>[]<>-----------------------------------
-----XXXX--------------------E-EE---[]-E--E---------E------------XXXXXXXXS-SSS----X-----------[]XXXXXXXXXX------SSSo-------------------------EE---------------------------------EE-E-----------XXXXX---------------XXXXXXXX-------------E-[]-------[]-E-----------E-EE---[]------[]-[]--------------------[]------------------------[]-EE--[]--------E-EE--[]-E-E--EE---XXX---EE-E---[]--XXXXXX--------X--------XXXXXXXXXX---EE---XX--------------[][][]----[]-E---------XXXXXXXXXXX---EE--X--------------[]------------E--[]----[]------[]--E--[]---E----------E-[]--[]----------[]----[]------[]------[]---E-E----XXXX-E-XX-X----XXXXX--E--[]------[]------[]------[]---------------------------SSSSSSSS-SS-----------------[]------------EE--------E------[]---E-[]--[]--------E------E-EE------EE----[]-----XXX----E---------EE--[]-E-----------------E---XXX-X-----X----EE--------E--[]--[]--------------E-E---[]----------X-EE-E-E-------E---------ES--EE--------E--[]--[]--------E--[]-E--[]----------XXXXXX---------------[]---------------------EE-E-EE------------E----------XXXXXXXX--------X---------------------EE-----E--[]-E--[]-----------XXXXXX-------------S---X------XXXX------------E-[]---X----[]-E----------XXXXXXXX---EE--XXX-------------------[][]-------------------------------------------------XXX--------X------EE------[]--XXX-[]--XS------------XXXX---SSS-?--------------------------------------E-EE----EE---XXXXX-XXX--------E-[]------------XXXX------E-EE-E--[]-E----XXXXXXX--[]-----[]---[][][]-----------------------------------
XXXXXXXX----------------E---XXXXXXXXXXXXXXXXXXXXXXXXXXXXXXXXXXXXXXXXXXXX---X----XXXXXXXXX---XXXXXXXXXXXXXXXXXXXX-XXX------------------------XXXXXXXXXXXXXXXXXXXXXXXXXXXX--X-XXXXXXXXXXXXX-X-XXXXXXXXXXXXX-----XXXXXXXXXXXXXXXXXXX-X-XXXXXXXXXXXXXXXXXXXXXXXXXXXXXXXXXXXXXXXXXXXXXXXXXXXX--XXXXXXXXX-XXXXX-XXXXX-----X------XXXXXXXXXXXXXXXXXXXXX-XXXXXXXXXXXXXXXXXXXXXXXXXXXXXXXXXXXXXXXXXXXXXXXXXXXXXXXXXXXXXXXXXXXXXoXXXXXXXXXXXXXX--XXXXXXXXXXXXXXXXXXXXXXXXXXX----XXXXXXXXXXXXXXXXXXXXXXXXXXXXXXXXXXXXXXXXXXXXXXXXXXXXXXXXXXXXXXXXXXXXXXXXXXXXXXXXXXXXXXXXXXXXXXXXXXXXXXXXXXXXXXXXXXXXXXXXXXXXXXXXXXXXXXXXXXXXXXXXXXXXXXXXXXXXXXXXXXXXXXXXXXXXXXXXXXXXXXXXXXXXXXXXXXXXXXXXXXXXXXX---XXXXXXXXXXXXXXXXXXXXXXXXXXXXXXXXXXXXXXXXXXXXXXXXXXXXXXXXXXXXXXXXX-XXXXXXXXXXXX--XX--XXXXXXXXXXXXXXXXXXXXXXXXXXXXXXXXXXXXXXXXXXXXXXXXXXXXXXXXXXXXXXXXXXXXXX---XXXXXXXXXXXXXXXXXXXXXXXXXXXXXXXXXXXXXXXXXXXXXXX--XXXXXXXXXXXXXXXXX-XXXXXXXXXXXXXXXXXXXXXXXXXXXXXXXXXXXXXXXXXXXXXXXXXXXXXXXXXXXXXXXXXXXXXXXXXXXXXXXXXXXXXXXXXXXXXXXXXXXXXXXXXXXXXXXX-X---XXXXXXXXXXXXXXXXXXXXXXXXXXXXXXXXXXX--XXXXXXXXXXXXXXXXXXXXXXXXXXXXXXXXXXXXQ-XXXXXXXXXX--XXXXXXXXXXXXXXXXXXXXXXXXXXXXXXXXXXXXXXXX-XXXXXXXXXXXXXXXXXXXXXXXXXXXXXXXXXXXXXXXXXXXXXXXXXXXXXXXXX-XXXXXXXXXXXXXXXXXXXXXXXXXXXXXXXXXXXXXXXXXXXXXXXXXXXXXXXXX-----XXXX---XXXXXXXXXXX-XXXXXXXXXX-XXXXXXXXXXXXXXXXXXXXXXXXX--XXX-XXXXX-------XXXXXXX--SXS--XXXX----------------XXXX---XXXXXXXXXXXXXXXXXXXXXXXXXXXXXXXXXXXXXXXXXXXXXXXXXXXXXXXXXXXXX--XXXXXXXXXXXXXXXXXXXXXXXXXXX--XXXXXXXXXXXXXXXXXXXXXXXX-XXXXXXXXXXXXXX--XXXXXXXXXX--