------------------------------------------------------------------------------------------------------------------------------------------------------------------------------------------------------------------------------------------------------------------------------------------------------------------------------------------------------------------------------------------------------------------------------------------------------------------------------------------------------------------------------------------------------------------------------------------------------------------------------------------------------------------------------------------------------SSSXo--Q-o---------X----------------------------------------------------------------------------------------------------------------------------------------------------------------------------------------------------------------------------------------------------------------------------------------------------------------------------------------------------------------------------------------------------------------------------------------------------------------------------------------------------------------------------------------------------------------------------------------------------------------------------------------------------------------------------------------------------------------------------------------------------------------------------------------------------------------------------------------------
-------------------------------------------------------------------------------------------------------------------------------------------------------------------------------------------------------------------------------------------------------------------------------------------------------------------------------------------------------------------------------------------------------------------------------------------------------------------------------------------------------------------------------------------------------------------------------------------------------------------------------------------------------------------------------------------------SS--XXQS-oX-X----------------------------------------------------------------------------------------------------------------------------------------------------------------------------------------------------------------------------------------------------------------------------------------------------------------------------------------------------------------------------------------------------------------------------------------------------------------------------------------------------------------------------------------------------------------------------------------------------------------------------------------------------------------------------------------------------------------------------------------------------------------------------------------------------------------------------------------------------------
--------------------------------------------------------------------------------------------------------------------------------------------------------------------------------------------------------------------------------------------------------------------------------------------------------------------------------------------------------------------------------------------------------SSSSSSSSSSSSSSSSSSSSSSSSSSSS--------------------------------------------------------------------------------------------------------------------------------------------------------------------------------------------------------------------------------SSSSSSSSSSSSSSSSSSSSSSSSSSSS--oo---XSXX---E--S------------------------------------------------------------------SSSSSSSSSSSSSSSSSSSSSSSSSSSS-----------------o----------------------------------------------------------------------------------------------------------------------------------------------------------------------------------SSSSSSSSSSSSSSSSSSSSSSSSSSSS-----------------------------------------------------------------------------------S------------------------------------------------------------------------------------------------------------------------------------------------------------------------------------------------------------------------------------------------------------------------------------------------------------------------------------------------------------------------------------------------------------------------------------
---------------?---------------------------------------------------------------Q------------------------------------------------------------------------------------------------------------------------------------------------------------------------------------------------------------------------------------------------------------------------------------------------------------------------S--------------------------------------------------------------------------------------------------------------------------------------------------o-------------------------------------o---------------------------------------------------------------------------------------------S-------XX-XX-X--X----o--X-o------------------------------------------------------------S------------SS--S---SSSS---------------------------------------------------------------------------------------------------------------------------------------------------------------------o------------------------------S--SSSS---S--SSSSSSSSSSSSSSS------------------------------------------------------------------------------------------------------------------------------------------------------------------------------------------------------------------------------------------------------------------------------------------------------------------------------------------------------------------------------------------------------------------------------------------------------------------------------------------------------------------------
--XX-------------oo--oo----------------------------------------------ooo----------------------------------------------------------------------------------------------------------------------------X---E---------------------------------------------------------------------------------------------------------------------------------------------------------------------X-------------------------S--------------------------------------------------------------------------------------------------------------------------------------------------------------------------------------------------------------------------------------------------E-----------------------------------------------X-----------------------------------------------------------------------------------------S--S---SSSSE--------?--------------------------------------------------------------------------------------------------------------------------------------------------------------E---------------------------S--SSSS--SS--SSSSSSSSSSSSSSS-----------------------------------------E-------------------------------------------------------------------------------------------------------------------------------------------------------ooo--------------------------------------------------------------------------------------------------------------------------------------------------------------------------------------------------------------------------------------------------------------------------------------------------------------------
X----XXX-------------XX----------------------------------------------------------oo------------Q--------------SS------------------------SSSS------------------------------------------------SSSSSSS----SQSS------------------------------------------------------------SSS---------------------------------------oo-----------------SSS---SSS--S------S----SSS-------SSS---------------------?------X---S------?--------------------------------------------SQQQ-------------------------------------------------------o-----------------------------------------------------oo-----------------SS---------------------------------------------------------E--E---------------------------------XXXXXX------------------oo----------------------XXX----------------------------------S------------------S---SSSSS---SQS---?------------SSS------------------------SSSSSS---SSS--------SSSSS--?SQS-------------------------------S----------SS---------------SS?SSSS---?SSS-------SSSSS--SS--SSS----------------SSS--S------------S-SSSSSSSSSSSSS---------------------------------------SSS----SSSSS-----------------------------S-?S--------------------SSS--------------------------SSS----------------------------------------XXXX------------XXXX-----------------------E--------------SSS--------------------------SSS--------------Q?SSS---Q-------------------QQ---------SSSSSSSSSSS------------------------------SS-----------------------------------------------------------S-?------------SSSSSSSS----------------S---SSSSSS-----------------Q--------------XX
--------------------------------------------------------o-----------------XXXX--------------------------------------------------------------------------------------------------------------------------------------------------------------------------------------------------------EX--------------o---XXXXX-------------------------------------------------XSS-----------------E----------------ooo--------------------------------------------------------------------------------------------------------------XX-----------------------------------E--o---o---XXXX--------------------------------------------------------------XXX------------------XXXXX---------------------------------------------XXXXXX----------------------------------------------------oo---------ES------------------SS--SSS-----S-------------------------------------------------------------------------------------------------------------------------------------------------------------------SS--------------------------------------------------------------------------------------------------------------------------------------------------------------------------------------------------------------------------------------------------------------------------------<>--------------------------------------------------------------------------------------------------------------------------------------------SS------------------------------------------------------------------------------------------------------XX-----------------------------------XXX
----------------------------------------Q----------------------XX-X----------------------------------------X----------------------------------------------------------ES-------------------------------S----------------------------------------------------XX-----------------------<>X-----------------------------------------------------------------------XX----------------------------------------------------------------------------------------------------------------------------------------------------XXX------------------------------XXXXXXXXXX-XXX---------------------------------------------------------------------------------------------------------------------------------------XXX-oo--------------------------------------------------------------------S------------------S---SSS-----------------------------------------------------------------------------------------------------------------------------------------E-------------------------------SS----------------------------------------------------------------------<>--------------------------------------------------------------------------------------------------------------------------------------------------------------------------------------------------------[]--------------------------------------------------------------------------------------------------------------------------------------S---S---------------------------XS-------------------------------------------------------------------------EXXXX----------------------------------XXXX
------XXXXXX-------------------E-------------------X------------------------------XX----------------------XXS----------------------------------E---------------------XX--------------o--------------------------------------------------------E-------E-----S------------------------[]X---------------------------X------------------------------------------XXXS--SQ-------------------------------------E--------------------------------------------E--------------------------------E--------------------------XXXX-o----oo----------------------------------------------XXSS-------------E---------------------------------E-----------------------------------------------S--------------------------------------XXX---oo------------------------S--E------------------------SS---------------o?-S---SoS------------------------SSS?---------------------SSSSSS-----------------------------------------------------E--------------------E---E--<>-------------------------------SS----S--------------S------------------------------ooo---XXX-----------[]------------------------------------------------------S--------------------------E---------S-----------------E---------------E---------------------E----------------------------------------------------[]--o--------------------------E--------------------------o---------------------------------------------------------------------------S-S---S-??--Q---SSSSSS------------X--------------------E---------------------------------------------------XX--XXX---------------------------------XXXXX
XXX----------XXX--XXXXXXXX----<>------SSSQS--S---X-XX---XX----------oo-----------------QQ----SSQQQ-------XXX-----Q------------------------SS--<>------------SSS-----XXX-----------E----------S--------ES?S---------------QQ------------------<>------<>---------QQQ--QQQQ------------[]XSS----------------------------------<>------SS--------SS-----SS------XXXXX---------XXX------XX---------------------SSS-----S-----------------------------<>----<>---Q??S--------------E---------<>-------------------------XXXXX--------------------------E-------------------------------------------<>---------E------------------E---<>---------------------XXX-----------Q--------------------------XX-----XXX---------------------------S--------------------<>------SQ-------E-----E--SSSSSSSS----------------SSS?XS--S?SS-------------------------E-S------------------------SE---------QQQQ--QQQ---------------QQQQ-------<>-------Q-Q--QSQS---<>--<>--[]--X----S?SSS-----------X-------SS--S?S----XX--X------------------------------SSSS-SSSSS-------------E--[]------------------------XXX--X-------------------------S-------SSS--------------<>--------------------------<>--------------<>-----ESQS-----------<>---------------------------------------------------X[]---E---------SSSS-----------<>-----------------S----E-------QQQQQQ-QQQ--Q---Q-----QQQ---E?QQQ-Q--Q---------S------EX-----------------S----X-S---------------S----XX-XXX-------------------<>------------oooo-------XX-XX-----SS----X-----------XXX-XXX---------X---------S-Q----------XXXXXX
------------------------------[]-----------------X-XX----------------E--------------S-------------------XXXX--XX------------------------------[]-------------------XXXXX---------<>----------------------------------------------------------[]------[]-----S------------------------[]X------------------------------------[]----------------S-------------XXXXXX--------XX------------------------E------SSS-----SS----------------------------[]----[]--------------------<>---------[]------------------------XXXXXX------------------------X---------------------------------------------[]--------<>-----------------<>---[]---------E------E----------------X-----------XX------------------XXXX---------------------------------E---E-------------[]-----------E--<>----<>--------------------------------------------------------------------------------------------E-------------------------------------------[]-------------------[]--[]--[]--X--------------------XX-----------------XX--XX---------------------------------------------E-----<>--[]-----------------------XXXX--X------------------X---------------SS--------------[]--------------------------[]----------XX--[]----<>--------------[]----------------------------E---------------------XX[]--X-------------------------[]-------------E------E<>------------------------------------------------------E-----<>X----------------------X--------E-------------X-XXXX-------------------[]--E------E------------XX--XX---E-------X---------XXXX--XXX-------EXXS--------------------XXXXXXX
----XXXX------------------o---[]-----------------X-XX--------------XXXX----XXX------S------------------XXXXX---X------------------------------[]------------------XXXXXX---------[]----------------X-----------------------------------------[]------[]-----S------------------------[]S------X-----------------------------[]-----------------------------XXXXXXX-------XXXXXXX-------------------<>------SSS-----SSS---------------------------[]----[]--------------------[]---------[]-----------------------XXXXXXX-----------------------XXXXXXXXXXXX-----------------------------<>----[]--------[]-----------------[]---[]---------------------------------X-------------------------X-----------------------------------------<>--<>-------------[]----------<>--[]----[]-------------------------------------------X---X----------------------------------------------------------------------------------------[]-------------------[]--[]------X--------------------XXX---------------XXX--XXX--------------------------------------------------[]--[]----------------------XXXX---X------------------XXX---------X--SSS--------------[]-----------E--------------[]---------XXX--[]----[]--------------[]---------------------------<>--------------------XXX[]--XQ------------------------[]------------<>-----<>[]------------------------------------------------------------[]X------------------X-X-X-------<>-------------XXXXXX-------------------[]-<>-----<>----------EXXX--XXX------E---X--------XXXXXX-XXX-------XXXX-------------------XXXX--XX
---XX--------------------XXX--[]------E-----EE-E-X-XX-------------------------------X-------E------EE-XXXXXX---XE----------E------------------[]----E-----E-E----XXXXXXXEE--E----[]---------------XX-E--------------------E----------EE-E----[]------[]-----S------E-E--E------------[]S-------------------------------EE-E-[]----------------------------XXXXXXXX--S-S-XXXX-----------------------[]-------------E----oo-S----------------------[]----[]-------------E-EE-E-[]---------[]--E--------------------XXXXXXX---------------------XXXXXX------------------------------E------[]----[]--------[]-----------------[]---[]-------E-------------------E-EE-EX-------------------------X-----------------------------------------[]--[]-------------[]--E-EE----[]--[]----[]--E------------------------E--E-E----------X---X-----------EE--------------------------------------------------------------------EE-EE--[]-----------E-------[]--[]------X--E----------E------XXX-----E----------XX--XXXX--------------------------------E----------------[]--[]---------------------XXX-----X------X-E-----------X------------E----------------[]-----------S-E-EE-E----E--[]---E----XXX---[]----[]----E-E-------[]-------------------E---E-E-[]--------EE----E-EE-XXXX[]--E-------------------------[]------------[]-----[][]-E---------------------------E-E-------E--------E-----------[]X-------------E----X-----------[]---------E---XXXXXX---------E---------[]-[]-----[]--E------XXXXX--XXXX-----Q---X-------XXXXXX--XXX------XXXXX-----EE-------E---XXXXX--XX
----------------------------XXXXXXXXX-XXXXXXXXXXXXXXXXXX----------------------------XXXXXXXXXXXXXXXXXXXXXXXX--XXXXXXXXXXXXXXXXXXXXXXXXXXXXXXXXXXXXXXXXXXXXXXXXXXXXXXXXXXXXXXXXXXXXXXXXXXXXXXXXXXXXXXXXXXXXXXXXXX--XXXXXXXXXXXXXXXXXXXXXXXXXXXXXXXXXXXXXXXXXX---XXXXXXXXXXX-XXXXXXXXXXXXXXX------XXXXXXXXX-------XXXXXXXXXXXXXXXXXXXXXXXXXXXXXXXXXXXXXXXXXXXXXXXXX-----XXXXXX----------------XXXXXXXXXXXX-XXXXXXXXXXXXXXXXXX---XXXXXXXXXXXXXXXXXXXXXXXXXXXXXXXXXXXXXXXXXXXXXXXXXXXXXXXXXXXXXXXXXX-----XX----XXXXXXXXXXX--XXXXXX---XXXXX----XXXXXXXXX-----------------------------XXXXXXXXXXXXXXXXXXXXXXXXXXXXXXXXXXXXXXXXXXXXXXXXXXXXXXXXXXXXXXXX-XXXXX---XXXXXXXXXXXXXXXXXXXXXX----XXXXXXXXXXXXX------------------------------XXXXXXXXXXXXXXXXXXX--XXXXXXXXXXXXXXXXXXXXXXXXXXXXXXXXXXXXXXXXXXXXXXXXXXXXXXXXXXXXXXXXXXXXXXXXXXXXXXXXXXXXXXXXXXXXXXXXXXXXXXXXXXXXXXXXXXXXXXXXXXXXXXXXXXXXXXXXXXXXX---XXXXXXXXXXXXXXXXXXXXXXXXXXXXXXXXXXXXXXXXXXXXXXXXXX--XXX-XXXXXXXXXXXXXXXXXXXXXXXXXXXXXXXXXXXXXXXXXXXXXXXXXXXXXXXXXXXXXXXXXXX--XXXXXXXXXXXXXXXX---XXXXXXXXXXXXXXXXXXXXXXXX----XXXXXXXXXXX--XXXXXXXXXXXXXXXXXXXXXXXXXXXXXXXXXXX--XXXXXXXXXXXXXXXXXXXXXXXXXXXX--XXXXXXXXXXXXXXXXXXXXXXXXXXXX-XXXXXXXXXXXXXXXXXXXXXXXXXXXX--X-XX-XXXXXXXXXXXXXXXXXXXXXXXXXXXXXXXXXXXXXXXXXX-XXXXXXXXXXXXXXXXXXXXXXXXXXXXXXXXXXXXXXXXXXXXXXXXXXXXXXXXXXXXXXXXXXXXXXXXXXXXXXXXXXXXXXXXXXXXXXXXXXXXXXXXXXXXXXXXXXXXXXXXXXXXXXXXXXXXXXXXXXXXXXXXXXXXXXXXXX-XX-XXXXXXXXXXXXXXXXXXXXXXXXXXXXXXXXXXXXXXXXXXXXXXXXXXXXXXXXXXXXXXXXXXXXXX-X--X-XXXXXXXXX-XXXXXXXXXXXXXX-XXXXXXXXXXXX---XXXXXXXX--XX