----------------------------------------------------------------------------------------------------------------------------------------------------------------------------------------------------------------------------------SSS-SSSXo--XXX-S-------X-----------------------------------------------------------------------------------------------------------------------------------------------------------------------------------------------------------------------------------------------------------------------------------------------------------------------------------------------------------------------------------------------------------------------------------------------------------------------------------------------------------------------------------------------------------------------------------------------------------------------------------------------------------------------------------------------------------------------------------------------------------------------------------------------------------------------------------------------------------------------------------------------------------------------------------------------Q-Q------------------------------------------------------------------------------------------------------------------------------------------------------------------------------------------------------------------------------------------------------------------------------------------------------------------------------------------------------------
---------------------------------------------------------------------------------------------------------------------------------------------------------------------------------------------------------------------------------oS--XXQS-o--XXX---S-E---------------------------------------------------------------------------------------------------------------------------------------------------------------------------------------------------------------------------------------------------------------------S--------------------------------------------------------------------------------------------------------------------------------------------------------------------------------------------------------------------------------------------------------------------------------------------------------------------------------------------------------------------------------------------------------------------------------------------------------------------------------------------------------------------------------------------------------------------------------------------------------------------------------------------------------------------------------------------------------------------------------------------------------------------------------------------------------------------------------------------------------------------------------------------------------------------------------------------------------------------------------------------------------------------------------------------
SSSSSSSSSSSSSSSSSSSSSSSSSSSS-----------------------------------------------------------------------------------------------------------------------------------------------------------------------------oo-----------------------S----XXXX---XX-S------------------------------------------------------------------------------------oo--------SSSSSSSSSSSSSSSSSSSSSSSSSSSS--------------------------------------------------------SSSSSSSSSSSS?SSSSSSSSSSSSSSS---------------------------------------------------------SSS----------------------------oo----------------------------------------------------------------------------------------------------------------------------------------------------------------------------------------oo------------------------------------oo------------------------------------------------------oo------------------------------------------------------------------------------------------------------------------------------------------------------------------SSSSSSSSSSSSSSSSSSSSSSSSSSSS----------------------------------------------------------------------------------------------------------------------------------------------------------------------------------------------------o-----------------------------------------------------------------------------------------------------------------------------------------------oo------------------------------------------------------------------------------------------------------------------------------------------------------------------
---------------------------------------------------------------------------------------------------------------------------------------------------------------------------------------------------------------EE----------------------XX-XXX<]XXS-----XX----------------------------------------------------------------------------------------------------------------------------------------------------------------------------SSSSS--------------------------------------------------------------------------------SS--------------------------------E----E------------------------------------------------------------------------------------------------------------------------------------------------------------------------------------E-----------------------------------------E-----------------------------------------------XXXX----------------------------------------------------------------------------------------------------------------------------------------------------------------S-SSSSSSSSSSSSSSSSSSSSSSSSSS-----------------------------------------------------------------------------------------------------------------------------------------------X?--X--E--E--?---------------------------------------------------------------------------------------------------------------------------------------------------------------------------------------XXX-----------------------------------------------------------------------------------------------------------------------------------------------------------------
------------------------------------------------------------------------------------------------------------------------------------------------------------------------------------------------------------XXXXXX------------------E-----XXX[]XX---XXX----------------------------------------------oo--oo----------------Eooo-----------------------------------------------------------------------------------------------------X-SSSS--E---------------------------------------------------------------------------E-SS--E----------------------------XXXXXXXXX--------------------------------------------oooo--------------------XXX-----------------------------------------------------------------------------------------------oo---------XXX------------------------------------XX-XXX------------------------------------------------------------------------------------------------------------------------------------------------------------------------------------------------------------------S-SSSSSSSSSSSSSSSSSSSSSSSSSS--------------------------------------------------------------------------------------------------------------------oooo--------------------------------XXXX-----o-------------------------------------XXX--oo-------------------------------------------------------------------XX-------------------------------------------------------------------------------------------------------------------------------------------------------------------------------------------------------------------------------------
------------------------------------------SSSSSS-?----SS----------------E--E------------------------------------S--------SSS-----E--------------SQS---------XX-------S--------------------------------S--------------------S---S---XXX-------------------SS-------------------X------S------------XXX----------------------XXXXX-------XXX------SQQ-----------------------------------------------------------------------------SSQQ--S----SS------------S----S-S-------SQSQ--------------------------------------------------SS-------------------S------------------------------------------------------XS----XXXXX--------------------------------E-----------------------------------------------------------------SSS---X-Xoo--XXXXX-----o---------SS--------------X--------------------------------------S----------------------------------------------------------SSSS------------SSSSSSSSQ-----------------SSS-----------------------------------------ES?--SSSS-------------------------------------------S--SSSSSSSSSSSSSSSSSSSSSSSSS-----------S---SSSSSS----------------------------SSSS---------Q-------------------------------------SQS-------------XXXX--------------------XX-------------------------------------------------------------------XXX-------------------E-------o--------------------------------------S-----------------------------SSSSS------E-------E?---------------------------------------------------------QSQQQSSS----------------------SSSS----------------------------------------------------XX--SSQS------------------------
--------------------------------------------------------------------------XXXXXX------------------------------------------------<>-------------------------XXX------------E--------------o---------------------------------------------o--------XXX-------------------------------------------------------------------XXX--------------XXX------S----E-----------------------------------o----X-SS------------------------------------S----SS------------S----S-----------------o---------------------------------------E-----SS--------------------------------------oooo------------------------------------------------------------------E-------<>------------------------E--------------------------------------------------------------X--------------------------XSSXX------------------------------------------------------oooo-------E------------------------------------------------------------------------------------------------------------------------------------------------------------------------------------------------S-------------------------------------------------------------------------oo----------------------------------------------------------------------XXXX------XXX-----------------------------XX-----------------------------------XXX---<>--------------XXXXX-----o-------------------------------------------------------------<>----------XXXX---------------------ooo----------------------------------------------------------------------------------------------------------E---------------------------------------
--------------------------------------------------------------------X-----------------------------------------------------------[]------------------------XXXX-----------------------------E--------------------------<>-----------XX-XXX-XXXX--------------------------------S--------------------------------------------------------XXX------S---------------------------------------------XX--------------------------------------S----SS-----------------S---------------------------------------------------------------SS---------------E----------------------------------------------------------------------------------------------------[]--o-------------------------------------------------------------------------------------------------------------XXXX-o-------------------------------XS--o------------------------------------------------------------------------------------------------------------------o------------------X------XX---------------------------------------------------------------------------------------------------------------------------------E-----------------------------------------------------------E-----------------------------------------------------------------------------XSS------------------------------------------[]--------------------XXXXXX-------------------S----------------------------------------[]------------------------------------------------------------------------------------------------------------------------------E------------XXX-XXX-----XX---S---------------------------
-------------------------------------------------------------------------------------S-S-----------------------S----------------[]----------------------XXXXXX-------------------------E---------------------E--S-----[]----------------------------oo----X------------------X------S-------------------------------------------------XXXX-------E------SSSS------------------E---------------XX------------E---------o-------------X-Soo?oSS------------S----SQ-------------------Xo-----------------------------------SS----SS--------------<>-----------------------E--------SSSSSSS------------------SSS----------------------------------------[]----------------E---------------------------------------------SQSSSSSS-------------------XXXXX--------------E---XXXX-------------------------------XXX-----------E-ES------E-------------------------E-----------------------------------E------------------------------------------------------------S-----------------------------------------E--------------------------?-ooooooooooooo-------------------------------------------E--<>-----------------------E-----------X----------------------<>--------------------------------------------------------X-------------------XXX---------XXX----------------------------E--XXX------------------------------------------XSS-S---------------E---------------E------[]-----------------------E--S---------------------------------------------E-------------------------------------------------E---------------------------XXX-------------------------------
SS-----------------------------------Q-----SQ------------------XX---XXX------------------------------X--X------------Q--QS?S----------------Q---S?S----XXX-XXX-----------Q------------<>--------------------<>-----E--[]--------X--------------------------------------XXX-XXX---------------XXXX-----XXXX---------------------------XXXXX------SSSS-------------------------<>---------------XX-----------<>-----<>------------SSSS--SSSSSSSSS-----S---------SS---E?SQQQSQS-------------XX---------------------E--------SS---SS-------ESSS---[]-X--S--E---------E---E<>--------------------S------------------------------------------------S-----SXXS--------------<>---SS-----SQS----------------S-----------------------------XXXXXXXXX-------------ooo------<>-X-XXXX-------------Q---S?S----------XXXX-SX----E--<>-----E--<>------------------------<>------------------------X--------SSSSSS-----------------------------S---------------------X-----S--QQQ---SQQQ----------------------------<>---------------------SSSSS??SSSSSSSSSSSSS-----------E--S-Q------------QQQ----------<>--[]--------------SS------<>----------XX---Q-----Q-----E---E--[]--------------------------------XXXX---XXXXX-------------------------------XXXX------------------X------XXX-----------<>------------XXXX--------S------E--------------XXX-----------------<>--------------<>------XXX---QQ-------------E--<>-----E--?--------X-----------------------E?QQQQ-QS--SSS-------------------S-------------E--------<>--------------------------XXXX---SSS---------ES--------------
------o-------------------------------------------------------------------------------------------E--X--XX-------------------------------E------------XXXX-XXX------------------------[]--------------------[]----<>--[]---------XXXXXXXXX----------------------------XXX--XXXX-----------------------------------------------------XXXXXX-----------E--E--------------------[]--------------XXX-----------[]-----[]--------E----------------------------------------------------------------------------------<>---------------------<>------[]-XXX--<>--------<>-E<>[]-------------------------X---X----------------------------------X----------------E--------E--[]--------------------------------------------------------XXXX------------------------------[]-XXXXXX-----------------------------XXXXX-SXX--<>--[]----<>--[]------------------------[]---------------------oooX-------------------------X------------------------o-----------X--------S----------------------------------------[]---------------E-----SSXS--------------------------<>------------------------------[]--[]----------------------[]---------XXX------------------<>--[]--------------------------------------------------------------------------XXXXX-XX------------------------------------[]------------------------------<>-------------XXXX---------------E-[]---------X----[]--------------------------<>--[]----<>----------XXX--------------------------------------------------------------------<>--------[]--<>---------------------XXXXX----------XEX-----E-E--E-----E-
-----XXXXX-----------------------------------------E----XXXXX------------------------------------X---X--XXX-----------------------------<>-----------XXXXX-XXX------------------------[]---------X----------[]----[]--[]---------------------------------------------XXXX--XXXX---------------------X----XXXX----------------------XXXXXXX--------------X--------------------[]-------------XXXX-----------[]-----[]-------<>----------------------------------------------------------------------------------[]---------------------[]------[]-XXX--[]--------[]<>[][]---------------------X---X--------------------------------------XXXX--SS--------<>-------<>--[]-X----------------------X-----------------------------XXX-------------o-------------------[]-XXXXXX---------o------------------XXXXXX-SSS--[]--------[]--[]------------------------[]----------------------X-X---X-X------------------X-X----------------------XXXXXXXX-----XX-------S----------------------------------------[]---------------------SSXS--------------------------[]------------------------------[]--[]----------------------[]----<>--XXXX------------------[]--[]-----------------XX---------XXXX-------------------XXXX---------------<>-XXXXXX-X-X-------------------------------XX--[]------------------------------[]------------XXXXX--------------<>-[]--------XXX---[]--------------------------[]--[]----[]---------XXXX--------------------------------------------------------------------[]--------[]--[]--------------------XXXXXX---------XXXXX-------------E---
-------------------------------E---------E---------------------------------------------------E---X---X--XXXX--------------------------E-[]--E-E-----XXXXXX-XXX---------X----E------E--[]---------X---EE-E---[]----[]--[]--------------------------------------------XXXXX--XXXX--------X-oooo--XXXXXXX----------------------------XXXXXXXX--------------X--------------------[]---------E-EEXXXX----E--E---[]-E---[]-------[]-----------------------------E-E---------------------------------------EE---------[]---------E--------E--[]-E----[]-XXX--[]--------[][][][]---------------------X---X----------X---------------------------XX--------------[]-----E-[]--[]---------E-EE-------EE--X-E---------E----------------XXXX------------XXX---------E--------[]-XXXXXX--------XX--E-----E----E-E-XXXXXXX-SSS--[]-----E--[]--[]-----------E-EE-E----E--XX------E--------------XXXX---X-X-----------------XXXX-E--------------------XX-----------XXX------S----------------------------------------[]-------E-EEE---------X---o-o-----EE-E--------------[]-----------------EE--------E--[]--[]-------------------E--[]----[]-XXXXX---------------E--[]--[]-------------------------------------XXX------------------------------[]XXXXXXX?X-XX----------------------------------[]------------------------------[]-----------XXXXX--------E-E--E-[]-[]---------XX---[]------------------E-E-E---[]--[]----[]--------XXXXX-----------------------------E--E-------E---------------------E-EE--[]-E-E----[]--[]----------------E--XXXXXXX--------XXXXX------------------
XXXX------------------X-XXXXXXXXXXXXXXXXXXXXXXXXXXXXXXXX------------------------XXX-XXXXXXXXXXX-XXXXXXXXXXXXXXXXXXXXXXXXXXXXXXXXXXXXXXXXXXXXXXXXXXXXXXXXXEoXXXXXXXXXXXXXXXXXXXXXXXXXXXXXXXXXXXXXXXXXXXXXXXXXXXXXXXXX--XXXXXXXXXX------------------X----XXXX-XXXXXXXXXXXXXE-XXXXXXXXXXXXX-XXX------------------------XXX-XX---XXXXXXXXXXXXXXXXXXXXXXXXXXXXXXXXXXXXXXXXXXX----XXXXXXXXXXXXXXXXXXXXXXXXXXXXXXXXXXXXXXXXXXXXXXXXXXXXXXXXXXXXXXXXXXXXXXXXXXXXXXXXXXXXXXXXXXXXXXXX----XXX---XXXX--XXXXXXXXXXXXXXXXXXXXXXXXXXXXXXXXXXXXXXXXXXXXXXXX--XXXXXXXXXXXXXXXXXXXXXXXXXXXXXXXXXXXXXXXXXXXXX--XXXXXXXXXXXXXXXXXXXXXX--XXX---XXXXXX---XXXXX---------XXXXXXXXXXXXXXXXXXXXXXXXXXXXXXXXXXXXXXXXXXXXXXXXXXXXXXXXXXXXXXX-------XXXX----------------------------XXXXXXXXXXXXXXXXXXX-XXXXXXXXXXXXXXXXXXXXXXXXXXXXXXX--SSXX-XXXXXXXXX-XX--XXXXXXXXXXXXXXXXXXXXXXXXXXXXXXXXXXXXXXXXXXXXXXXXXX--oE-XXXX--XXXXXXX----XXXXXXXXXXXXXXXXXXXXXXXXXXXXXXX--------XXXXXXXXXXXXXX--XXXXXXXXX----XXXXXXXXXXXXXXXXXXXXXXXXXXXXXXXXXXXXXXXXXXXXXXXXX---XXXXXXXXXXXXXXXXX-XXXXXXXXXXXXXXXXXXXXXXXXX-XXXXXXXXXXXXXXXXXXXXXXXXXXXXXXXXXXXXXXXXXXXXXXXXXXXXXXXXXXXXXXXXXXXXXXXXX-XXXXXXXXXX-XXXX---------------------------------------------------X-X-XX--X-XXXXXXXXXXXXXXXXXXXXXXXXXXXX---XXX----XXXX--S-XXXXXXXXXX-------------XXX--XXXXXXXXXXXXXXXXXXXXXXXX----XXXXXXXXXXXXXXXXXXXXXXXXXXXXXXXXXXXXXXXXXQ--XXXXXXXXXXXXXXXXXXXXXXXXXXXXXXXXXXXXXXX-XXX-XXXXXXX---XXXXXXXXXXXXX-XXXXXXXXXXXXXXXXXXXXXXXXXXXXXXXXXXXXXXXXXXXXXXXXXXXXXXXX--XXXXX----XX--X-XXXXXXX--X-XXXXXXXXXXXXXXXXXXXXXXXXX-XX