-----------------------------------------------------------------------------------------------------------------------------------------------------------------------------------------------------------------------------------------------------------------------------------------------------------------------------------------------------------------------------------------------------------------------------------------------------------------------------------------------------------------------------------------------------------------------------------------------------------------------------------------------------------------------------------------------------------------------------------------------------------------------------------------------------------------------------------------------------------------------------------------------------------------------------------------------------------------------------------------------------------------------------------------------------------------------------------------------------------------------------------------------------------------------------------------------------------------------------------------------------------------------------------------------------------------------------------------------S-X---Q-Q----------------------------------------------------------------------------------------------------------------------------------------------------------------------------------------------------------------
----------------------------------------------------------------------------------------------------------------------------------------------------------------------------------------------------------------------------------------------------------------------------------------------------------------------------------------------------------------------------------------------------------------------------------------------------------------------------------------------------------------------------------------------------------------------------------------------------------------------------------------------------------------------------------------------------------------------------------------------------------------------------------------------------------------------------------------------------------------------------------------------------------------------------------------------------------------------------------------------------------------------------------------------------------------------------------------------------------------------------------------------------XXXX----------------------------------------------------------------------------------------------------------------------------------------------------------------------------------------------------------------------------------------------------------------------------------------------------------------------------------------------------------------------------------------------------------------
-----------------------------------------------------------------------------------------------------------------------------------------------------------------------------------o--------------------------------------------SSSSSSSSSSSSSSS------------------------------------------------------------------------------------------------------------------------------------------------------------o--------------------------------------------------------oo------------------------------------------------------------------------------SSSSSSSSSSSS-SSSS---------------------------------------------------------------------------------------------------------------------------------------------------------------------------------------------------------------------------------------------------------------------------------------------------------------------------------------------------------------------------------------------------------------------------------------------------------------------------------------------------------------------------------------------------------------SSSSSSSSSSSSSSS------S-SSSSS----------------------------------------------SSSSSSSSSS----------------------------o---------------------------------------------------------------------------------------------X------S------------------------------------------------------------------SSSSSSSSSSSSSSSSSSSSSSSSSSSSSSSSSSSSSSSSSSSSSSSSSSSSSSSS------------------------------------------------------------------------------------
-------------------------------------------------------------------------------------------------------------------o------------------------------------------------------------------EE-------------------------------------------------------------------------------------o-------------------------------------------------------------------------------------------------------------------------------------------------------------------------------------XXXX-----------------------------------------------------------------------------SSSSSSSSSSSSSSSSSSS---------------------------------------------------------------------------------------------------------------------------------------------------------------------------------------------------------------------------------------------------------------------------------------------------------------------------------------------------------------------------------------------------------------------------------------------------------------------------------------------------------------------------------------------------------------------------------------------------------------------------------------------------------------------------------------------------------------------------------------------------------------------S----XXXXX--?----oo--------------------------------------------------------------------------SSSS---SSSS-------------SSSS--SS-------------------------------------o---------------------------------------------------------
--------------------------------------------------------------------------E---------------------------------------------------------------------------------------------ooo----------XXXXX-X--------------------------------------------------------------------------------------------------------------------------------------------------------------------------------E-----------------------------------------------------------------------------------------------------------------------------------------------------------------------SSSSSSSSSSSSSSSSSSS-------------E--------------------------------------------------------------------------------------------------------------------------------------------------------------------------------oo---o--------------------------------------------------------------------------------------------------------------------------------------------------------------------------------------------------------------------------------------------------------------------------------------------------------------------------------------------------------------------------XX---------------------------------------------------------------------------------------------o------------------------ooo--------------------------------------------------------------------?---X----XX----------------------------------------------------------------------E--SSSSS---SSSS--E--------SSSSSS----------------------------oooo---------XX-------------------------------------o--oo--ooo-ooo-----
----------------XSSSSSS------X--oo--XXXXX----oo----------S?S--------SS--SSSSSSSS--------------------------------S?SS------------SSS-------------------------------------XXXXX-----------------------------------------XXX--------------------------------------------------SSS----------------------------------------------------------------------------------------Q-----S---SQS---?-----------SSSS-----XX------------------------------------------------------------------------------S-----------SS---------------------------------------SSQQSSSSSSSSSSSSSSSSSSS---Q--------SQSSS---SS----------------------------------SSSS---------------------------------------SSSS-----------------------------------------------?SSS----------------SSS---------oo--XX------------X---------SS----SSS---S---SSS-------------------------oQ------------------------------------------------------------------------SS--SSS---------SSSSSQ---------SSSSSSSSSSS---S------------------------------------------SQQSS--------------------------------------------------------------------SS----?SSS-------SSSSS--------------------------SSSS--------------------------X--SSSS-----------------------SSSS----------------------------------------------------XX---------------E--------------S---SSSSS---------------SSSS--------XX--------------XX-----------XX---------oo--------------------SSSSS--SSS-------SSSS---------------XXS--------SS----------S-------------SSSSSSSS--------------XXXoo--XXXX------------------------------------------XXo--------XX-----------------
---------------XXX-----------------------------------XXXE-------------------------------------------------------------------------ooo-----------------------------------------------------------oooo-----------------XXXX-------------------------------------------------------------------------------------------------------------------------------------------------------------------XSS---------------------E---------------------XXX----------------------------------------------X------------------------------------------------------------------------------------------------------------------------------------------------------------------------------------------------------------------------------------------------XSS-------------------------o---------------------------------------------------------------------------------------------------------------------------------------------------------------------------------------------------------------------------------------------------------------------------------------------------------------------------------------------------------------------E---o--------------------------------------------------------------------------------------ooooo----------------------<>------------------------------------------------------------------o----XXXXX--------XXX---------------------------------------------------------------S--------SS----------------------------------------------------------------------------------------------------X--------------------------E-
--------------XXXX--------o-----------------------------------------------------------------------------------------------------------------------------E-----------------------------------------------------------XXXXX----------------------------------------------------------------------------------------------------------------XX------------------------------------------------X----------------------XXXX------------------XXXX--XX------------------------------------------XX-----------------------------------------------------------------------------------------------------------------------------------------------------------------------------------------------------------------------------------------------XXX-------------------------XX----X----------------------------------------------------------------E---------E---------------------------------------------------------------------------------------------------------------------------------------------------------------------------X---------------------------------------------------------------------------------------------------XS--oo---XXX----------------------------------------------------------------------------------------------------------------[]----------X---------------------------------------------------oXXX---------------------------------------------------o--------------------------------SS-------SS------------------------------------------------------------------X-------------------------------XXX-----------------------XXXXX
------------XXXXXX-------------------------------XXX-----------------------------------------oo--------------XS-SS-------------------------------------<>-----------------------XXXX--------------------------------XXXXX----------------------------------------------------------------XXX----------------------------------------------XX-oo---------------------E-------E---------------XX--SSSSSSS----------------------------------------------------------S--------------------EX-XXX-----------------------------------SQ----------------------??----------E-E-------------------------E-------------S-------E--S------------oo----------------------------------------------------------------------------------S----------------XXXS--S------------XXXX---------------------------------------------------------o------------------<>--------<>-----------E------------------E-----------X---------------------------------------------------------------------------------------E---------------------------------------XX---------------------------------E----------------------------------------------------------------XX----------------------------------------------E--o-------------------------------------------------------------------------XXX--o------S------------------------E-----------ooo----------------------XXXX----XXXX------XXX----------------------------------------------------------E-------SS------?----o---S-------------------------------------------------XS-----------------------------XXXXXXX----------------S-SQ------
-----------XXXXXXX---SS-----------XXX--XXXXX--------------oS-------XX-------------XX------------------------XXX-----------------S----------X-----------[]---------------XXX----------------XXXXXXXX--oo------------XXXXXX--------ooQ----------------------------------------QQ---------S-------------------------------------------------XXX-----------------------<>--QQQ------S?S-----XXXXXX----------X-----XXXX------------------XXX---------------------------------------E------<>XX-XX---Q-QQ----S--------E--S--------------------------------SSSS?SSSSSSSSSSSSSS-------QQ---SQS--------<>---------E----------<>-----E----------------------------------QQQ-------------------------------S----------------------XXX-E----SSS-----XXXXX-------------------X-------------------Q---SSS----XX--X-----------X------------------XXX--------[]--------[]-------E--<>-----------------<>----------XX---------------S----------S--ESSS----------QQQ?--QQS--------------S-----E-------------<>-----------ES?S--------------XXX------XXX----------E------E-------E------<>--------QQQQ----------------------------------------S---SSS----XXX--S--------------------------SQQ-SQ----------<>--------------------------------------QQo----------------------------XXXXX--<>----------S---?QQ--SSQSS----------<>-----------------XXXX--SS-----XXX----------------------------------------------SS--------XXXX---S-----------------SSSS---E-------SSS---S-S--SS------SS-----?--------------------XXX---------X-XX----------------------------XXX-XX---------XXX----------------
----------XXXXXXXX-------------XXXX------------------------------XXXX--X---E-----XXX-----------------------XXXX----------E----------------XX-----------[]-------------E------------------------------------------XXXXXXXX-------------------X-------E-----------------------------------------------------------------------------------XXXX----------------E------[]------------------XXXXXXX-------------------------------------------o-----------------------------------<>------[]XXXXX-----------E-------<>---------------------------E-------SSSS-SSSSSSSSSSSSSS-----------------------[]--E-----<>----------[]----<>-----------------------------------------------------------------------------------------XXXXX-------------XXXXXX--------------X-----------------X----------------XXX--XX--------EXX----------------E------------[]--------[]------<>--[]-----------------[]---------XXX------------------E----------------------------------------------------<>-------------[]-------------------------------------XXXX-XX------XX-----<>------<>------[]------------------------------------------------------EE------XXXX---------------------------------------------[]----------------------------------------------------------------------------[]-------------------------------X--[]---------E---------------------------------------------------------------------------X----------------------------E-----<>----E------------E----o-----SS-S---SSSS------------XXXX----------XX-XX-SSS-----------------------XXXXXXX----------------------------
---------XXXXXXXXXX--------XXXXXX-------------------------------EXXXX--XX-------XXXX----------------------XXXXX---------<>---------------XXX-----------[]------------<>--------o-------------------o--------XXXXXXXXXXXXX-------------------------------E------------------------------------------------------------------------------XXXX----------------<>------[]------------------XXX-XXX---------X--------------------------------XXXXX--------------------------------[]------[]XXXXX----------<>-------[]--------------------------<>-------SSSSSSSSSSSSSSSSSSS-----------------------[]-<>-----[]----------[]----[]----------------------------------------------------------------------------------------XXXXXX------------XXXXXXX----------X-------------------X-X---------------XXXX--XXX-------XXX---------------<>------------[]--------[]------[]--[]--X--------------[]-<>-----XXXX-----------------<>--------------------------------E-------------------[]------<>-----[]------------------------------------XXXXX--X-----XXX-----[]------[]------[]--------------------X----------------------------------------XXXXXX-SSSS---------------------------------------[]--------XXXXX---------------------------------------------------------------[]------------------------------X---[]--------<>-------------------X----o-------------------------------------------------XX---------------------E------------[]----------------------------SSXS---SSSS---------XXXXX---------o-XXX--X--------------------------XXXXXXXX-------------X-XX-------oooo
--------XXXXXXXXXXX-------XXXXXX------------------------E-E----XXXXXX--XXX-----XXXXX------------------E--XXXXXX---------[]-----------------X-----E-EE--[]------------[]--------XX-------------------E------XXXX--XXXXXXXX----------------------------S-----------EE-------------------------------------------E-E-E--E---------E-E----XXXXX---------EE-E---[]------[]--------E-E------XXXXXXXX--------XX------------------------------------------------------------E-E-E----[]-E----[]XXXXX----------[]-------[]-E------------------------[]-------SSSSSSSSSSSSSSSSSSS----------E-E----------[]-[]-----[]----------[]-E--[]-E---------S---------------------------------------------------------------------------XXXXXX-----E------XXXXXXXXS--S-----XX--XX-----------------X---XX----E----XXXXX--XXXX-----XXXX-------------E-[]------------[]--------[]-E----[]--[]--X----E-E-EE----[]-[]----XXXXX---EE------------[]---E------------------------------------------------[]------[]-----[]----EE-----EE-----E-E--------------XXXXXX--X----XXXX-----[]-E----[]-E-E--[]----------------E-E-X----------------------------------------XXXXX--------------------E-E----------------------[]-------------------------------E----------------------------------ooo-------[]----------------------------E-X---[]--------[]------------------XX---XXX-------------------------------------------EE--XXXooo-------------------------------[]----------------------------------oS-SS---------XXSX-----------XXXX-XX---XX-E------------------XXXXXXXXX-----XX------X-----SS?SS----
XXXXXXXXXXXXXXXXXXXXXXXXXXXX----------------------------XXXXXXXXXXXXXXXXXXXXXXXXXXXXXXXXXXXX----XXXXXXXXXXXXXX--XXXXXXXXXXXXXXXXXXXXXXXXX--XXXXXXXXXXXXXXXXXXXXXXXXXXXXX----------------------------XXXXXXXXXXXXXXXXXXXXXXXXXXXXXXXXXXXXXX------XXXX-XX-XXXXXXXXXXXXXXXXXXXXXXXXXXXXXXXXXXXXXXXXXXXXXXXXXXXXXXXXXXXXXXXXXXXXXXXXXXXXXXXXXXX--XXXXXXXXXXXXXXXXXXXXXXXXXXXXX--XXXXXXXXXXXXXXXXXXXXXXXXXXXX---------------------------------------------------XXXXXXXXXXXXXXXXXXXXXXXXXXXXXXXXXXXXXXXXXXXXXXXXXXXXXXXXXXXXXXXXXXXXXXXXXXXXXXXXXXXXXXXX-XXXXXXXXXXXXXXXXXXX--XXXXXXXXXXXXXXXXXXXXXXXXXXXXXXXXXXXXXXXXXXXXXXXXXXXXXXXXXXX----------------XXXXXXX---XXXXXXXX---XX-XXXXXXXXXXXX----XXXXXXXXXX-X-XX-XX-X-XXXXXXXX---XXXXXXXXXXXXXXXXXXX--XXXXXXX--------------X------X------XXXXXXXXXXXXX--XXXXXXXXXXXXX-----XXXX----XXXXXX----XXXX--XXXXXXXXXXXXXXXXXXXX--XX--XXXXXXXXXXXXXXXXXXXXXXXXXXXXXXXXXXXXXXXXXXXXXXXXXXXXXXXXXXXXXXXXXXXXXXXXXXXXXXXXX---X-----XXXXXXXXXXXXXXXXXXXXXXXXXXXXXXXXXXXXXXXXXXXXXXXXXXX-XXXXXXXXXXXXXX-X-XXXXXXXXXXXXXXXXXXXXXXXXXXXXXXXXXXXXXXXXXXXXXXXXXXXXXXXXXXXXXXXXXXXXXXXXXXXXX--XXXXXXXXXXXXXXXXXXX-------XXXXXXX---XXXXXXXXXXXXXXXXXXXXXXXXXXXXXXXX-XXXXX-------XXXXXXXXX---XXXXXXXXXXXXXXXXXXXXXXX--XXXX--XXX------XXX-------XXX----X----XXXXXXXXXXXXX---XXXXXXXXXXXXXXXXXXXXXXXXXXX------XXXXXXX----------------------------XXXXXXXXXXXXXX--XXXXXXXXXXXXXXX-------------XXX--X---XXXXXXXXXXXXXXXXXXXXXXXXXXXXXXXXXXXX---X-X-XXXXXXX--XXXXXXX-----------XX-XXXXX-XXXXXXX-XXXXXXXXXXXX---XXXXXXXXXXXXX-------------XXXX-----ESSSS-