------------------------------------------------------------------------------------------------------------------------------------------------------------------------------------------------------------------------------------------------------------------------------------------------------------------------------------------------------------------------------------------------------------------------------------------------------------------------------------------------------------------------------------------------------------------------------------------------------------------------------------------------------------------------------------------------------------------------------------------------------------------------------------------------------------------------------------------------------------------------------------------------------------------------------------------------------------------------------------------------------------------------------------------------------------------------------------------------------------------------------------------------------------------------------------------------------------------------------------------------------------------------------------------------------------------------------------------------------------------------------------------------------------------------------------------------------------------------------------------------------------------------------------------------------------------------
------------------------------------------------------------------------------------------------------------------------------------------------------------------------------------------------------------------------------------------------------------------------------------------------------------------------------------------------------------------------------------------------------------------------------------------------------------------------------------------------------------------------------------------------------------------------------------------------------------------------------------------------------------------------------------------------------------------------------------------------------------------------------------------------------------------------------------------------------------------------------------------------------------------------------------------------------------------------------------------------------------------------------------------------------------------------------------------------------------------------------------------------------------------------------------------------------------------------------------------------------------------------------------------------------------------------------------------------------------------------------------------------------------------------------------------------------------------------------------------------------------------------------------------------------------------------
------------------------------------------------------------------------------------SSSSSSSSSSSSSSSSSSSSSSSSSSSS------------------------------------------------------------------------------------------------------------------------------------------------------------------------------------------------------------------------------------------------------------SSSSSSSSSSSSSSSSSSS-----SSSS---------------------------------------------------------------------------------------------------------------------------------------------------------------------------------------------------------------------------------------------------------------------------------------------------------------------------------------------------------------------------------------------------------------------------------------------------------------------------------------------------------------------------------------------------------------------------------------------------------------------------------------------------------------------------------------------------------------------------------------------------------------------------------------------------------------------oo---------------------------------------------------------------------------------------------------------------------------------------------------------------------------------------------------------------------------------------------------------------------------------oo------------------------------------------------------
------------------------------------------------------------------------------------------------------------------------------------------------------------------------------------------------------------------------------------------------------------------------------------------------------------------------------------------------------------------------------------------------------S----------------------------------------------------------------------------------------------------------------------------------------------------------------------------------------------------------------------------------------------------------------------------------------------------------------------------------------------------------------------------------------------------------------------------------------------------------------------------------------------------------------------------------------------------------------------------------------------------------------------------------------------------------------------------------------------------------------------------------------------------------------------------------------------------------------------XXXX-----------------------------------------------------------------------------------------------------------------------------------------------------------------------------------------------------------------------------------------------------------------------------------E--o--------------------o---------------------------
----------------------------------------------------Eooo----------------------------------------------------------------------------------------------------------------E-------------------------------------------------------------------------Eooo------------------------------------------------------------------------------------------------------------------------------------------------S-----------------------------------------------------------------------------------------------------------------------------------------------------E---------------------------------------------------------------E-------------------------------------------------------------------------------------E------------------------------------------------------------------------------------------------------------------------------------------------------------------------------------------------------------------------------------------------------------------------------------------------S-------------------------------------------------------o----------------------------------------------------------------------------------------------------------------------------------------------------------------------------------------------oooo-------------------------------------------------------------------------------------------------------------------------------X-X---------------------------------------------------------------------------------------------------XXXXXX-----------------------------------------------
-------XXX---------S--------------------------------XXXX-----------------------------------------------------------SS-----------------------------------------------------SSSQ-----------------SSSSS----------------SSSSSS------------------------XXXXX-----------------XX------------------------------------------------------------------------Q--------------------------------------oooooo-----SS-o--------------------------------------------------------S-SS------SSS-----------------------------------------------------QQ----------------------SSSS--------------SS---------------------------------------------SQSSSSS-----------------SSS-----------------------------SSSS--------S---S------------SSQSSSSS----SS-------SS---------?----------------------------------o-SS---SS-------------------S-----------------S---------S---S----S-------SS-------------------------------------SSSS------SS--------------------------------------------------------Q-----------------S---SSS-----------------S-------------------------------------------------------XXX-----------------------------SSS--------------------------------------------------Q----------------------------S------SSS--------------------S----SS-----------------SSS---------QSQ----------XXXX--------------------------SSSS-------------------------------------------------------------------------------XXX----------------------------------------------------------------SS------------------------------------------------------------------------------QS------------------------
------------------ES-------------------------------------------------------------------------------------------------------------XX----------------------------------------------------------------------------------------------oo-------------------------oooo---------------------------------------------------------------------------------oo-------------------------------------------------SS--o----------------------------------------------------------------------------------------------------------------------------------------------------------------------------------------oo------------------------------------------------------------------------------------------------------------------------------------------S------X-o----------------------------XE--------------------------------------------------------------ES---------------------E--------------------------------------------------------------------------------------------------------------------S-----------------S------------------------------------------------------------------------------------------------------------------------------------------------E-----------------------------------------------------ES----SS-----------------------------------------------------------------------------------------------------------------------------------------------------------XXX-------------------------------------------------------------------------------------------------------------------------X------------o-----------------------------------
-----------------<SS-------------------------------------------------------------------------------------------------------------XX----------------------------------------------------------------------------------------------------------------------------------------------------------------------------------------------------------------o-------------------------------------SSSSSS---S-SS-S---------XXX----------------------------E-----------E-----------------------------------------------------------------------o--------------------------------------------------------------------------------------------------------------------------------------------------------------------------------------------------------------------------------------------XXS-----------------------------------------------------------S----S-----------------------------------------XSSS-o------------------------------------------------------------------------------------------S------------------S------------------------------------------------------------------------o------------o----------------------------------------E-----------------------------o-------XSS--o-----------------------------S----SS--------------------------------------------------------------E--------------------------------------------------------------------------------------------XXX----------------ooo-----------------------E------------------------------------------------------------------------------------------------------------S------------------
----------------ESS---------------------------------------------------------------E-----------------------E----------------E-----XX-----------------------------------------------------------------S-------------E------------------o-----------------------SSSSSSS-------------------------------------------------------------------------E-------------------o-----------------------SSSSSS---SoSS-S------------------------------E--------<>-------E--<>---S---SS-----------------------S----------------------SSS-------------------------------E-------------------E----------------------------------------------------------------------------------------X----------------------E------------------------------------E-----------------o------------------------------XXXX--------------------------XX-------------------------------So?--S--------------------SS------------------XXX-S-------------------E--------------------------------E---------------------------------------S--------------S--SS---XXXX-----------------------Q--E-----------------------S-S--SSS--------------------E---------------------------------------<>---------------SS-------------------XXS-----------------------------E--SS----SS------------------------------------------E------------------<>--------------------------------------------------------------------------------------------XXX-----------------------------------------<>----------------------------------E-----------------------E-----------X-------E--S------E-----------------SoS------------------
---------------XXXX-X-------------------S--------------------------E--?----------<>--oo-------XXX-XX-----SS-----S---QQS------XX--XX----------------------------------------SSS-----XXX--X--------------E-----E---<>------------X---------------XXXX-SSS----------------------------------------------------------------------------S--------<>---S------------------------E---SS---------------XX-XSSS-S-----E-EEE-------------------<>--<>----[]------<>--[]-------------QQQ----------------------------<>------------X-------QQ?SSSSS---------E----<>-----------E------<>-----------ooo----------------------------------SSSSSSSQS-------QQQQ--Q-----S----------XX----------------SSS--<>----------------XX--X-----------X--<>-----XXXXXX----------XX------------------------XXXX--S----SSS----------------XXX---------------------------S---SSS--S-------QQQ-----------------------------XXXX-SS-----------XXX---<>-------------------------------<>-----Q----------Q--------------------SSSS--S--------------SSS----------------------Q-------<>------------------------------------S-----S----X<>------------EE-E----------------E--------[]---------------------------S-------XXXX-SS-Q----?SQS----------E----<>---S---SSS--S-------------SSSSS--------S-S---------<>---------------E--[]------------------E-EEE-E-----------------------E-----------X--------------------------S--X-XXX---------XXXXXX--------------------------[]-----------------Q---SS-------E--<>-----E--QQQ-----------<>---------XXX---E--<>-----E--<>----------SSSS---SSS-----------------E
--------------XXXXX-XX-----------E-----------------------X--------<>-------------[]----------XXXX-XX-----E-------------------XX--XX----------------E------------------------------XXXX--XX------------<>----<>---[]-----------XX------------------------------------------------------------------------------------------------------------[]---------------E---------XXXXX-------------------XX-----SS----XXXXXXXXXX--------XXXXXX-[]--[]----[]------[]--[]--------------------------------------------[]-----------EX-----------------------<>----[]----------<>------[]----------------------------------E------------------------------------------------E--XXX---------------------[]--E------------XXX--XX----------X--[]----------------------------------------------XXXXX-------------------------XXXX-------------------------EXX-----------------------------------------------XXXXX-SXS----------------[]------E--------------E------E--[]----------------------------------------------------------XSS------------------------------[]---------------------------------------E-----XXX[]---------X----XXXXX-----XXXXXX--E--------[]-------------E----------------E---XXXXX-SS----------------E--<>----[]----------------------------SS---------------------[]--------------<>--[]------------X--XXXXXXXXXXXXXX------------------<>--XX--X----X-----------------------------X-XXX-----------------------------------------[]-------------E---------------<>--[]----<>----------------[]--------XXXX--<>--[]----<>--[]-------------------------------E-XXXXX
----------<>-XXXXXX-XXXXX-------<>-----------X-----XX----X--------[]-------------[]---------XXXXX--XXX-------E---------------XX--XX---------------<>-----------------------------XXXXX--XX------------[]----[]---[]----------XXX------------XXX---------oooo-------------------X---------------------------------X--------------------------[]--------------------------------------XX---------XXX----SS-----------------------------[]--[]----[]------[]--[]--------------------------------------------[]----------XXX-----------------------[]----[]----------[]------[]-----------------------XXXXX---------X--------------------------------------------<>-XXXX---------------------[]-<>-----------XXXX--XXXX----E---X--XX------------o--------------------------------XXXXXX----------<>------------XXXXX------------------------XXXX----------------------------------------------XXXXXX-SSSX----------------------<>--------------------<>--[]----------------------------------------------------------X-S------------------------------[]----<>--------------------------------<>----XXXX[]--------XXXXXXXX---------------<>--------[]------------<>---------------<>----X-XX--S---------------<>--[]----[]---------------------------SSSX--------------------[]--------------[]--[]-----------XX----------------------------------[]-XXX--X----X-----------------------------X-XXX----oo-----------------------X-----------[]------------<>---------------[]--[]----[]----------------[]-------XXXXX--[]--[]----[]--[]--------------------------------X-X---
--------E-[]XXXXXXX?XXXX?-------[]-----------XE----------X--EE-E--[]-------------[]--------XXXXXX--XXX-----------------------X---XX----EE---------[]--------------------E-------XXXXXX--XX----EE------[]----[]-E-[]---------XXXX----------XXXXX--------------------------------X---------------------------EE----X-----E-EE--------E-----E--[]--------------------------------E----XX----------XXX---E-------------------------------[]--[]----[]------[]--[]----------------------------------------E---[]-----------XX-----------------E-EE--[]----[]--------E-[]--E---[]-------------------------------------X----E---------------------------E-----------[]XXXXX------E-EE-----E--E--[]-[]-----EE---XXXXX--XXXXE-------X------oooo----------------------------------E-E--XXXXXX-E-E------[]-----------XXXXXX---EE----E-E-----------XXXXX------E------------E-EE-------------EE-E-EE--XXXXXXX-SSS-----------------------[]-----------E--------[]--[]----------E-EE-------E--------------E-------EE------------X-S------------------------------[]----[]-E-------------------------E-E--[]-XE-XXXX[]-S-----XXX---------------------[]--------[]------------[]---------EE-E--[]-E--X-XX--SS----E---------[]--[]-E--[]--E--E-------E-----E-------X--X----E-E-------------[]--------------[]--[]------EE--XXX----------------------------EE----[]XXXX--X--E-X------------------------EE---X-XXXX---XXX----------------------------------[]------------[]---E--------E--[]--[]----[]-E----E-EE------[]------XXXXXX--[]--[]-E--[]--[]-----------------------------XXXX-----
XXXXXXXXXXXXXXXXXX--XXXXXXXX-XXXXXXXXXXXXXXXXXXXXXXXXXXXXXXXXXXXXXXXXXXXXXXXXXXXXXXXXXXXXXXXXXXXXXXXXXXXXXXXXX-XXXXXXXXXXXX--XXXXXXXXXXXXXXXXXXXXXXXXXXXXXXXXXXXXXXXXXXXXXXXXXXXXXXXXXoXXXXXXXXXXXXXXXXXXXXXXXXXXXXXXXXXXXXXXXXXXXXX--XXXXX-----------------XXXXX-XXXXXXXXX----XXXXXXXXX--XXXXXXXXXXXXXXXXXXXXXXXXXXXXXXXXXXXXXXXXXXXXXXXXXXXXXXXXXXXXXXXXXXXXXX---XXX-----XXXXXXXXXXX----XXXXXXXXXXXXXX-----------------------------XXXXXXXXXXXXXXXX--XX--XXX-XXXXXXXXXXXXXXX--XXXXXXXXXXXXXXXXXXXXXXXXXXXXXXXXXXXXXXXXX--XXXXXXXXXXXXXXXXXXX-XXXXXXXXXXXXXXXXXXXXXXXXXXXXXXXXXXXXXXXXXXXXXXXXXX-----------XXXXXXXXXXXXXXXXXXXXXXXXX-XXX--XXXXXXXXXXXXXXXXXXXXXXXXXXXXXXXXXXXXXXXXXXXXXXXXXXXXXXXXXXXXXXXXXX--XXXXXXXXXXX-X------XXX------XXXX----X----XXXXXXXXXXXXXXXXXXXXXXXXXX--XXXXXXXXXXXXXXXXXXXXXXXXXXXXXXXXXXXXXXXXXXXXXXXXXXXXXXXX-XXXXXXXXXXXXXXXXXXXXXXXXXXX----XX-XXXXXXXXXXXXXXXX--SSX-------XXXXXXXXXXXXXXXXXXXXXXX-XXXXXXXXXXXXXXXXXXXXXXXXXXXXXXXXXXXXXXXXXXXXXXXXXXXXXXXXXXXXXXXXXXXXXXXXXXXXXXXXXXXX--XXXXXXXXXXXXXXXXXXXXXX-XXXXXXXXXXXXXXX--X--XoXXXXXXXXXXXXXXXXXXXXXXXXXXXXXX[]-XXXXXXXX----------------------XXXXXXXXXXXXXXXXXXXXXXXXXXXXXXXXXXXXXXXXXXXXXXXXXX---SXXXXXXXXXXXXXXXXXXXXXXXXXXXXXXXXXXXXXXXXXXXXXXXXXXXXXXXXXSXXXXXXXXXXXXXXXXXX-XXXXXXX-XXXXXXXXXXXXXXXXXXXXXXXXXXXX-----------------XXXXXX-XXXXXXXXXXXXXXXX--XXXXXXXXXXXXXXXXX-X-----X-XXXXXXXXXXXXXXXX------------------XXX-------X-XXXXXXXXXXXXXXXXXXXXXXXXXXXXXXXXXXXXXXXXXXX-XXXXXXXXXXXXXXXXXXXXXXXXXXXXXXXXXXXXXXX-XXXXXXXXX-XXX-XXXXXX------XXXXXXXXXXXXXXXXXXXXXXXX----