------------------------------------------------------------------------------------------------------------------------------------------------------------------------------------------------------------------------------------------------------------------------------------------------------------------------------------------------------------------------------------------------------------------------------------------------------------------------------------------------------------------------------------------------------------------------------------------------------------------------------------------------------------------------------------------------------------------------------------------------------------------------------------------------------------------------------------------------------------------------------------------------------------------------------------------------------------------------------------------------------------------------------------------------------------------------------------------------------------------------------------------------------------------------------------------------------------------------------------------------------------------------------------------------------------------------------------------------------------------------------------------------------------------------------------------------------------------------------------------------------------------------------------------------------------------------
------------------------------------------------------------------------------------------------------------------------------------------------------------------------------------------------------------------------------------------------------------------------------------------------------------------------------------------------------------------------------------------------------------------------------------------------------------------------------------------------------------------------------------------------------------------------------------------------------------------------------------------------------------------------------------------------------------------------------------------------------------------------------------------------------------------------------------------------------------------------------------------------------------------------------------------------------------------------------------------------------------------------------------------------------------------------------------------------------------------------------------------------------------------------------------------------------------------------------------------------------------------------------------------------------------------------------------------------------------------------------------------------------------------------------------------------------------------------------------------------------------------------------------------------------------------------
--------------------------------------------------------------------------------------------------------------------oo---------------------------------------------------------------------------------------------------------------------------------------------------------------------------------------------------------oo-----------oo------------------------------SSSSSSSSSSSSSSSSSSSSSSSSSSSS----------------------------------------------------------------------------------------------------------------------------------------------------------------------------------------------------------------------------------------------------------------------------------------------------------------------------------------------------------------------------------------------------------------------------------------------------------------------------------------------------------------------------------------------------------------------------------------------------------------oo-----------------------------------------------------------------------------------------------------------------------------------------------------------------------------------o----------SSSSSSSSSSSSSSSSSSSSSSSSSSSS--------------------------------------------------------------------------------------------------------------------------------------------------------------------------------------------------------------------------------------------------------------------------------------------------------------------
-------------------------------------------------------------------------------------------------------------------XXXX------------------------------------------------------------------------------------------------------------------------------------------------------------------------------------------------------------E--E----------------------------------o-------------SSS--------------------------------------------------------------------------------------------------------------------------------------------------------------------------------------------------------------------------------------------------------------------------------------------------------------------------------------------------------------------------------------------------------------------------------------------------------------------------------------------------------------o-------------------------------------------------------------------------------------------------------------------E--E-------------------------------------------------------------------------------------------------------------------------------------oo-------?-------------------------------------------SSSS----------SS?-SS-----S--------------------------------------------------------------------------------------------------------------------------------------------------------------------------------------------------------------------------------------------------------------------------------------------------------------------
---------------------------------------------------------------------------------------------------E-----------------------------------------------------------------------------------------------------------------------------------------------oooooo-----------------------------------------------------------Eooo----------XXXXXXX-----------------------------------------?----SSS-----------------------------------------------------------------------------------------E-----------------------------------------------------------------------------------------------------------oo-------------------------------------------------------------------------------------------------------------------------------------------------------------------------o--o-----------------------------------------------------------------------------------------------------oo--oo---------------------------------------------------------------------------------------------oo-----------------------------------XXXXXXX---------------------------------------------------------------------EE-----------oo--------------------------------------------------ooo-----------------E----E------------------------SSSS----------SS--SS----ES----------------------------------------------------------------------------------------------------------------------------------------------------------------------------------------------------E--------------------------S---------------------------E--------------------------------------------------------
----------------------------S--------------------------------------------------------------------SSSSSSSS--------S-?-------------------------------------------------------------S---------------XX---SS--SQQ-?--------------------------------------XXXX---------S-------------------------------------SSSSSSSS----XXXXX----------------------------------------S---SSSSS------SS?--S----------------------------------QSSSSSS--SSS----------------------------SSSS-------E-------E--E------------------------------------------------QQQS---------SSSSS------------SSSSS---SSS-----o--XXXX------------------------------------------------------------------------QQQQQ------------SSSSSQ-----------?-----------------------------XXXXX------XX-------------o------------XXX-X-------XXXX----------------------------------------------------------------------------------------------------------?SSS-------XX-------------o-----------------SSSSS------SSSSS-----XXX--------o--------------------------------E----------------------------S------------------------SSSS-------------------------SSQSS---S---------------SSSSS------------------XX-----------------XXXXX-----XX-------------SQS---------XXX-----------SS-----------------S----SS---?-------------SSSSSSS----SQSQS-------SSS----Soo------Q-----S---------------------------------------------------S----------------S-?------------------------------SSQQ--------------------------------SQS-----------------SS----------------------------SS---ooo--XXX---------------------------------SSSS-----SSS
-----------------X----------------------------------------------------------------------------------------------------------oo----------E---------------E-----------------------------------------------------------------------------------------------------------------------------------------------------------------------------------ooo---------------------------------------------<>----------------------------------------------------------------------------<>---------XXXXX-----------------------------------------------------------------------------------------XXX----------------------------------------------------------------------------------------------------------------------------------------XXXX-------------XXX----------------------------------------------------------------------------------------------------------------------------------------------------------------------------XX-------------------------------XX------------------XXXX-------oooo---------------<>------------------oo-------------------------------------------------------------------------------------------------------------XX---------------------------XX------------------------XXXX-----------SS-----------------S----SS-----------------------------------------------------------------------------------------------------------------------------------------XXX--------------------------------------------------------------------------------SS--------------------------------------------------------------------------------------
-----------------XX----------------------------------------------XXX----------------------------------------------------------------------------------XXXXXXXX---------------------------------------------------oo-------------------------------------------------------------------------------------------------------------------------------------------------------------------------[]---------------------------------------------------------------------E------[]-------------------------------------------------------------------------------------------------------------------------------------------------------------------------------------------------------------------------------------------------------------------XXX-----------------------------------------------------------------------------------------------------------------------------------oo---------------------------------------o----------------------------------------------------------------------------------[]------------------------E--------------------------------------------------------------------------------------------------------XX-------------------------E-XX------------------------XXXX-----------SS-----------------S----SS----------------------------------------------------------------------------------------------------------------------------------------ooo---------------------------------------------------------------------------------[]--------------------------------------------------------------------------------------
--------------E--XX-------------------------------------------------------------------------------------------------------E-------------SS-------------------------------SSSSSS--------------------------------------------------------------------------------------------------------X--------------------------XX---------XXXXX---------------S--Q------------------S-------------EE-----[]-------------------E--------------------o-----------------------EX----------[]--------------------oo-------------------------E----------------------------------------------------Q----------------------------------------------------------------------------------------------oo-------------------------------oE-----------------------------XXX------------------XXX------------------------------------------S-S----------E------------------------------------------------------------E--------SSSSSS---------S--------------------oo--------------------------------------XXX---------E-------E------------[]o-S----------S------E--<>-----------------------------E------------------------------E------------------SSSSSSSS-----------E-----XX-------------S----------XX-XX----------------------XXXXXX-----------SoS-------------<>-S----SS-S-------------------------------------oo--------------------------------------E------------------------------------------ooo----------------oo-----E--o-----------------S-------------------------------oS-----------------[]------------------------E-------------------------------------------------------------
-------------<>----------------------Qoo------------------------------------XXXXX--------X-----------S-S--------oS-------<>--------------S----------XX------------------------------------------------Q---S?S-SSS----X--X----------------------------------------SS-------------------XX----------------Q--------XXXX-------------------------------------------------XX-XXXSSSSSSSSSSSSSE--[]------------------<>-----EQQ?----------------------------------<>X-----S----XXS---------------------o--------------------X--<>--------QQ-Q--QQQQ----------------------SQ---S?S-SSS-------XXXXXXX-----------------------------------------------------oo---------------?QQQQ---------------SSQQQS---------------E--?--------o-------------SS-------X---------------X-----------XXXXX------------------------XX------------------<>-----------------------------------------------------S-----<>---------------------XXXXX-------------X----------XXXX-SSSSSS-------------XXXXXX---------------<>------<>-------E----[]S---------------E--<>--[]-------------------S--------<>-------------E--------E----E--XS--SSS--E----------------------E----<>XXX-XXX---------X-------------XXX-XX---------Q---S?S-----XX-XXXX-----------SSS----SS-----S-[]-S----SS----------------------o-------SSS-ooo-------XXXX--SSS---Q--QQ-Q--------E------<>-----------<>---------------Q-------------------XXXX-SSS-----------<>---X--------SSSSSSS------------S---------------S---S?SS-------S--------[]-------------E---S----E<>----o-----XXXX----------X------------Q-Q---------------------
-------------[]----------------------------------------------oo------------------------XXX-------------------------------[]----XXX------------XXXXXXX------------------------------------X--SSS-------------------E--X--XX-----------------------------------------------------------XXX------------------------EXXX-------------------------------------------------XXX-XXX-SSSSSSSSS-SSS--[]------------------[]---------------XX--------------------------[]X-----------------E---------X--------------------------XX--[]-------------------------------------------------------------------------------------XXX-----------------X-X------------o--------------------------------------------------E----<>-------------------------------X--XX---------------------------------------------------------------------------[]----------------E---------------------------------------E--[]-----E-------------XXXX------------X--XXXX-----------------------------------------------------[]------[]------<>----[]S--------------<>--[]--[]----------------------------[]------E-----<>-------<>---------------<>---------------------<>----[]XXX-XXX-------EXX------------XXXX-XX--------------------XXXXXXXX---------------E-----E-----[]------------------------------------------------------------------------------<>------[]-----------[]-------E----------------------------------------------[]--XXX-----------------------------E-----X---------------------------X--[]------------<>------E<>[]----------------------XXXX-------------------X---------------
-------------[]----------------------------------------------XXXX--------------------oXXXX-----X-------------------------[]----XXX------------------------X----------X-X-------------E---X---------------------------X--XXX------------------------------XXX------------------------XXXX--------<>-------------XXXXX----XXXXX--------------<>-----------------------XXXX-XXX-SSSSSSSSS-SSS--[]------------------[]--------------XXX--------------------------[]X------S---------<>---------X---------------X---------XXX--[]-----------------------------------------------------------------------------------------------------------------------XXXX-----------------------------------------------<>----[]-------------------------------X--XX---------------------------------------------------------------------------[]---------------<>---------------------XXX--------------<>--[]-----E------------XXXXX-----------XX-XXXXX---------------------X-----------------o----------X--[]----<>[]------[]----[]S--------------[]--[]--[]----------------------------[]-----<>-----[]-------[]---------------[]---------------------[]----[]XXX-XXX-------XXX-----------XXXXX-XX--------X----------XXXXXXXXX---------------------------[]-----------------------X------------------------------------------------------[]------[]-----------[]------<>----------------------------------------------[]-XXXX----------------------------<>-----X------------------------------[]------------[]-----<>[][]-----------------XXX-X-XXXX------------------X---X-----------
----E-E------[]---------------------------------------------------------------------XXXXXX-----X-E----------EE--E--------[]----XXX-------X-----------------------------------------------X---------------------------X--XXXX-----------------------------------E----E--E-E---------XXXXX---EE-E-[]-E----------XXXXXX-----------------------[]--------------E-EE--E-XXXX--XXXSSSSSSSSSSE-----[]-----------E-EE---[]-E---------E--XXX---------EE--EE-E--E------[]X----------------[]---E-EE--X--------------XXX-------XXX---[]-------------------------------------------------------------------------------------------------------------------XX-----------------o-----------------------------------[]----[]---------------------------------XXX--E--------------------------------------------------------------E---------[]-------E-EE----[]--------------------------------------[]--[]-----------------XXXXXX--SS------XXX--XXXX--------------------XX-------ooo------XXX---------E--[]----[][]------[]----[]S------E-EE----[]--[]--[]---X---E--E-EE-E----------E-[]-----[]-E---[]-------[]--------EE-E---[]-E--E-------------E--[]----[]--X-XXX------XXXX----------XXXXXX-XX-------XX---------XXXXXXXXXX-------XX------------------[]--E-E------------E-EE--X------------------------------------------------------[]------[]-----------[]------[]--------------------------------------E----E--[]-XXXX---S------------------E-----[]-EE--X---------E-------E------E-----[]-----EE-E---[]-----[][][]-------ooo-------------XXXX-EE-------EE-E----X---X-----------
XXXXXXXXXXXXXXX--XXXXXXXXXXX--XXXXXXXX--XXXXXXXXXXXXXXX--------------------------XXXXXXXX---XXXXXXXXXXXXXXXXXXXXXXXXXXXXXXXXXXXXXSXXXXXXXXXX----------------------------XXXXXXXXX-X-XXX-XXXXX---XXXXXXXXXXXXXXXXXXXXXXXXXXXXXXXX-XXXXXXXXXXXXXXXX-XXXXX-----XXXXXXXXXXXXXXXXXXXXXXXXXXXXXXXXXXXXXXXXXXXXXXXXXXXXXXXX---------------------XXXXXXXXXXXXXXXXXXXXXXXXXXXXXX---XXXXXXXXXXXXXXXXXXXXXXXXXXXXXXXXXXXXXXXXXXXXXXXXXXXXXXXX------XXXXXXXXXXXXXXXXXXXXXXXXXX-X---XXXXXXXXXXXXXXXXXXXXX-XXXXX--XXXXXXXXX--XXXXXXXX-XXXXXXXXXXXXXXXXXXXXXXXXXXXXX-XXXXXXXX--XXXXXXXXXXXXXXXX----XXX---------------------XXXX-----XXXXX-XXXXXXXX-----XXXXX---------------------XXXXXXXXXXXXX----XXXXXXXXXX-------XXXXXXXXXXXXXXXX--XXXXXX--------XXXXXXX-XX-XXXXXXXXXXXXXXXX---XXXX-XXXXXX----X--XXXXXX----XXXXX-XXXX-----XX-XXXXXXXXXXXXXXXXXXXXXXXXXXXXXXXXXXX-XXXXXXXXX---XXX-----XXX-XX-X-XXXXXXXXXXXXXXXXXXXXXXXXXXXXXXXXX---SX--XXXXXXXXXXXXX-------XXXXXXXXXXXXXXX-------XXX------------------X--XXXXXXXXXXXXXXXXXXXXXXXXXXXXXXXXXXXXXXXXXX-XX--XXXXXXXXXXXXXXXXXXXXXXXXXXXXXXXXXXXXXXXXXXXXXXXXXXXXXXXXXXXXXXXXXXXXXXXXXXXXXXXXXXXXXXXXXXXXXXXXXXXXXXXXXXXXXXXXXXXXXXXXXXXXXXXXXXXXX--XXXXXXXXXXXXXXXXXXXXXXXXXXXXXXXXXXXXXXX-XXXXXXXXXXXXXXXXXXXXXXXXXXXXXXXXXXXXXXXXXXXXXXXXXXXXXXXXXXXXXXXXXXXXXXX-----XXXX---XXXXXXXXXXXXXXXXXXXXXXXXXXXXXXXXXXXXXXXXXXXXXXXXXXXXXXXXX--X-XXXXX-X---------XXXXXXXXXXXXXXXXXXXXXXXX----XXXXXXXXXX-XX-X--XXXXXXXXXXXXXXXXXXXXXXXXXXXXXXXXXXXXXXXXXXXXXXXXXXXXXXXXXXXXXXXXXXXXXXXXXX--XXXX-----XXXXXXXXXX---XXXXXXXXXXXXXXXXXXXXXXXXXXXXXXXX