------------------------------------------------------------------------------------------------------------------------------------------------------------------------------------------------------------------------------------------------------------------------------------------------------------------------------------------------------------------------------------------------------------------------------------------------------------------------------------------------------------------------------------------------------------------------------------------------------------------------------------------------------------------------------------------------------------------------------------------------------------------------------------------------------------------------------------------------------------------------------------------------------------------------------------------------------------------------------------------------------------------------------------------------------------------------------------------------------------------------------------------------------------------------------------------------------------------------------------------------------------------------------------------------------------------------------------------------------------------------------------------------------------------------------------------------------------------------------------------------------------------------------------------------------------------------
------------------------------------------------------------------------------------------------------------------------------------------------------------------------------------------------------------------------------------------------------------------------------------------------------------------------------------------------------------------------------------------------------------------------------------------------------------------------------------------------------------------------------------------------------------------------------------------------------------------------------------------------------------------------------------------------------------------------------------------------------------------------------------------------------------------------------------------------------------------------------------------------------------------------------------------------------------------------------------------------------------------------------------------------------------------------------------------------------------------------------------------------------------------------------------------------------------------------------------------------------------------------------------------------------------------------------------------------------------------------------------------------------------------------------------------------------------------------------------------------------------------------------------------------------------------------
---------------------------------------SSSSSSSSSSSSSSSSS---------------------------------------------------------------------------------------------------------------------------------ooo--------------------------------------------------------------------------------------------SSSSSSSSSSSSSSSSSSSSSSSSSSSS---------------------------------------------------------S--------------------------------------------------------------------------------------oo--------------------------------------------------SSSSSSSSSSSSSSSSSSSSSSSSSSS-SSSSSSSSSS------SSSSSSSSSSSS----------------------------------------------------------------------------------------------------------------------------------------------------------------------------------------------------SSSSSSSSSSSSSSSSSSSSSSSSSSSSSSSSSSSSSSSSSS-----------SS----------------------------------------------------------------------------------------------------------------------------------------------------------------------------------------------------------------------------------------------------------------------------------------------------------------------------------------------------------------------------------------------------------------------------------------------------------------------oo------------------------------------------------------------------------------------------------------------------------------------------------------------------------------------oo---------------------------------------------------------------
------------------------------------------------------------------------------------------------------------------------------------------------------------------------------o----------------------------------------------------------------------------------------------------------------------------------------------------------------------------------------------SSS---------------------------------oo-----------------------------------------------------E--E---------------------------------------------SSSS----------------------------------------------------------------------------------------------------------------------------------------------------------------------------------------------------------------------------------------?-------X-----------------------SSSSSSSSSSS---------------------------------------------------------------------------------------------------------------------------------------------------------------------------------------------------------------------------o-------------------------------------------------------------------------------------------S--------------?---------------------------------------------------------------------------------------------------------------------------------------------------------XXXX-----------------------------------------------------------------------------------------------------------------------------------------------------------------------------------XXX--------------------------------------------------------------
--------oo--oo----------------------------------------------------------------ooo-------------------------------E----E---?------------------------------------------------------oo----------------oo--------------------------------------------------------------------------------------------------------------------------------------------------------------------------SS-------------------------------------------oooo----------------------------------------XXXXXXX-------------------------------------------SSSS--E-------------------------------------------------------------------------------------------------------------------------------------------------------------------------------------------------------------------------------------------------X-------------------SSSSSSSSSSS--------------------------------------------------------------------------------------------------------------------------------E--------------------------------------------------------------------------------------------------------------------------------------------------------------------------------------------------------------S-----------------------------------------------------------------------------------E-------------------------------------------------------------------XXX--------------------------------------------------------------------------------------------------------------------E-------------------------------------------------------------------------?-------------------E----E----------------------
-----------------------------------------------------------------------XXX-----XX-----S---SS-------------------SS---SQS-S??-------------SS------------------------QQQ---oo------XXX-------oo------------------?SSS---SSSSS---------------------------XX-------------------------SSSSSSSS----------------------------Q?SSS-------SSSSSSSSSSSSSSSS---------Q-Q------------------SS---Q---o-----------E---------------XXXX----XXXX----o------S-----E------------------------------------------S-----QS----------------S------SS---SS--o--------------------------------------------S---------SSS---------------------------------SSSSSSSSS-----------------SS---SS-----QSSSQ---?--SSSS--------SSSSSSSSSS----?--------------------------SS--------------SSQQ-----------------------XXXX-----------------SSSSSSSSSSSS--Q-----------------SSS----------------------------------------------------------------------?SSSS------------------------------E--E------------SQS------------------------------------------------------------------S---SSS---------------SSS---XX------------------------------------------------------SSSSS-----------SSS------------SS-----S---------------XXX--------------------------------------------------------S---Q-QSSQ------------------E-------Q-------------SSSSSSSSSSSS-------S------------------SS---S-------------------------------------??SSS----------------S---SS---------------------S?S-------------S?--SSS---S----------SSSS------------------------------------------------SSS?S-----------------S---SQS---?-----------------
--------------------------------------------------------------------------------------------------------------------------------XSSS----------------------------------------------------------------------------------------------E----------------X-XX-----------------------------------------------------------------------------------------------------------------------SS------------------<>----XXX-----------------------XX-----------XXXXXX----------------------------oo---------------------------------------SS---SS---------------------------------------------------------------------------------------------------------------------------------------------------------------------------------------------------------------------------XXXX-E---E---------XX-----------------------------------------------------------------------------------------------------------------------------------------------------------------XXXXXXX--------------------------------------------------------------------------------------------------------XX-----------------------------------------------------------------------SS------------SS--------------------XXXXSS---------------------------------------------------------------------------------<>------------------------------------------------------oo---------------------------------------------------------------------------------------------ES-------------------SS----------------------------------------------------------------------------------------------------------SS---------
-------------------------------------------------------------------------------------------------------------------------------XXX-----------------------------------------------------------------------------------------------------------------XXXX-----------------------------------------------------------------------------------------------------------------XXX---SS---S-S------------[]-----------------------------Eo---------------------------------------------------------------------------------------SS---SS--------------E----------------------------------------------------------------------------------------------------------------------------------------------------------------------------------------------E-----------------XXXXXXXXXXX--X-XX-----------------------------------E--------------------------------------------------------------------------E------------------------------------------------------------------------------------------------------------------------------------------------------------------X-------------------------------------------------------E---------------SS------------SS--------------------XXXX-----------------------------------------------------------------------------------[]--------------------------------------------------------E--------------------------------------------------------------------------------------------SS-------------------SS--------------------------------------------------------------------------------XX----------------------XXX----------
XX-----------------------------------o---S---------E------------------XXXXX--------------------------------E--o-E-------------XXXX--SQ-----------------------------------------------------XX------------------------------------S-----------------XXXX-------------------------------------------------------------------------X--------------------------------------XX-X---SS---SoS---------E--<>-----------------------------------------------E------------SS-------E--S------------------------------E------------X-So??-SSS------------<>------------SSS--------------------E------------------------------------------------------------------------------------------------------------------------------------------------------E--XX----------oo----o-------------XXXX------------------------------------------oo--ooo--------------------------------------SS----------S---------<>---------------------------------------------------------------------------------SSSSS--XX-------------------E--------------------------------X----------E-E-----XX-----------------------------------------------------------------------SS------------SS-----X-------------XXXXX--------------------------------------------------------------------------------E--[--------------------------------------------------S--E--<>-----------------------------------------------------------------------------------------------------------------SS-------------------------------------------------------------------------------------------------------XEXSS-SQ------
-----------------X--------------------------------<>-----X------XX----------XXXXXXX---Q---SSS------E------<>-X--XS--S?S-------XXXX--------------------------------QQQQ-----------XXX-------------------QQQQ--------------------------------------X-XXXX--------------E----------------XX------------------------S-----SSS------XXX-XX----SS---------Q----Q-QQ---------XXX-X---SS---SSS---E----<>--[]------------------XXXXXXXXXXX---Q-Q---S?S-----<>---------------E----<>-----E--S-------SS----SS--------<>---------E----SSS--SSSS--------E--[]-----ESSS--------S----------------<>-----QQQQ-----Q--------Q---o------E-XX-------S----------------E------S------------ESQS--Q--------Q?--QQQ-------SSQ--Q--QQ----------------------------<>--------------------------------XXXXXX------S----X---------SS------XXSQSSS----------------QQQ-----------------------------------E------S----E---E--[]-------------QQQQ-------------------------XXXXXXXX--------------S?S--------E------------S----------------E--<>-----------------------Q-------XXX---QQQQ---------XXX-----------------------<>----------------------E-----SSSS------XX----SSSS------------------XX------------XXXXXX---------X----------------S?S-------XX---Q-Q---S-S----E----E?QQQ?--------------<>----<>-----------------------S--SSSSSSSSX---------E----<>--[]------------------SQ----------------S--QQQQ--Q-Q----------------------SSS---------------------S-------EX--X---------o--S-----Q---SSQS-----------------------------------------------XXX------------XX-------S---S?S------XXXXX----------
-------E--------------o---------------------------[]----------------------------------------------<>------[]-XXX------------XXXXXX--------------------XXX-?----------------------------------SS--SS-----------------------------------------------XXXXX-------------<>---------------XXX-----E--------------EE----------------XXXX-XX--------------------------------XXXX-XX------------<>----[]--[]----------------------------------------------[]-----------X--<>----[]----<>----------SS--------------[]--------<>--------------------<>--[]----EE-------------E--------------[]---------------------------------<>-XX-------------X---------<>--------------------------------------------------------------------------------------[]-----E-------------------------XXXXXXX-----E------XX--------------XXX--------------------------------------------X-------------------------<>--<>--[]--------------------------------------------------------------------------<>-------------------E-E------<>--[]---------------E--------------EXXX----------------XXX-----------------------[]---------------------<>--------------XXX-----------X---XX--------XXX-----------EXXXXXX--------XX-------------------------XXX---------------<>---------------E--------[]----[]--------------------------E-------X--------<>----[]--[]-------S---------------------------------------------------------------------------------------------XXX--XX--------E--X---------------------------------------------------------------------XXXXX-XX-----S-------------XXXXXX----------
------<>------------------X-X---X-----------------[]----------------------------------------------[]------[]-XXX------------XXXXXX---------------------------------------------------XXXX----S----------------------------------------------------XXXXX-------------[]--------------XXXX-------------------------------------XXXXX-XXX---------X--------------------XXXXX-XXX-----------[]----[]--[]------------------------------oo--------------[]-----------E--[]----[]----[]----------SS--------------[]--------[]--------------------[]--[]----------------------------------[]---------------------------------[]---------------XX---------[]--------------------------------------------------------------------------------------[]----<>--------------------------XXXXXX------------XXX----------EEXXXX----------------------------------------E---X-------------------------[]--[]------------------------------------------------------------------------------[]------------------<><>------[]--[]--------------<>------------EXXXXX------------E---XXX-----------------------[]-----------X---------[]-------------XXXX-----------X---XXX------XXXX----------XXXXXXXX-------XXX-----------------<>-----XXXX---------------[]------------<><>--------[]----[]------X---------------------------X--------[]----[]--[]-------S--------------------------------------------------------------------------------------------XXXX--XXXX--------------------------------------------------------------XXX-----------XXXXXXXX-XX----SS-------------XXXXXX----------
------[]--------------------X---X----EE----EE-E---[]--------------------------------E-E--E--E-----XX---XX-[]-XXXE-----------XXXXXX--------------------------------------o-XXXXXXX-----------SS--E------------E-E----------------------------------XXXXX---------E---[]-E-----------XXXXX------------------------------------XXXXXX-XXX--------XX------E-E-------E--XXXXXX-XXX-----------[]-E--[]--[]--------XXXXXXXXXXX----------XXX--------------[]--------------[]----[]----[]-E-------SSS-E-E----------[]------E-[]-----------------EE-[]--[]----------------------------EE----[]---------------------------------[]----------EE--XXX---E-EE--[]-E----------------------------------E-EE----------------------------------------------[]----[]-----------------------E--XXXXXX------------X-X-----------XXXXX--------------------------------------------X------EEEE----------E----[]--[]-----------E-----------------------------------------------------E-E----------[]-------------E--E-[][]------[]--[]----EE-E--E---[]-E-E--------XXXXXX----------------XXX---EE-E-----E----------[]---E-EE---XX------E--[]-E----------XXXXX-E-EE------X-E-XXXXE---XXXXX---------XXXXXXXXX------XXXX------E-EE-E--EE-[]----XXXXX---------------[]------------[][]--------[]----[]------X----E--E-----E-------------X-EE-E-E-[]-E--[]--[]-------S-----E-EE-EE----EE---------------------------------EE---E-EE-E----------------------E------XXXXXE-XXXX---------X------------------------------------------------------------------XXXXX----XX--EE-S----E--------XXXXXX----------
XXXXXXXXXXXXXX--------------XX-XXXXXXXXXXXXXXXXXXXXXXXXX------X---------------------XXXXXXXXXXXXXXXXXXXX--XXX-XXXXXXXXXXXXXXXXXXXX-X----XXXXXXX--XXXX-----XXXXX---XXXX--XX------------------XX--XXXXX-XXXXXXXXXXXXXXXXXXXXXXXXXX--X-XXXXXXX---XXXXXXXXXXXXXXXXXXXXXXXXXXXXXXXXXXXXXXXXXXXXXXXXXXXX--XXXXXXXXXXXXXXXXXXXXXXXXXXXXXE-XXXXXXXXXXXXX--XXXXXXXXXXXXXXXXXXXXXX--XXX-XXXXXXXXXXXXXXX-XX--XXXXXX----------------------------XXXXXXXXXXXXXXXXXXXXXXXXX--XXXXXXXXXXXXXXXXXXXXXX-XXXSSXXXXXXXXXXXXXXXXXXXXXXXXXXXXX-XXXXXXXXXXXXXXXXXXXXXXXXXXXXXXXX--XXXXXXXXXXXXXXXXXXXXXXXXXXXXXXXXXXXXXXXXXXXXXXXXXXXXXXXXXXXXXXXX-XXXXXXXXXXXXXXXXXXXXXXXXXXXXXXXXXXXXXXXXXXXXXXXXXXXXX-X-XXXXXXXXXX--XXXXXXXXXXXXXXXXXXXXXXXXXXXXXXXXXXXXXXX-XXXX-XXXXXXXXXXXXXXXXX---XXXXX--XXXXXXXXXXXXXXXXXXXXXXXXXXXXXXXXXXXXXXXXXXXXXXXXXXXXXXXXXXXXXXXXX---XX--XXXXXXXXXX--XXXXXXXXXXXXXXXXXXXXXXXXXXXXXXXXXXXXXXXXXXXXXXXXXXXXX--XXXXXXXXXX------XXXXXXXXX----------------XXXXXXXXXXXXXXXXXXXXXXXXXXXXXXXXXXXXXXXXXXXXXXX-XXXXXXXXXXXXXXXXXXXXXXXXXXXXXXXXXXXXX---XXXXXXXXXX--XXXXXXXXXXXXXXXXXXXXXXXXXXXXXXXXXXXXXXXXXXXXXXXXXXXXXXXXXXXXXXXXXXXXXXXXXXXXXXXXXXXXXXXXXXXXXXXXXXXXXXXXXXXXXXXXXXXX--XXXXXXXXXXXXXXXXXXXXXXXXXXXXXXXXX-X-XXXXXXXXXXXXXXXXXXXXXXXXX--XXXXXXXXXXXXXXXXXXXXXXXXXXX--XXXXXXXXXXXXXXXXXXXXXXXXXXXXXXXXXXXXXXXXXXX-XXXXXXXXXXXXXXXXXXXXXXXXXXXXXXXXXXXXXXXXXXXXXXXXXX-----XXXXXXXXXXXXXXXXXXXXXXXXXXXXXXXXXXXXXXXXXXXXXXXXXXXXXXXXXXXXXXXXXXXX--XXXXXXXXX----XXXXXXXXXX-----XXXXX-X-XX----XXXXXXX----XXXX-----XXXXS----XXS---X-XXXXXXXXXXXXXXXXXXXXXX----XXXX