------------------------------------------------------------------------------------------------------------------------------------------------------------------------------------------------------------------------------------------------------------------------------------------------------------------------------------------------------------------------------------------------------------------------------------------------------------------------------------------------------------------------------------------------------------------------------------------------------------------------------------------------------------------------------------------------------------------------------------------------------------------------------------------------------------------------------------------------------------------------------------------------------------------------------------------------------------------------------------------------------------------------------------------------------------------------------------------------------------------------------------------------------------------------------------------------------------------------------------------------------------------------------------------------------------------------------------------------------------------------------------------------------------------------------------------------------------------------------------------------------------------------------------------------------------------------
------------------------------------------------------------------------------------------------------------------------------------------------------------------------------------------------------------------------------------------------------------------------------------------------------------------------------------------------------------------------------------------------------------------------------------------------------------------------------------------------------------------------------------------------------------------------------------------------------------------------------------------------------------------------------------------------------------------------------------------------------------------------------------------------------------------------------------------------------------------------------------------------------------------------------------------------------------------------------------------------------------------------------------------------------------------------------------------------------------------------------------------------------------------------------------------------------------------------------------------------------------------------------------------------------------------------------------------------------------------------------------------------------------------------------------------------------------------------------------------------------------------------------------------------------------------------
------------------------------------------------------------------------------------------------------------------------------------------------------------------------------------------------------------------------------------------------------------------------------------------------------------------------------------------------------------------------------------------------------------------------------------------------------------------------------------------------------------------------SSSSSSSSSS-SSSSSSSSSSSSSSSSS-SSSSSSSSSSSSSSSSSSSSSSSSSSS-----------------o-----------------------------------------------------------------------------------------------------------------------------------------------------------------------------------------------------------------------------------------------------------------------------------------oo---------------------------------------------------------------------------------------------------------------------------------------------------------------------------------------------------------------------------------------------------------------------------------------------------------------------------SSSSSSSSSSSSSSSSSSSSSSSSSSSS--------------------------------------------------------------------------------------------------------------------------------------------------------------------------------------------------------------------------------------------------------------------------------------------------------------------
-------------------------------------------------------------------------------------------------------------------------------------------------------------------------------------------------------------------------------------------------------------------------------------------------oo--------------------------------------------------------------------------------------------------------------------------------------------------------------------------------------------------------------------------------------------------SSSSSSSSSSSSSSSSSSSSSSSSSSS--------------------------------------------------------------------------------------------ooo-----------------------------------------------------------------------------------------------------------------------------------------------------------------------------------------------------------XXXX-------------------------------------------------------------------------------------------------------------------------------------------------------------------------------------------------------------------------------------------------------------o--o-----------------------------------------------------------SSSSS-----SSSSSS--SSSS---S--------------------------------------------------------------------------------------------------------------------------------------------------------------------------------------------------------------------------------------------------------------------------------------------------------------------
--------------------------------------------------------------------------------------------------------------------------------------------------------------------------------------------------------E----------------------------------------------------------------------------------------------------------------------------------------------------------E---------------------------------------------------------------------------------------------------------------------------------------------------------------------------------SSSSSSSSSSSSSSSSSSSSSSSSSSSE----E---------------------------------------------------------------------------------------------------oo----o--------------------------------E----------------------------------------------------------------------------------------------------------------------------------------------------o--------------X-------------------------------------------------------------------------------------------------------------------------------------------------------------------------------------------------------------------------------------------------------------------------------------------------------------------X-SSSSS--E--SSSSSS--SSSS--ES----E----------------------------------------------------------------------------------------------------------------------------------------------------------------------------------------------------------------------------------------------------------------------------------------------E----------------
-----oo---------------XXX-----SSSSS---------------------------------------------SQQQ----------------SSSSSS----------X-----------------------------------------------SSS-------S-------------------------E-----SSSSSSSSSSS------S-----------------------SSS------------------SSSSSSSSS-SSo----------XXXX-------------------------SSSSSS?SSSSSS--------------E-------E--E--------SSQS-----------------SSSS------------------------------------------------XXXX----Q?SSS---?SSSS-----------SSSS----SSSSSS--------------------Q---------ooo-------------SS-SSSSSSSSSSSSSSSSSSSSSSSSSS---SQS--X?-----XX-----------------------------------------------------------------------------XXXX----X-------o----------?SSS----SSSSS--------S?S-----SSSSSSSSSSS----------SQS---?---------------------------------------------------------XXoo----oo------SSSSS-----------------------SSSSS--------------------------SSQ-----------------------------------------------?--SSSSSS---------------?-------------------------------------------??SSS------------------------------------------------------------SSSSS----------------------SSSSSS--------?-----------------SSS---S-----------------------------------------------------------S----SSS----------S----SS---SQS----SSSS-----------------?-------------------------SQS------------------------------S----SSS------XXX-----------------------------SSSS-----------------------------------------------XXX---------------------------S-S----SS--------SS----------XXX-----S---S--------------SSSSS----SSS-----SSS--SSS----------
----------------------------------------------------------------------------------------------------------------------------------------------------------------------------------------------------------------------------------------------------------------------------------------------------------------------------------------------------------<>---------XXXXXX-------------------------------------------------X---------------------------XXXX--------------------------------------------XXX------------------------------------------------------------------------------------XXXS--------------------------------------------------------------------------------S---------XXX---------------------------------------------------------------------------------------------------------------------------------------------------------------oooo--------------------------------E-----------------------------------------------------------------------------------------------------------------------------------------------------------------------------------------------------------------------------------------------------SS----------------------------------------------------------------S----SSS----------S----SS-------------------------------------------------------------------------------------------------------XXXX---------------------------------------------------------------------------------------------------------------------------------------------------------------------------------------------------------
-----------------------------------------------------------------------------------------------------------------------------------------------------------------------------------------X----------X----------------------------------------------------------------------------------------------------------o------------------------------------------[]---------------------------------------------------------------XX-------------------------XXXXX-------------------------------------------------------------------------SSSS---------------S----------------------S---------------EXXXX-------------------------------------------------------------------------------------------o-----------------------------------------------------------------------o---------------------------------------E--------------------------Eo--------------------------------------------------------------------------------------------------------------------------------------------------------------------X-----------------------------------------------------------------------------------------------------------------------------------------SS-----------------E-----------E--------------------------------SSS----SSS----------S----SS-------------------------------------------------------------------------------------------------------XXXX--------------------------------------------------------------------------------------------------------------------------------------------------------------------E------------------------------------
-----------------------------------------SSS----------------E--S------E-------------Q---QSS---------------------------------------------------------------E--S--------------------------XSS--Q------S-----------------------------------------E-------------------------ooo-------------XX------------SS-------------------------------------------E----<>[]------------------------------E---------------------------E-E--XX-------oo---oo-----------XXXXX--------------------------------------------------------------------------S----------------?-------S----?----ooooo-S--------------XXXXX------------------------------S-------S------------------------E----------------SS---------------S----------------S------------------------------------------------------------E------------------------E--<>----------------------------------------------E-----------S-------------------SSSSSSS----------------------------------------------E---E-------------------------------------------------------XX--oo----------------------------------------------------------------------------------------------------------------------------------S--SS--EE---E--------<>----S-----<>---------ooo----------------------So??--SS----oo?-?-So??-SSS----------------------------SQSQ-----------------------------------------------------------------E-EXXXXXX---------E----------------------X--oo----E--o----XXXXX-----------------------------oo-------------------------------X----------------------------------------------<>------------------------------------
-------XXXXXXX-------------X--ESQS------XX--X----SS-----E--<>-----E--<>-----E----------------------------------X-----------------------------------------<>-----E--?----------S--------XXX--X-------S--QQQQQQQ--QSQQ-----S-------S--------E--<>-----------------------E----------------X------------XXXXX----------X-----------XX--X--------------<>----[]XXX--XXXX-------------SSS---E--<>--------------------------------XX------------------------XXXXXX----------E------------QQQ-----------SQS--S?S-----------------SS--------------------------SSSSSSSSSSSS--??SS--SSSS-S-oS--S?S-----XXXXXX-------------------------------------X------------S----E------<>--------------XXXXXX--SSS-----------------X--XX----------X---SQE----------QQ?SSQQQQ-------S?SQS-SSS----X------<>-----------------S-----<>--[]-----------------XXXX--XXX-----------Q-------<>--------------S?SS-------------------------S-------------------QQS-----------------<>--<>-------SSS--------Q-Q--QQQQ--Q--Q---------------E-----XXX----S--QQQQ--QQQS-------------XX------------------E----------QQQ-----------E------------oo---------XX-------------XX--SS-------------SS-----o--X-<>---E----[]-------E--[]--X---------------XX--------------SSS--SSSSS--SSS---SSS--SSS--QQQ---Q-QQ------------------o-------X-----------------QS-Q--------------------X--------SS---------XXXXXX--------<>-----E----S----------XX-------<>--------------XS-------------------------------Q-------------------------XX---------------------------------SSS-------E--[]-------------Q--QQ--Q--QQQ----Q-----
---------------------------------------XXX--XX----------XX-[]----<>--[]----<>----------E----------------------XX---------------------------------E-------[]----<>---------------------XXXX--XX------S-------------------------E----------<>--[]----------------------<>----------------------------XXXX-----------XX---------XXXX--XX-------------[]-----------------------X---------<>--[]-----E-----------------------XXXXX-----------------------XXXXXXX---------------------------------------------------------------------E---XX-?--------------SSSSSSSSSSSS---SS--------------------EXXXXXX--------E-------------------E------EXX---------------E<>---X--[]-------------XXXX--XX--------X-----------XX--XX---------XX---------------------------------------------Q--XXX-[]-----------------------[]--[]--------E------------------------------------[]-------------------------E---------------------------------------------------------[]--[]-----E--------------------------------XXX-?----<>------XX------------------------------XX-----------E-----<>-----------------------<>----------------E-----XXX--XX--------XXX----------XX--XX--------E--X-[]--<>----[]------<>--[]--X--------------------------E------------SS-----------------------------------------------------XX----------------------------------------XXX------------------XXXXXX--------[]----<>E------E------EXX-------[]--------------------------------------------------------------X--------EXXX----------------E-------------------------<>--[]-------S----------------------------
---------------------X----------------XXXX--XXX--------XXX-[]----[]--[]----[]------X--<>---------------------XXX--------------------------------<>-------[]----[]------X----------<>-XXXXX--XXX-----S------------------------<>----------[]--[]------------X---------[]----------------X----------XXXXX----------XXX--------XXXXX--XXX---------X--[]-----------------------X---------[]--[]----<>--------------XXXXXX------XX----------------------XXXXXXXX---------------------------------------------------------------------X-------------------SSSSSSSSSSSSSS---S--------------------XXXXXXXX---------o-----------------<>------XXX--------------<>[]------[]------------XXXXX---X-----o-XX-----------XX--XXX-------XXX---------------X-----------------------------X--XXX-[]-----------------------[]--[]-------<>------------------o-----------------[]------------------------<>---------------------------------------------------------[]--[]-----------------------------------------------[]------XX----S--------------------------X-----------------[]-----------------------[]---------------<>----XXXX--XXX-----EXXXX---------XXX--XXX----------X-[]--[]----[]------[]--[]--X-------------------------<>------------SS----------------------------------------------------XXX---X-----------------------------------XXXX------------------XXXXXX--------[]----[]>-----<>------XXX-------[]------------------------------XXX------------------------<>---XXX------XXXX---------------<>-------------------------[]--[]------------------------------------
-XXXXXX----------EE--X---X-----------XXXXX--XXX-------XXX--[]----[]--[]----[]------X--[]-------E------------XXXX--------------------------------[]-------[]----[]------X----------[]XXXXXX--XXXX----S--------E--E-----E------[]-E--EE----[]--[]----------XXX---EE-E--[]----------------X-----X---XXXXXX--S------XXXX-------XXXXXX--XXXX------XXX--[]-----------------------X---E--E--[]--[]----[]-E-E-E-------------------XXX---EE-E-----o--------XXXXXXXXX---------------------------EEE--------------------------E-EE------X--X--------------------SSSSSSSSSSSSSoooSSE-EE--------------XXXXXXXXX--------XX----E------------[]-----XXXX--------EE-E--[][]----X-[]-S------X--XXXXXX--S--S----XXX---------XXXX--XXXX-----XXXX---E-------E-E-X---------------E-------------XE-XXX-[]-E-----EEEE-----EE-----[]--[]-------[]-----ooo---------XXX------------E---[]-------EE--E------------[]----------------EE-E----------------------------E--E--EE-[]--[]------------------------------E----------------[]-E----XX----S-----EE-E----------------XX-----------------[]-----EE-E--------------[]---------------[]---XXXXX--XXXX----XXXXXE-------XXXE--XX-E---------X-[]--[]----[]-E----[]--XX--X-------------------------[]--E--------E-----------E--------E------------------E-EE----------XXXE--XXXX--------------------------------XXXX-------------------XXXXXX--------[]-E--[[]-----[]-----XXXXX------[]---------------------------------------------o-----E-----[]---XXXX----XXXXX-------o-------[]------------E-E-------E--[]--[]-------------E-------------E--E-----
--------------XXXXXX-X------XXXXXXXXXXXXXX--XXX--XXXXXXXX--XXXXXXXXXXXXXXXXXXXXXXXXXXXXXXXXXXXXXXXXXX---XXXXXXXXXXXXXX--XXXXXX--XXX--X------XXXXXXXXXXXXXXXX-XXXXXXXXXXXXXXXXXXXXXXXXXXXXX--XXXXXXXX---XXXXXXXXXXXXXXXXXXXXXXXXXXXXXXXXXXXXX-XXX-XXXXXXXXXXXXXXXXXXXXXXXXXXXXXXXXXXXXXXXXX----XXXXXXXXX--SX--XXXXXXXXXXXXXXXXXXXXXXXXXXXXXXXXXXXXXXXXXXXXXXXXX-----XXXXXXXXXXXXXXXXXXXXXXXXXXXXXXXXXXXXXXXXX-------------XXXXXXXXXXX--XXXX--XXXXXXXXXXXXXXXXXXXXXXXXXXXXXXXXXXXXXXXXXXXXXXXXXXX--XXXXXXXX----XXXXXXXXXXXXXXXXXXXXXX-----XXXXXXX---XXXXXXXXXXXXXXXXXXXXXXXXXXXXXXXXXXXXXXXXXXXXXXXXXX----XXXXXXXXXXXXXXXXXXXXXXXXXXXXXXXXXXXXXXXXXXXXXXXXXXXXXXX-XXXXXX------XXXXXX-------XESXXXXXXXXXXXXXXXXX--XXXXXXXXXXXXXX-XXXXXXXXXXXXXXXXXXXXXXX---XXXXXXXXXXXXXXXXXXXXXXXXXXXXXXXXXXXXXXXXXXXXXXXXXXXXXXXXXX-XXXXXXX---XXX------------XXXXXXXXXXXXXXXXXXXXXXXXXXXXXXXXXXXXXXXXXXXXXXXXXXXXXXXXXXXXXXXXXXXXXXXXXXXXXXXXXXXXXXXXXXXXXXXXXXXXXXXX-XXXXXXXXXXXXXXXXXXXXXXXXXXXXXXXXXXXXXX------XXXXXXXXXXX--XX----XXXXXXXXXXXXX--XXXXXXXXXXXXXXXXXXXX-XXXXXXXXXXXXXXXXXXXXXXXXXXXXXXXXXXXXXXXXXXXX----XXXXXXXXXXXXXXXXXXXXXXXXXXXXXXXXXXXXXXXXXXXXXXXXXXXXXXXXXXXXXXXXXXXXXXXXXXXXX--XX--XXXXXXX---XXXXXX---XXXXXXXXXX-XXXXXXXXXXXXXXXXXXXXXXXXXXXXXXXXXXXXXXXX----XXXXXXXXXXXXXXXXXXXXXXXXXXXXXXXXXXXXXXXXXXXXXXXXXXXXXXXXXXXXXXXXXX-XXXXXXXXXXXXX-XXXXXXXXXXXXXXXXXXXXXXXXXXXXXXXXXXXXXXXXXXXXXXXXXXX-------------------XXXXXX-------------------XXXXXXXXXXXXXXXXXXXXXXXXXXXXXXX---XXXXXXXX--XXXXXXXXXXXXXX-XXXXXXXXXXXXXXXXX-XXXXXXXXXXXXXXXXXXXXXXXXXXXXXXXXXXXXXX