------------------------------------------------------------------------------------------------------------------------------------------------------------------------------------------------------------------------------------------------------------------------------------------------------------------------------------------------------------------------------------------------------------------------------------------------------------------------------------------------------------------------------------------------------------------------------------------------------------------------------------------------------------------------------------------------------------------------------------------------------------------------------------------------------------------------------------------------------------------------------------------------------------------------------------------------------------------------------------------------------------------------------------------------------------------------------------------------------------------------------------------------------------------------------------------------------------------------------------------------------------------------------------------------------------------------------------------------------------------------------------------------------------------------------------------------------------------------------------------------------------------------------------------------------------------------
------------------------------------------------------------------------------------------------------------------------------------------------------------------------------------------------------------------------------------------------------------------------------------------------------------------------------------------------------------------------------------------------------------------------------------------------------------------------------------------------------------------------------------------------------------------------------------------------------------------------------------------------------------------------------------------------------------------------------------------------------------------------------------------------------------------------------------------------------------------------------------------------------------------------------------------------------------------------------------------------------------------------------------------------------------------------------------------------------------------------------------------------------------------------------------------------------------------------------------------------------------------------------------------------------------------------------------------------------------------------------------------------------------------------------------------------------------------------------------------------------------------------------------------------------------------------
--------------------------------------------------------------------------------------------------------------------------------------------------------------------------------------------------------------------------------------------------------------------------------------------------------------------------------------------------------------------------------------------------------SSSSSSSSSSSSSSSSSSSSSSSSSSSS----------------------------------------------------------------------------------------------------------------------------------------------------------------------------------------------------------------------------------------------------------------------------------------SSSSSSSSSSSSSSSSSSSSSSSSSSSS----------------------------o-----------------------------------------------------------------------------------SSSSSSSSSSSSSSSSSSSSSSSSSSSS------------------------------------------------------------oo-------------------------------------------------------------------------------------------------------------------------------------------------------------------------------------------------------------------------------------------------------------------------oo------------------------------------------------------------------------------------------------------------oo-------------------------------------------------------------------------------------------------------------------------------------------------------------------------------------------------------------
------------------------------------------------------------------------------------------------------------------------------------------------------------------------------------------------------------------------------------------------------------------------------------------------------------------------------------------------------------------------------------------------------------------------SSSSS--SSSSS-----------------------------------------------------------------------------------------------------------------------------------------oo----------------------------------------------------------------------------------------------------------------------------------------------------------------------------------oo------------------------E-------------------------------------------------------------------------------SS------?o---SSSSSSSS--SS----------------------------------------------------------------E--E------------------------------------------------------------------------------------------------------------------------------------------------------------------------------------------------------------------------------------------------------------------XXXX--------------------------------oo---------------------------------------------------------------------------X----------------------------------------------------------------------------------------------------ooo-----------------------------------------------------------------------------------------------------
------------------Eooo---------------------------------------------------------------------------------------------------------------------E-------------------------------------------------------------------E--------------------------------o-----------------------------------------------------------------------------------------------------------------------------------------------------------------------SSSSS--SSSSS------------ooooo-----------------------------------------------------------oo-----------------oo--oo---------------------------------------------------------------------------------------------------------------E--------------------------------------------------------------------------------------------------------------ooooooo----------Q-XXX---o--oo---------------------------------------------------------------------ESS-------SS--SSSSSSS---SS---------------------------------------------------------------XXXXXXX---------------------------------------------------------------------------------------------------------------------------------------------------------------------E------------------------------------------------------------------------------------------------------------------------------------------------------------------------------------------------?o-----------------------------------------------------------------------------------------------------------------------oo--o---------------------------------------------------------X--------------------------------
------------------XXXXX---SQ-------------------XXXX------------------------E--------------------------------SSSS--------------------------SQ------SQQ-------------------SSSS----------------------------------SQS--SQS---------S------------------------------S---SS--------------SSS-------------------SSSSSSS-----SS--SSS--------------------------------SSSSS------------------------------S?SS---SSQ---------------------------SXXXXX-------------------o--------------------------------------------------XXXX-----SS--------------------------------S--------------SSS---S--------------------------------------------------------Q--------------SSSSSS?------------------------------SSSS-----------------S?--SSS----S--------SS----------------------------XXXX--------------------------------------------------------------XXX-----SSS--SS----------------------oS---SS---S--------S-----S----------------SSS------------------------SSSSSSS----------------------------------------------------S----------------------------XX--------------------------SS----SSS------------------------------?S----------------------------------SQS----S---------------------------------------------SS------------------------------SSS---------------------------------XXX-----S------S--------------------S--------------------XX---------S----XXX---------------------E-------S-------------------------------SSSSSS---------------------------------------------XXX---------------------SSS------------------------------------------------------------SSSSSSSSS-----
-------oooo------------------------------o----XXXXX------------------------XXXXX-----------------------------------------------------------------------------------E----------------------------------------------------------------------------------XX------------------------------------------------------------ES--------------------------------------------------------------------------------------------------------------------------------XXX------------------------------------------------------------------------------------oooo---E-----------------------------------------------------------------------------------------------------------------------------------------------------------------------S--------SS-----------------XX------------------------XX-------------------ooo---------------------------XXX----ES-----------------------------S----S---S----------------------------------------------------------------------------------------ooooo-----------------------------------------------------XX--------------------------S------------------------------------------------------------------------------------------------------------------------------S--------------------------------------------------------------------XXX---E-----------------------------------------------------------------------XXX---------------------------------------------------------------------------------------------E-E-------------------------------------------------S--------------------------------------------------------------
---------------------------------------------XXXXXX---------------------------------------------------------------------------------------------------------------<>-------------------------------------------------------------------------------------------------------------------------------------------------S-----------------------------------------------------------------------------------------------------SS-S------------------------------------------------------X----------------------------------------------------------------------------------------------------------------X---------------------------------------------------------------------------------------------------------------------S-------SSS------------------------------------------XXX-----------------------------------------------XXXXX---oSS-----------------------------S----S---S--------------------------------------S-----------------------------------------------------------------------------------o-----------------------oX---------------------------S-------------------------------------------------S----------------------E-------------------------------------------------------------------------------------------------------------------------XXX--XXX-------------------------------------------------------------------------------------XX---------------------------------------------------------------------------XXXXXXX---------------XX-----------------------------------------------------------------------------------------------
-----E--------------E-------oo---oo---------XXXXXXX-----------------------------------------------E---------------E-----------------------------------------------[]--------------------------------S----------------------------------------------------------------------------------------------------------------S---------------------------------------------------------------------------------------------------?oS--S-??-?------XXXXX--------------XXXo--------------------X---oo--------------------------oo-S------------------E-------------------------------------S-------------------XX----------------o-----------------------E----------------------------------E--S---------------------------------------EE----SSSS------?-------------------------------------------------------------------------------------XXXXX----SS------------------------X-----E-----------ooooo-S---------------------------XX--oo----------------------------SSSS-S---------E--------------------------------------------------------ES---------------------E------------E----S--------------------E-----o---------------------------S-------<>-----------------------------------------------------S--------------------------------S-------------------------------EXEXXX-------------------------E-----E-------ooo-----------------------------------------------SS-------------------------------------------------------XXX----------------------------------------XXS----------------------------XS----------------------------------------------------------------
----<>-------------<>---QQQ?----------------XXXXXXX------------------XXXXXX----------------------<>-----E--------<>---SS-----S------E------X--QQ--QQQ------E---E--[]--------------oooS----XX----S-----------<>-----QQQQ------------------------------X------------SS--S----E-----------------------X-------SSSS----XSS--SSS---------------------QQQQQQ---------------------------E---------------S?S------SS-------X-----SSS--S-SS--XXX----------------------------------------------X----------------------------------------------------<>------------SSSS-------E---E-------S--------------------XXX--S-----------------------S?S----------<>-------SSSSSSS-------------------<>-----E--?---------------XX--X------------SSSS--------------------------------X-----XXXXX---------S--E?-------------<>-------------------------XXXXXXX----SSS----S-----------------XXX----SS--S-----SSSSSSSS----E----------------------XXX-------------------QQQ---------X--------------<>------------------Q--QQ-Q--Q-----S?S-----------------------XX-----------------<>---S-------SSSS----------------------<>-----SS-------X---S---S----X----S---E----[]-Q---QQQQ---------------E----------------------------SS----S-------------S---------------E--S--------X-------------------XXX------------S--------E--<>----<>----------------------------------XXX---------------------S--QQS-----S--------------------------------SS-SSS----E-------------------------------------------XXXX---------X--E--------------XX----------------------------SS---E?-----------------EQQ?-SSQS----
----[]-------------[]---------------------XXXXXXXXX----------o-----------------------------------[]----<>--------[]----------------<>------X--------------<>--<>--[]----------------E--E--XX----------------[]---------------E------------E----------X--------------------<>-------E--------------XX---X---E-----EXX---------------------------------------XX-------------------<>-------------------------------XXX---------E----------------------------------------------o------XSXX----------------------------------------------E----[]----------------------<>--<>----<>-S-------------------XXXX----X--------------------------------X-[]---------------------------------[]----<>------X----------XXX--XX----------XE------------------------------------------------------X--<>---------E----[]-------------------------XXXXXXX----------------------------XXXX---------X---------------<>X--------------------XXXX-SXX--------------------------XX--------------[]-----------------------------------------------------XXXX--XX-----------------[]--------E--E-------------------E-----[]----X------XX-XX--------E--E-------<>----[]-----------------------<>-----------------------------------------------X---------------<>---------XXX------------o--XXX-XXX--------------------<>--[]----[]---------------------X------------------------------------S----------------------------------------------------<>------------------------------------------XXXXXX-------XX-<>-------------XXX--XX----------------------------------------E--------------------
----[]-------------[]--------------------XXXXXXXXXX---------XXXXX--------------------------------[]----[]--------[]----------------[]------X--------------[]--[]--[]----------------------XXX---------------[]--------------<>-----X----------E------X--------------------[]------<>-------------XXX---X--------XXXX--------------------------------------XXX--X----------------[]------------------------------XXXXX-------------------o----------------------------------XXXXX---XXX----------------------------------------------<>----[]----------------------[]--[]----[]-S------------------XXXXX---SX-------------------------------XX-[]---------------------------------[]----[]------X---------XXXX--XXXX--------X----------------------------------------------XXXX----XX--[]--------------[]------------------------XXXXXXXX---------------------------XXXXX---------X---------------[]X-------------------XXXXX--SS-------------------------XXX--------------[]--<>---------------------------------------------XXXXXXX---XXX----------------[]-------<>---------------------<>-----[]----X----XXXX-XXX----------X-------[]----[]-----------------------[]-----------------------------------------------X---------------[]---------XXX-----------XXXXX---XXX--------------------[]--[]----[]-----------------E---XX--------------------XXXX----X------S----------------------------------------------------[]-------------XXX----XX------------------XXXXXXXX------XXX-[]-----------XXXXX--XXXX-------------------------------------<>--------------------
--E-[]-------------[]---------------------XXXXXXXXX---------------------------------------------E[]----[]--------[]---------E-EE---[]E-----X------EE------[]--[]--[]----E-----------------XXXX--------------[]------------E-[]--EE-X-----------------X-----E-EE-----------[]------[]---X--------XXXX-E-X-------XXXXXE----------E-------------------------XXXX--X------E---------[]--------EE-------------------XXXXXE------------------XX------------------------------------------XXX----------------------------------------------[]----[]---------E-E-------E--[]--[]----[]ES--------EE-E-------XXXX----X------------------------------XXX-[]--E------------------------------[]----[]------X---EE-E-XXXXX--XXXX--------X------------------S-------------------XXX------------XXX--[]--------------[]---------------------E-XXXXXXXXX----E-EE------------------XXXXXX----E--E-X---------E-----[]X--------EE-E---E--XXXXXX--SS---------E-E------------XXXX------------E-[]--[]-----------------E-----------------X--------XXXX-X-----XXX-EE-------E-E---[]-------[]-------E-----E-EE----[]-E---[]----XE-EEXXXX-XXX----------X-------[]---E[]-----------EE-E--------[]-----E-------E-----------EE-E----------E-E-----X------------E--[]---------XXX-------------------XXX-------E-E--------E-[]--[]-E--[]-S-------------------XX-------oooo--XXXX----------SS-EE---S-----------------------EE-E---------EE-EE-E---------[]--------XXXXXXX-------------------o----XXXXXXXX------XXXX-[]-----------XXXXXE-XXXX------E-E--------E--------------E----[]--------------------
XXXXXXXXXXXXXXXXXXXXXXXXXXXX-XXXX---XXXXXXXXXXXXXXXXXXXX-------------------------XXXXXXXXXXXXXXXXXXXXXXXXXXXXXXX-XXXXXXXXXXXXXXXXXXXXXXXXXXXXXXXXXXXXXXXXXXXXXXXXXXXXXXXXXXXXXXXXXXXXXXXXXXXXXXXXXXXXXXXXXXXXXXXXXXXXXXXXXXXXXXXXXXXXXXXXXXXX---XX-XXXXXXXXXXXXXXXXXXXXXXXXXXXXXXXXXXXXX----XXXXXXXXXXXXXXXXXXXXXXXXXXXXXXXXXXXXXXXXXXXXXXXXXXXXXXXXXXXXXXXXX--XXXXXXXXXXX--XXXXXXXXXXXX-XXXXXXXXXXXXXXXXXXXXXXXXXXXXXXXXXXXXXXXXXXX------------------------------XXXX-------------XX-----------X----------X------------XXXXXXXXXXXXXXXXX-XX--XXXXXXXXXXXXXXXXXXXXXXX-XXXXXXXXXXXXXXXXXXXXXXXXXXXXXXXXX--SSXXXXXXXXXXXXXXXXXXXX-XXXXXXX-XXXXXXXXXXXXXXXXXXX-XXXXXXXXXXXXXXXXXXXXXXXX-XXXXXXXXXXXXXXXXXXXXXXXX--XXXXXXXXXXX-XXXXXXXXXXXXXXXXX--XXXXXXXXXX--------------------------XXXXXXXXXXXXXXXXXXXXXXXXXX---X-X-XX----XX-XXXXXXXXXXXXXXXXXXXXXXXXXXXXXXXXXXXXXXXXXXXX--XXXXXXXXXXXXXXXXXXXXXXXXXXX---XXXXXXXXX-XXXXXXXXX---S-XXXXXXXXXXXXXXXXXXXXXXXXXXXXXXXXXXXXXXXXXXXXXXXXXXXXXXXXX-XXXXXXXXXXXXXXXXXXXXXXXXXXXXXXX--------------XXX--XXXXXXXXXXXXXXXXXXXXXXXXXXXXXXX-XXXXXXXXXXXXXXXXXXXXXXXXXXXXXXXXXXX--XXXXXXXXXXXXXXXXXXXXXXXXXXXXXXXXXXXXXXXXXXXXXXXXXXXXXXXXXXXXXXXXXXXXXXXXXXXXXXXXXXXXXXXXXXXXXXXXXXXXXXXXXXXXXXXXXXXXXXXXXXXXXXXXS-XXX-XX-XX----X-X----XXXXXXXXXXXXXXXXXXXXXXXXXXXXXXXXXXXXXXXXXX---XXXXX--XXXXXXXXXX-XXXXX-------X---------SX--XXXXX---XXXXXXXXX----XXXXXXXXXXXX---XXXXXXXXXXXXXXXXXXXXXXXXXX--------------------------XX-X----XXXXXXXXXS-----XXXXXXXXXXX--XXXXXXXXXXXX-XXXXXXXXXXXXXXXXXXXXXXXXXXXXXXXXXXXXXXXXXXXXXXXXXXXXXXXXXXX----