------------------------------------------------------------------------------------------------------------------------------------------------------------------------------------------------------------------------------------------------------------------------------------------------------------------------------------------------------------------------------------------------------------------------------------------------------------------------------------------------------------------------------------------------------------------------------------------------------------------------------------------------------------------------------------------------------------------------------------------------------------------------------------------------------------------------------------------------------------------------------------------------------------------------------------------------------------------------------------------------------------------------------------------------------------------------------------------------------------------------------------------------------------------------------------------------------------------------------------------------------------------------------------------------------------------------------------------------------------------------------------------------------------------------------------------------------------------------------------------------------------------------------------------------------------------------
------------------------------------------------------------------------------------------------------------------------------------------------------------------------------------------------------------------------------------------------------------------------------------------------------------------------------------------------------------------------------------------------------------------------------------------------------------------------------------------------------------------------------------------------------------------------------------------------------------------------------------------------------------------------------------------------------------------------------------------------------------------------------------------------------------------------------------------------------------------------------------------------------------------------------------------------------------------------------------------------------------------------------------------------------------------------------------------------------------------------------------------------------------------------------------------------------------------------------------------------------------------------------------------------------------------------------------------------------------------------------------------------------------------------------------------------------------------------------------------------------------------------------------------------------------------------
-------------------------------------------oo-----------------------------------------------------------------------------------------------------------------------------------------------------------------------------------------------------------------------------------------------------------------------SSSSSSSSSSSSSS?SSSSSSSSSSSSS-----------------------------------------------------------SSSSSS----------------------------------------------------------------oo-----------------------------------------------------------------------------------------------------------------------------------------------------------------------------------------------------------------------------------------SSSSSSSSSSSSSSSSSS-S--------------------------------------------------------------------------------------------------------------------------------------------------------------------------------------------------------------------------------------------------------------------------------------------------------------------------------------------------------------------------------------------------------------------------------------------------------------------------------------------------------------------------------------------------------------------------------------------------------------------------------------------------------------------------------------------------------SSSSSSSSSSSSSSSSSSSSSSSSSSSS------------------------------------------------------------------------------------
---------------------------X----------------------------------------------------------------------------------------------------------------------------------------------------------------------------------------------------------------------------------------------------------------------------------------SSSSS-----------------------------------------------------------------------------------------------------------------------------------------------------------------------------------------------------------------------------------------------------------------------------------------------------------?----------------------------------------o------------------------------------------------------------------------------------------------------------------------------------------E--E---------------------------------------------------------------------------------------------------------------------------------------------------------------------------------------------------------------------------------------------------------------------------------------------------------------------------------------------------------------------------------------------------------------------------------------------------------o----------------------------------------------------------------------------------------------------------------------------------------------------------------------------------------------------------------------------------------------------------------------------------
-------------------------------Eooo----------------oo---------------------------------------------------------------------------------------------------------------------------------------------------------------------------------------------------------------------------------------------------------------ESSS------------------------------------------------------------------------------------------------------------------------------------------------------------------------------------------------o---------------E----------X------------------------------------oo--oo---------------------------------------------------------------------------------------oooooo----------------------------------------------------------------------------------------------------------------------------XXXXXXX--------------------------------------------------------------------------------------------------E----------------------------------------------------------------------------------------------------------------------------------------------------------------------------------------------------------------------------------------------------------------------------------------------------------------------------------------------------------------------------------------------------------------o---o-----------------------------------oooo---------------------------------------------------------------------------------------------------------------------------------------------------------------------------
------------------------X------XXXXX-------XXX---XXXXX-----------------------------------------SSSS--SSSSSSS----SSSS--------------S??S------------------E-----oo-----------------------------------------------------S----------------SQQ-----------------------SSQS---------------SSSSSSSSSS-------------SSSSS-----SSQ-------ooooo---------------------------------------------------------------SSS----------------------------------------------------------S------S-XXX----------------------S---?SSSS--------------XX--------E-----E-EE---------------------------------S--o---------------------------SSSS----?SSS-----E--?oo---------------SSS-------------------------XXXXX----XXXX----oSSSS---SSQ---------------------------------------------o-----------SSSSSSSSSSSSS---S-----------Q-----------------------------------------------?--------------SSSSS-----------S-Q-------------------??SSS------SSS----SSSSS----------SS---------------------SS---------------E----------------------SSSSSSSS--------------------------------------------QQQQQQQ-------------SSS--------Q------------------------------------------------------------------------------------------S-------S-----------------------------SSSSS---------o------------------------SSS--SSSSSS---------SSS---------------?---------------XXX-----------------------------------------------------------------XXXX---------------SSSS----------------SS-----Q---Q--Q----------------------------------oo-------------------------------------------------------------------------------------
-----------------------XX-------------------------------------------------------------------------------------------------------------XXXX--------------------------------------------------------------------------------------------------------------------------------------------------------------------------SS-----------------------------------------------------------------------------------------------------------------------------------------X--------------------------------------------------------------------------XXXXXXX----------------------------S-----------------SSSS-------------------------<>--------------------------------------oo------------------------XX----------------------XXXX-----------------------------X-------------------------------------------------------------------------oooo---------------------------------------------------------------------------------------------------------------------------------------<>------------------------------------------------------------------------------------------------------------------------------------------------------------oo------------------XX---------------------------------------------S-----------------------------------------------------------------------------------------------------------------S--------------------------------------------------XX----------------------------------------------------------------------oo------E-----------------------oooo--------------------------------------------------------------------------
---------------------X-X----E------------------------------------------------------------------------------------------------------------------------------------------------------------------ooo---------E-------------------------------------------E------------------------------------------------------------SS--------SSSSSS-------------------------------------------------E-------------------------------------------------------------------------S-------------------------------------------------------------------------------------------------------------S----------------------------------------------[]----------------------------------------------------------------o-------------------------------------------------------XX---------------------------------------------------------------------------------------------------------------X----------------------------------------------------------------------------------------------------[]---E--------------------------------X-------------------------------------------------------------------------------------------------------------------------------------------XX-------------------------------------------------------------------------------------------------------------------S-----------------------------------------X----------------------------------------------------------------------------------------------------------------------------------XXX--------------------------------------------------------------------o--------------------------------
---------------------X-XX---E-------------X-----------------------Eooooo-------------------------------------------------------------------------------------------------X-----------------------------E----------E-----------------------------------<>------------------------------------------------------------SE--------SSSSSS----------------------------------------S-------<>--S--------SSSSSSS---------------------E----------------------------------------------------------------------------------------------------------------XX----------------------------SS--X---oo------------------------S-------------[]-----------------------------------E-----------------------------------------------------------------------------------XXX--------------------------------------------------------SS----------S--E---------------------------------------X-------------------------------S----------------------------------------------E-------X-------------[]------------------------------------X----------------E-----------X------------------oo-----------E-------------E------------------------------------------E-------E------------XXX----E-------------------------XXX---------------SSSS-SS-SSSSSS-------------------------------------------------X----------------------------X---oo----------XSS-SQ----------------------------------oo---------------------------------------------------------S--------------------------------------------------------E-----------------E------oo-----------------------------------------------E-----
------------------XX-XXX-----------------------XXXX--XXX------E--<>-------------E--S----QQQ------------------------------------XXX---SS----------------------XX-----------------------------SSS-------<>---------<>------------XQ-Q---SQS----------E--[]----------------SS-------------Q-QQQ------------XX---SSS----SSSS---------S---------------------------------------------E----[]-----E--------------------------------<>---------------------E------XX-XXXQ---S?SQS----------------------QQQ--QQQS--------------------------XXXXXX--------------------------------oo---S-----o--o--------------------------Q---SXS----XXXXX--XXXX-----------S-------------<>----------------XXXXX---X---------SQQQQQQ-Q--Q------------------------------------XXXX---SQQ-----XX------SSSSSSSS----Q---QQQ-QQQQQQ----------Q--------------<>-------------o------------XXX---------XX------S?S--------X--X---------------------XXXXX-SSS---------SSS--------S-----<>--------------SS-----<>-------------QQ--Q-Q--QQQQ--------XXX---------------<>----------XXX--QQ--QQ?SSQS-------------Q--<>---QQ?SQQ---<>----------------------E-------------E----<>------<>-----------XXXX---<>----------------------------E------------------------------Q--S-----X---SSS-------------------X----------XXS---SS--------S-------Q--------------------XXX---------------------------------------------XXXX----------------------------------------SSS-----SSS------QQQQ--Q-----Q--------------ooo-----------------<>----------------<>---X----------------------S---------------------S-----<>---Q-
-----------------XXX-XXX----X--------------------------------<>--[]----------------------------------------------------------------------------------------XXXX------SS--------------XX------------X--[]---------[]-----------XX---------------E--<>--[]---------------------------------------------------E-------XE-------------------E----------------------E---------E----<>----[]----<>--------------------------------[]--------------------<>-----XXX-XXX-----------------------------------------------------------------------------------------------------------------------------XXXX-----o---------------------------------------------------------[]--------------------X------------------------------------------------------------XXXXX----------XXX--XX--E--------------------------------------------------[]--------XXX--------------XXXX-------XXXX--------------E--X--XX--------------------------E----------------------------[]---------------------[]----------S----------------------XX-XX--------------[]--E------XXXX-----------------------------[]------------[]---------------------<>----------XX<>----[]------[]---------XXXXXX---[]----------------------------------------------------------------------------------------------XX--------XXX------------------------------------------XXXX--------XX-----------------------XXXXX------------------------o-----------------------------------------------------------------------EE-----oo----------[]-------------E--[]--XX---------------------------E-------------------E--[]--E--
----------------XXXX-XXX----X------------------------XX------[]--[]------------------------------------------------------------------------X------------XXXXXXXX-----SS-------------XXX-----------XX--[]---------[]-----------XX--------------<>--[]--[]-------------------------------------------------------E--XX------------------------E-----------------<>--------<>----[]----[]----[]--------------------------------[]--------------------[]----XXXX-XXX--------------------------------------------------------XXXXXXX-------------------------------------------------------------XXXXX----X---XXX----------------------------------------------<>----[]--------------------XXXX----o---------------------------------------------------XXXXXX---------XXXX--XX------E-------------------------<>-------------------[]-------XXXX-------------XXXXX------XXXXX-----------------X--XXX-----------------------------E-o----------------------[]---------------------[]----------S---------------------XXX-XX-----------------<>-----XXXXS-----------------------------[]------------[]---------------------[]---------XXX[]----[]------[]--------XXXXXXX---[]------------------------------------------------------------------------------------------E---XXX------XXXX--------------------------------------<>-XXXXX--------XX-----------XXXX---XXXXX----------------XXXX--XXX---XXXXX-----------X---X----------------------------------------------XXXXXXXXX----------------[]------------<>--[]-XXX--------------------------<>------------------<>--[]-<>--
---------------XXXXX-XXXX---X-----------------------------EE-[]--[]---------E--------------------------------------------------------------X----XXXX-XXXXXXX-XX--SSSSS-------------XXXX----------XXX--[]---------[]-E---------XX--------------[]-E[]--[]--------EE-E---------------------------------------------XXX----------------------------------------E-[]--------[]----[]----[]----[]--------------------------------[]-----------------E--[]-E-XXXX--XXX--------------------------------------------------EE-E--------------------------------E-----E--E---E--------------------X--XXXX----SSSS--------------o------------------------------------[]----[]------XXXXXXXXXX?-----------XX----------------------EE-EE-----EE-E-------------XXXXXXX--------XXXXXE-X-----------------E----------E-E--[]-------------------[]------XXXX-------------XXXXXX-----XXXXXX------EE-----E---X--XXXX---E-------------------------------E-------E--------E[]---------------E-EE--[]----------S------E--E-E---E-E--XXXX-XX---EE------------[]----XXXXXS----E-EE------------E-----E--[]------------[]---------------E-EE--[]---E----XXXX[]-E--[]-E-E--[]----E---XXXXXXX---[]------------------------E-----------------------------------------------------------------XX--XXXX----XXXXX---------------------EE-E--X----------[]XXXXXX--S-S?XXXX-------------------------------------------------------------------X---X--------------------------------------------------------------------E--[]-E-EE-----E-[]--[]-XXXX------------E-E----------[]-----E-E--E-----E-[]--[]-[]--
XXXXXXXX--XXXXXXXXX--XXXXXXXXXXXXXX------XXX------------XXXXXXXXXXXXXXXXXXXXXXXXXXXXXXXXXXXXXXXXX-XXXXXXXXXXXXXXXXXXXXXXXXXXXXX----XXXXXXXXXXXXX----XXXXXXXXXX----------XXXXXXXXXXXXXX-------XXXXXXXXXXXXXXXXXXXXXXXXXXXXXXXXXXXXXXXXXXXXXXXXXXXXXXXX-XXXXXXXXXXXXXXXXXXXXXXXXXXXXXXXXXXXXXXXXXXXXXXXX----X-XXXXXXXXXXXXXXXXXXXXXXXXXXXXXXXXX--XXXXXXXXXXXXXXXXXXXXXXXXXXXXXXXXXXXXXXXXXXXXXXXXXXXXXXXXXXXX--XXXXXX--XXXXXXXXXXXXXXXXXXXXXXXXXXXXXXXXXXXXXX--SXXXXXXXXXXXXXXXX---XXXXXXXXXXXXXXXXXXXXXXX-----XXXXXXXXXXX----------------------------XXXXXXXXXXXXXXXXXXXXXXXXXXXXXXXX---XXXXXXX---------SS-S----XXXXXXX------------------X---XXXXXXXXXXXXXXXXXXXXXXXXXX--------------------------XXXXXXXXXXXXXX---XXXXXXXXXXXXXXXXXXXXXX----XXXXXXXXXXXXX--XXXXXXXXXXX-XXXXXXXXXXXXXXXXXXXXXXXXXXXXXXXXXXXXXXXXXXXXXXXXXXXXXXXXXXXXXXXXXXXXX-XXXXXXXXXXXXXXXXXXXXXXXXXXXX-XXXXXXXXXXXXXXXXXXXXXXXXXXXXXXXXXXXXXXXX--------XXXX---XXXXXXXXXXXXXXXXXXXXXXXXXXXX--XXXXXXXXXXXXXXXXXXXXXXXX--X--XXXXXXXXXXXXXXXXXXXXXXXXXXXXXXXXXXXXXXXXXXXXXXXXXXXXXS-XXXXXXXXXXX--XXXXXXXXXXXX-XXXXXXXXXXXXXXXXXXXXXXXXXXXX-XXXXXXXXXXXXXXXXXXXXXXX-XXXXXXXXXXXXXXXXXXXXXXXXXXXXXXXXXXXXXXXXXXXXXXXXXXXXXXXXXXXXXXXXXXXXXXXXXXXXXXXXXXXXXXXXXXXXXXXXX-----------XXX----XXXXXXXXXXXXX--XXXXXXXXXXXXXX-XXXXXXXXXXXXXXXXXXXXXXXXXXXXXXXXXXXXXXXXXXX-----XXXXXXXXXXXXXXX---------------E---XXXX------------------------XXXXXXXXXXXXX--XXXXXXXXXXX--XXXXXXXXXXXXXXXXXXXXXXXXXXXXXXXX----------------------XXXXXXXXXXXXXXXXXXXXXXXXXXXXXXXXXXXXXXXXXXXXX-X-XXXXXXXXXXXXXXXXXXXXXXXXXXXXXX-XXXXXXX