------------------------------------------------------------------------------------------------------------------------------------------------------------------------------------------------------------------------------------------------------------------------------------------------------------------------------------------------------------------------------------------------------------------------------------------------------------------------------------------------------------------------------------------------------------------------------------------------------------------------------------------------------------------------------------------------------------------------------------------------------------------------------------------------------------------------------------------------------------------------------------------------------------------------------------------------------------------------------------------------------------------------------------------------------------------------------------------------------------------------------------------------------------------------------------------------------------------------------------------------------------------------------------------------------------------------------------------------------------------------------------------------------------------------------------------------------------------------------------------------------------------------------------------------------------------------
------------------------------------------------------------------------------------------------------------------------------------------------------------------------------------------------------------------------------------------------------------------------------------------------------------------------------------------------------------------------------------------------------------------------------------------------------------------------------------------------------------------------------------------------------------------------------------------------------------------------------------------------------------------------------------------------------------------------------------------------------------------------------------------------------------------------------------------------------------------------------------------------------------------------------------------------------------------------------------------------------------------------------------------------------------------------------------------------------------------------------------------------------------------------------------------------------------------------------------------------------------------------------------------------------------------------------------------------------------------------------------------------------------------------------------------------------------------------------------------------------------------------------------------------------------------------
-------------------------------------------------SSSSS-----------------------------------------------------------------------------------------------------------------------------------------------------------------------------------------------------------------------------------------------------------------------------------------------------------------------------------------------------------------------------------------------------------------------------------------------------------------------------------------------------------------------------ooo------------------------------------------------------------------------------SSSSSSSSSSSSSSSSSSSSSSSSSSSS--------------------------------oo------------------------------------------------------------------------------------------------------------------------------------------------------------------------------------------------------------------------------------------------------------------------------------------------------------------------------------------------------------------------------------------------------------------------------SSSSSSSSSSSSSSSSSSSSSSSSSSSS-------------------------------------------------------------------------oo--------------------------------------------------------oo-----------------------------------------------------oo--------------------------------------------------------------------------------------------------------------------------------------------------------------------------------
---------------------Q----oo-----------------------------------------------------------------------------------------------------------------------------------------------------------X-------------------------------------------------------------------------------------------------------------------------------------------------------------------------------Q-------------------------------------------------------------------------------------------------------------------------oo--------------------------------------------------------------------------------XXXX------------------------------------------------------------------------------SSSSS-------SSSSS--SSSS----------ooo---------------------------E--E-----------------------------------------------------------------------------------------------------------------------------------------------------------------XX------------------------------------------------------------------------?----------------------------------------------------------------------------------------------------------------------------------------------------------------------------S----SSSSSSSSSSSSSSSSSSSSSSS----------------------------------------------------------------------------------------------------------------------------------XXXX--------------------------------------------------------------------------------------------------------------------------------------------------------------------------------------------------------------------------------------
--------------------------------------------------------------------------------------------------------------------------------------------------------------------------------?---------------------------------------------------------------------------------------------Eooo-------------------------------------------------------Eooo---------------oooooo----------------------------------------------------------------------------------------------E-----------------------------------oo---------------------------------------------------------------------------------------------------------------------------------------------------------------SSSSS--E----SSSSS--SSSS--E------------------------------------XXXXXXX---------------------------------------------------------------oooo------------------------------------------------------------------------------------------------------------------------------------------------------------ooooooo-oo-------------o---oo------------------------------E----------------E---?---------------------------------------------------------------------------------E--------------------S----SSSSSSSSSSSSSSSSSSSSSSS-----------------------------------------------------------------o---------X------------E-------------------------------oo-----------------------------oooooo--oo--------------Eooo-------------------------------oooooooo--------E------------------------------------------------------------------------------------------------------oo---------------------------------
----XX----------------------S----------o----------------------------------------SSSSSS-------------------------------------------------SSSSSSSSS---o----XXoo----oo---------S----XXX--------XX-------SSS------SSS-----E--------------------------------------------------------XXXXX------------------------------------------------------XXXXX----XXX--------------------------------------------------o-----------------SSSSSSSSS-------------------SSSSS------SS--SSS--------------SSSSS-----SS--XXXX------XX-----SSSS-------------------------------------------XXX---SS-SSS------------------------------------------------XX-------QQQ---------------------------S----SSS-----------S----SS---S-----SSS-----------------SS------------------------S----------------SSSS------SS---XXoo------E-------XXXX---SSSSS------SSS------------------S-------SSSSSSSSSSSS----SSS-----SQQQQ----------------------------------------------?----------------SSSS---------oo--XXXX----------------------------------------------oo-----------E--------oo-----SQS-S??------------------------E----XXoo----?------------------------------------------E--E------oo-----X---S--SSSSSSSSSSSSSSSSSSSSSSSSS-------------------------------SS------SSSSSSS---SSSS------S----XXX-------XXX----------SQS------SSSSSS------------------XXX----------------------o--XXXXX----------------------XXXXX-------X--------------------------------------E--E-------------------??------------------------XXX--SS----------------------------------------------------------------------------------
--o---------o--------o------SX--------------------------------------------------------------------------------------------------------------XXX-----------------------XX-------------------XX-----------------------<>----------------E--------------------------------------------------------ooo----------------------------------------------o------------------------------------------------------X-----------------------------------------------------------------------------------------------------XX---------------------------------------------------XXXX---------------------------------------------------------XX-------------------------------------SS---SSS-----------S----SS---------------------------------------------oo----------------------------------------------------XX---------------------------------------------------------------------------------------------------------------XSSS------------------------------------XX-------------------------------------------oo-o-------------------------XXXX----------------------------------------<>---------------XXX---------------------------------------XXX------------------------------------------------------------------------------------------------------XX-------------XXXX----------------------------------------------------SSS------------XX----------XXX---------------------------EXSSS------------------------------E------XXXXXX-----------------------------------------XXX--------------------------------------------SSSSS-------------------------------------
-------XXXXXXX------XXX-XXX-S----------S-----------------------------------------------------------------------------------------------------------------------------oo-----------------XXXXX-----------------------[]--------------XXXX-------------------------------------------------------------------------------------------------------------------------------XXXXX--------------------------XX-----------------------------------------------------------------------------------------------------XX------------o--------------------------------------XXXX-------------------------------------------------------XXSX----------o--------------------------S----SSS-----------S----SS-------------------------------------------------------------------------------------------------------------------------------------------------------------------------------------------------------------------XX--o--------------------------------------------------------------------------------------------------------XX------XX----------------------------------------[]------------------------------------------XX--------------------------------------------------------------------------------XX--------------------------------------------------XXXXX--------------------------------------------------XX--------------------------------------X------------------XXX------------------------------XXXXX-XX-------------------XX---------------------------XX----------------------------------------------X----------------------------------------
----------------------------S--------SSSS----------------------------------------------------------E--S-S---------------------E-------------------------------------------------------E-EX-XX-----------------------[]----E--------------------------------------------o---------------------E-------------------------------------------------------------------------------------oo----------------XXX--------------------------------------------------------E--------------------SS-------SSSSS-------E--XX-------------------------S------------------------XXXXX-----------------------------------E---oo-------------XXXXX---------------------------------o-?-So??-SSS-------???-So?--SS--SS-----------------------------------------------------------------------------------------------------------------------------------------------------------------------------------------o----------oo---------XXS--SQ----------oo---------E----------X------XXXX----------------------------------E--SSSSS--------------------------X------------------------S-SQSSSSSS---E--XX-----------------------------------------XXX-------------------------------------------------------E------------------------XX---------SS---------------------------------------XXXXX-----------------------------------X---oo--------X-XSS-SQ-----------------------------------ooo--o----------XXXS---------------------------------------------------------XX-------------------------X-XX--------------------E--o-----------oo--------XSX---------------------------------------
-----XX------ooo-----X------SSS-----------------------E------E----------------------QQ--S?S-------<>-------------------------<>--------------------------XXXXXXXXXXXX----------------------XX----------------S?---E------<>---------------------XXX---XXX---Q--------------XXXX--SSS-----E--<>----S------------------QQQ----------------<>------XX-------------XX-----------------------------------XXXX--------------------------XX----------------S-----QQQQ--XS--S?S--------------------X-------------<>-------------SSS------------------------Soooo-------XXXXXXX---------X---------------S--------<>-S-----------------XX---------?SQ---------------------------SSS--SSSS----SS----SSS--SS---------SSS----------------------SS--S----E--S-------SS----------E----S----------SS------XXXX---------------------SSSS----XX--X---------------S-------XX--X-----------X-------Q??SSSSS-------------oo-oooo-----X-XXXX---------X-o-o-----E----<>----------XX--------X----XXX--------------------------<>------------X----XXX-------------X----------S?SQS---------------------<>-----XXXXX---XXXX----X-----E-----E-----------XXX-------XXX-------XX----XXX-XXXX-------------------X-SSSSSSS------XXXXX----------XX---------SS-------X--X-----------X---------------XXXXXX-------X----------E----Q-----------------o-------XXXX---------X-------XXXXXXXXX-----------------------------XXXX-----------------------------------X-------------------XXXX-XX------------------SSS---XX-------------------<>-------oo----o-----------XX---------------------------------------
---------------E-----X-----------------------------XXXXX--------------E---E-----------------------[]-------------------------[]-------------------------------------------------------XXX-XXX--------------------<>------[]------------------------------XXX----------------------------<>--[]------------------------------------------[]--------------------------------------E------------------XXXXX----------E--------E-------X------------------------------------------------------XX-------------[]-----E---------------------------------------------XXXXXXXX--------XX-----------E------E-----[]-S----------------XXX-X------------XXX-?---------------XXX------------E---------------------------------------------------------<>----------SS---------<>-----------E-----------------------o-----o--E----------XXX--XX-------------E-------XXX--XX---------XXXX---------------E----------------------XXXXXX--------XX--------<>----[]--------XXXX-------------------------o----------------[]---------------XXX------o--------X-----------------------X------------[]--------------------------<>----<>---------XXXXX----------------------------------------------------EE---------------------------X----o------------XX--XX---------XX--------------XXXXXXX-------S---------<>----------------------------XXXXXX--------EX--------------------------------------------XXXXX-SS-------E------------------------X------------------XXXXX-X--------XX---------------XX-------------------[]-----------------------XXX--E-----------------------------E-------
------XXXXXXXXXXX--X-X-----------------------------------------------<>--<>-----------------------[]-------------------------[]------------X----XXXX------------------o------------XXXX-X--XX--------------------[]------[]----------XXX-------------------------------------------E--E-[]--[]------------------------------------------[]-----------------XXX----XXXX---------<>-----------------XXXXXX---------<>------------E---X-----------------------------------------------------XXX-------------[]----<>---------------------------------------------XXXXXXXX-------XXX----------<>-----<>-----[]-S---------------XXXX-E----------------------------------------------------------------------------E----------------------------[]---------SSS---------[]----------<>----------------XXXX--XXX---XXXXX---------XXXX--XXX-------------------XXXX--XXX--------XXXX--------------<>----------------------XXXXXX-------XXX--------[]----[]-------XXXXX---o--------------XXX---XXX---------------[]-----------------------XX--------X-----------------------X------------[]--------------------------[]----[]---------XXXXX--------------------------------------------E--------------------------XXXXX----SX----------------XXX--XXX-------XXX-------------XXXXXXXX-------X---------[]----------------------------XXXXXX--------XX------------------XXXX---------------------XXXXXX---------<>---------------------XXXX-----------------XXXXXX---------------------------XXX------------------<>--------------------XXXXX---XXXX--oooo-------------------<>------X
-XX----------------X-X-----o-------------------------------EE--------[]--[]--EE-------------------[]-------------E-EE--------[]-------E----X--------oo---------------XXXE-----------------XXX---EE-X-------------[]-E----[]----------------------------------------------------------XX-[]-E[]----------------E-E---------EE------------[]-------------------------------------[]----------------XXXXXXX---------[]-E--------------X-------E-EE-EE--------------E----------E------------XXXX-------------[]----[]----------E-----------E---------E--E-------XXXXXXXXXX------XXXX------E-E-[]--EE-[]-----[]------------------XXXXX---E----------------------------------------------------------E-----------------------------E-E----------[]-E--------SS---EE-E--[]----------[]--------oooo-----------------------------XXXXX--XXXX---E-E-----------XXXXXE-XXXXE------XXSS--------------[]---------------------XXXXXXX------XXXX--------[]-E--[]------XXXXXX--XXX----------------------------------E--[]--------------------------------SS-----o-----------------X------------[]----o---------------------[]----[]--------XXXXXX--------------------------------------------------------------ooo---------------SX---------------XXXX--XXXXE-EE-XXXX------------XXXXXXXXX-------X--E------[]---------EE-----------------XXXXXX--SSSSS--XXXXXX-------------------------------------XXXXXXX---------[]------------------------X----E-E-----E-E--XXXXXX--------------------E------XXX------------------[]----------------XXXXXXXX?--------------------------------[]-----XX
XX-----------------XXXXXXXXXXXXXXXXXXXXXXXXXX-XXXX------XXXXXXXXXXXXXXXXXXXXXXXXXXXXXXXXXXXXXXXXXXXXXXXXXXXXXXXXXXXXXXXXXXXXXXXXXXXXXXXXXXXX--------XX------------------XXXXXXX--------XXXXXXXXXXXXXXXXXXXXXXXXXXXXXXXXXXXXXXXXX-------XXX--XXXX------------XXXXXXXXXX-XXXX------XXXXX--XXXXXXXXXXXXXXXXXXXXXXXXXXXXXXXXXXXXXXXXX--XXXXXXXXXXXXX----------------------------XXXXXXXXXXX-----XXXXXXXXXXX-XXXXXXXXXXXXXXXXXXXXXXXXXXXXX--XXXXXXXXXXXXXXXXXXXXXXX--XXXXXXXXXXXXXXX--XXXXXXXXXXXXXXXXXXXXXX-XXX--XXXXXXXXXXXXXXXXXXXXX-XXXXXXXX-XXX-XXXXXXXXXXXXXXXXXXXXXXXXXXXXXXXXXXXXXXXXXXXXXXXXXXXXXXXXXXXX----XX---XXXXXXXXXXXXXXXXXXXXXXX----XXX-XX-X--XXXXXX----XXXXXXXXXXXXXXXXXXXXXXXXXXXXXXXXXXXXXXXX-X---XXXXX--XXXXXXXXXXXXXXXXXXXXXXXXXXX---XXXXXXXXXXXXXXXXXXXXXXXXXXXXXX---XXXX---------------------XXXXXXXXXXXXX--XXXXXXXXXXXXX--XXXXXXXXXXX-XXXXXXXXXXXXXX-----XXXXXXXXXXXXXXXXX-XXXXXXXXXXXXXXXXXXXXXX----XXXXXXXXXXXXXXXXXXXXXXXXXXXXXXXXXXX----------------------------XXXXXXXXXXXXXXXXXXXXXXX-XXXX--------------------XX-XXXXXXXXXXXXXXXX-XXXXXXXXXXXXXXXXXXXXXXXXXX------------------XXXXXXXXXXXXXXXXXXXXXXX--XXX----------------------------XXXXXXXXXXX---XXXXXXXXXXXXXX-XXXX-------XXX----XXX--XXXXXXXXXXXXXXXXX--XXXXXXXXXXXXXXXXX---XXXXXXXXXXXXXXXXXXXXXX-XXXXXXXXXXXXXXXXXXXXXXXXXXXXXXXXXXXXXXXXXXX-------XXXX----------------------------X--------XXXXXXXXXXXXXX--XXXXXXXXXXX----XXXX------------X--XXXXXXXXXXXXXXXXXXXX-XXXXXXX-------XXXXXXXXXXXXXXXXXX-------XXXXXXXXXXXX---XXXXX-XXXX---S-XXX-----------SS---XXXXXXXXXXXXXXX--XXXXXXXXXXX