-------------------------------------------------------------------------------------------------------------------------------------------------------------------------------------------------------------------------------------------------------------------------------------------------------------------------------------------------------------Q-oE-------------------------------------------------------------------------------------------------------------------------------------------------------------------------------------------------------------------------------------------------------------------------------------------------------------------------------------------------------------------------------------------------------------------------------------------------------------------------------------------------------------------------------------------------------------------------------------------------------------------------------------------------------------------------------------------------------------------------------------------------------------------------------------------------------------------------------------------------------------------------------------------------------------------------------------------------------------------------------------------------------------------------------------------------------------------------------------------------------------------------------------------------------------------------------------------------------
---------------------------------------------------------------------------------------------------------------------------------------------------------------------------------------------------------------------------------------------------------------------------------------------------------------------------------------------------------------XQ-------------------------------------------------------------------------------------------------------------------------------------------------------------------------------------------------------------------------------------------------------------------------------------------------------------------------------------------------------------------------------------------------------------------------------------------------------------------------------------------------------------------------------------------------------------------------------------------------------------------------------------------------------------------------------------------------------------------------------------------------------------------------------------------------------------------------------------------------------------------------------------------------------------------------------------------------------------------------------------------------------------------------------------------------------------------------------------------------------------------------------------------------------------------------------------------------------
-------------------------------------------------------------------------------------------------------oo------------------------------------------------------------------------------------------------------------------------------------------------------------------------------------ooo---------------------------------------------------------XX---XXSS---------------------------------------------------------oo-----------------------------------SSSSSSSSSSSSSSSSSSSSSSSSSSSS--------------------------------------------------------------------------------------------------------------------------------------------------------------ooo------------------------------------------------------------------------------------------------------------------------------------------------------------------------------------------------------------------------------------------------------------------------------------------------------------------------------------------------------------------------------------------------------------------------------------------------------------------------------------------------------------------------------------------------------------SSSSSS----------------SSSS--------------------------------------------------------------------------------------------------------------------------------------------------------------------------SSSSSSSSSSSSSS-----------------------------------------------------------------------------------------------------------------------------
------------------------------------------------------------------------------------------------------XXX------------------------------------------------------------------------------------------------------------------------------------------------------------------------------------XXXX--------------------------------------------------SSSoo--XXXXXXX---------------------------------------------------------XXXX----------------------------------------------------------------------------------------------------------------------------------------------------------------------------------------------------------------------------XXXX--------------------------------------------------------------------------------------------------------------------------------------------------------oo------------------------------------------------------------------------------------------------------------------------------------------------------------------------------------------------------------------------------------------------------------------------------------------------------------------------------------------------------------------------------------------------------------------------------------------------------------------------------------------------------------------------------------------------------------------------------------------------------------------------------------------------------------------------------------------------------------------------------------------------
--------------------------------------------------------------------------------------------??-----------------o------------------------------------------------------------------------------------------------------------------------------------------------------------------ooo-----------------------------------------------------------o-----------X--XX---XXX----------------------------------------------------------oo---------------------------------------------------------------------------------------------------------------------------------------------------------------------------------------------------------------------------------------------------------------------------------------------------------E------------------------------------ooo------------------------------------------------------oo---------------------------------------------------------------------------------------------------------------------------------------------------------------------------------------------------------------------------------------------------------------------------------------------------------------------------------------------------------------------------------------------------------------------------------------------------------------------------------------------------------------------------------------------oooo---------------------------------------------------------------------------------------------------------------------------------------------------------------------------
-----------------------------------------------------oo-----SSSS--------------------S------SS??-------------XXXX---?---------------?SSS----------------------------------------------------------------------Q------SSS----------------------------------------------------XXX---XXXX------------------------------S-------------------------SS-XX--------------------------SSSSS--??---------SSS?----------SSSSS?--E----------------XXXX---XXXX-----Xoo---?Q-Q-----------------------------S?SSS---------------?-------------o------XXSoo--XXX-------S--------------------S---------------------------------------------------------------S----SQSS------------------Q----------------------------?---------------SSSSS-------------------SQS-----SSSSSE-------E---X--Soo----XX-----------------------------------------XXX------E-----------------------------------SS---------?SSSS--------------------------------------SSSS----------------------------------------------o---XXX---------------------XX-------------------------SSSSS----------------------------------------------------------------------------------------------------------------------------S-SXX-----------------SSSSS-------SSS-------------Q----------------SSSSSS---------------------S-------------------E------Sooo----oX-----------------------------------SSS------------------------------------------XXXXX----------------------------------------------------------S?SSS----------------?--SSSSE-----------------------QQQ-SSSSS------------E--------------SQ-----------------SSS--
-----------------------------------------------XXX----------------------------------------------XXX-------------------------------------------------------------S-----------------------------------------------------------------------------------------------------------------------------------------ooo-----------------------------------------EXX----------E------oo---------------------------------------XXXXXX------------------------------------XXX---------------------------------------------------XXX--o----------------------------------------------E-----------------------------XXX-------------------------------------------------------------------------------------------------------------------------------------------------------<>--------------------------------o----------------XXXX-----------<>-----------------------------------------------------------------------------------------------------------E------------------X----------------------------------------XX----------------------------------------------------------------------------------------------------------------------------------------------------------------------------------------------------------XX-----------------------------------------------oo--------------<>-XX---------------------------------------------------------------XX--------------------------------------------------------------X----------------------------------------------------------------------------------------------------<>--------------------------XSSS--------
----------------------------------XXXXXXXX---------------------------------------------------------------------------------------------------------------------X------------------------------XX-------------------------------------------------------------------------------------------------------------------------------------------XS-------XXXXX--------------------------------------------------------------------------------------------------------------------------------------------E----------------------------------------------------------------<>-------------------o----------------------------------------------------------------------------E--------------------------------------------------------------------------------------[]-------------------------------XXX----------------E-------------[]-------------------------------------------------------------------------------------------------------XXXXXXXX--------------------------------------------------------XX------------------------------------------------------------------------------------------E---------------------------------------------------------------------------------------------------------------o------------------------------------E---------------------------[]----------------------------------------------------------------XS----------------------------------XSS--------------------------XX---------------------------------------------------E------------------------------------------------[]-------------------------XX-----------
------------------------------------------------------XX------------------------------------------------------------oo-------XX-----------------E-------------XSS-SQ--------------------------XX------------------------------------------------------------------------------------------------------------------------------------------XX--o---------------XXX----------------------------------------------------------X-----------------------------------------------oo---------------S-------<>-------------SSSSS---------------XXXXX----XXX----------E--------[]-------------------------------------------------------------------------------------------S---------------E-------------------------------------------------E-------------------------[]-------XX--------------------------------oo---------------------[]--------------------E------------o-------------------------------------------E-----------------------------------------------------------------------------------------XX-------------------E------------------------------------------o-----------------------ESS<>--------------------------------E------------------E-----------------------------------------------------------------------------------------S-----<>-----------------ooS-------[]--------X---------------------------SS----E--------------------EX-----------------------XXXX-------XXX--------------------------XXX--------------------------------------------------------E-------E--o--------------------------------[]-----------------------XXXXS--SQ------
-------------------------<>-XX----------oo----------------------E---------------E?Q----XXXX----------------------o-o--o----XXXXXX-----------E----------------XXX-------------------------S----EX--------Q----Q-QQ---------------------------E-----------X-----------XX---------XXX---XXX-------------------------------------------------XXX-----XX-----------------------------S-----------XXXX--SS--------SXSQS-----------------------XXXX-----XXXX---XX--SSS-QQ---------------------Q-------E----[]------XX-----------------XXXXX------------------------<>---E-ESS[]-----------SS------------------------------oo----S--------------------XX--SSSS----------------Q?S---------<>---E--------Qo-Q-------XXX-XX----------X--------<>-------QQ--Q-Q-----------XXX-XX-------X--XXXXX--------------------------------------SSS----XX-------------------<>---S--------------QQQQ---QQQ---------------------------<>--------------------------------------------------XXXXXX------------XXX------------------XX------------------<>----Q---------------------------------------------------E--S-----<>--[]-------------------------------<>-----------S-----<>---Q-------SSS---S-----------------------------XXXX----------SSS-------------SQ-------------E--[]-----E--?--------------XXX-XXX----------XXXXXXXX----------------------SS--------S?SSS-------XXX-X---------E-EE-E---------------XXXX-------------------------XXXX----------------------Q-QQQQ--------QQ--Q--S-Q---S?S----E------<>------------SSSSSS---?SSSSSSSS-----[]--------Q-----So------XXXXXX----------
-------------------------[]--------------E---------------------<>---------------------------------------------------------XXXXXXX---------------------------XXXX---------------------------X-<>X------------------------------XX-----------<>----------XXX------------------------------------E--------------------------XXX-?----------XXXX-------------------------------------------------------------------------------------------------------------------------E------------------------<>----[]---E--------------------------------------------------[]--<><>--[]----------SSSS-------------------------------------E---X--------------------------------------------------[]--<>------------------XXXX-XX----------X--------[]-----------------------------------------------------------------------------------E----E--XX-SSS---------------[]------E---------------------------E---E----------------[]---------------------------------------------------------------------------------------X-XX------------------[]---------------X-----XXXX?-----E-----------------------<>--------[]--[]-------------------------------[]-----------------[]--E-----------------------X----------------------------------------------------------------<>--[]----<>---------------------------------------------------------------EE-------------------E--X--XX------XXXXXXXXXXXXX---------XXXXX-E---E-------XXXX?------XXXXX-------------------------------------------------------<>------[]----------------------SSSSSS-------[]---------------------XXXXXXX----o-----
-------------------------[]------XXXXXXXXXXXX------------------[]--------------------------------------------------------XXXXXXXX----------XX--------------XXXXX--------------------------XX-[]X---------------------------XX-XX-----------[]---------XXXX--XXXX-----------------------------------------------------------------------XXXXX--------XXXXX---------------------------------------------------------------------------------------------------------------X---------------------[]----[]--------------------------------o---------------------[]--[][]--[]----------SSSSS----------------------------------------X--------------------------------------------------[]--[]-----------------XXXXX-XXX-------X-X--------[]--------------------------------o------------------------------------------------------E---XX-------------------[]---<><>--------------------------<>--<>-XXX------------[]---------------------------------------------------------------------------------------X-XX------------------[]---------------X--------------<>-----------------------[]--------[]--[]-------------------X---X---X---[]-----------------[]-<>-----------------------XXX-------------------------------X-----------X------------------[]--[]----[]-----------------------------------------o-----------------------------------------XXX-X--XXX--------------------------XXXXXX-E--<>-----------------XXXXXX-------------------------------------------------------[]------[]----------------------SSSSSS--SS---[]--------------------XXXXXXXX----------
--------E-E-----EE-------[]---------------------------------E--[]-------------------------------------------------------XXXXXXXXXS--------XXX-------------XXXXXX--SSSS---------EE--------EX--[]X----------E-EE-----EE------XX-XX-----E-E---[]---E-E--XXXXX-----------------------------------EE--------EE-----------------------------XXXXXX------------------------------------------------------------------------------------------o---------------------------------X-----------EE--------[]----[]------------------XXXXXX-------XXX-------------EE-E---[]--[][]--[]--------o---------o---------------EE-------------------X---------S---------------------------E------------[]--[]----------------XXXXXXXXXX-------XXX-EE-E---[]------------------------ooo----XXX---------------------------------------------------------XX------------EE-E---[]---[][]---E-E-------E--E---------[]--[]--XX----E-------[]-EE----------------------E----------------------oo-----------------------------------E---XX-----------EE-E---[]-------E-EE---XX--------------[]-----------------EEEE--[]-E------[]--[]-----EE-E-----E----X-E-X----E--[]----E-----EE-----[]-[]------EE-E-------E-EE--XXX-------------X----------------XX------------------------E-----[]--[]----[]------------------------------------------E-E--E-E---------------------------------E---X-?XXXX------------------------XXXXXXX----[]--E-------------XXXXXXX--------------------------------------------------E----[]------[]--------------------ooSSSSSSSE-S---[]-------EE----------XXXXXXXXSSSSSS-----
XXX-XXXXXXXXXXXXXXXXXXXXXXXX----------------------------XXXXXXXXXXXXXXXXXXXXXXXXXXXXXXX--XXXXXX------XXXXXXXXXXXXXXXXXXXXXXXXXXXXSXXXXXXXXXXXXXXXXXXXXXXXXXXXXXXXXX--XXXX-XXXXXXXXXXXXXXXXXX-XXXXXXXXXXXXXXXXXXXXXXXXXXXXXXXX-XXXXXXXXXXXXXXXXXXXXXXXXXXXXXX----------------------------XXXXXXXXXXXXXXXXXXXXXXX--XXXXXXX-----XXXX--XXXXXXXX-XXXX--------------------------X----XX--XXXXXXXX--------XX---XXXXXXXXXXXXXXXXX------------X-----------------------XXXXXXXXXXXXXXX--XXXXXXXXXXXX-XXXXXXXXXXXXXXXXXXX-XXXXXXXXX----------------------------XXXXXXXXXXXXXXXX--XXXXXXXXXXXX-XX--XXXXXXXX---X---XXXXXX---XXXXXXXXXXXXXXXXXXXXXXXXX-XXXX---XXXXX-----------XXXXXXXXXXXXXXXXXXXXXXXXXXXXXXXXXXXXXXXXXXXXXXXXXXXXXXXXXXXXXXXXXXXXXXXXXXXXXXXXXXXXXXXX------XXX----------------------------XXXXXX-XX-------XXXXXX-XXXXX-XX-XXXXXXXX---XXXXXXXXXXXXXXXXXXXXXXXXXXXXXXXXXXXXXXXXXXXXXXXXXXXXXXXXXXXXXXXXXXXXXXXXXXXXXXXXXXXXXXXX----XXXXXXXXXX--XXXXXXXX-XXX----XXX--------XXXXX-XXXXX--XXXXXXXXXXX--XXXXXXXXXXXXXXXXXXXXXXXXXXXXXXXXXXXXXXXXXXXXXXX-----XXXXXXXXXXXXXXXX---XXXXXXXXXXXXXXXXXXXXXXX--XXXXXXXXXXXXXXXXXXXXXXXXXXXXXXXXXXXXXXXXXXXXXXXXXXXXXXXXXXXXXXXXXXXXXXXXXXXXXXXXXXXXXXXXXXX--XXXXXX---------XXXXXXXXXXXXXXXXXXXXXXXXXXXXXXXXXXXX-[]Q-XXXXXXXXXXXXXXXXXX----XXXXXXXXX-------------------XXXXXXXXXXX----XXXXXXXXXXXXXXXXXXXXXXXXXXXXXXX--XXXXXXXX---------------XXXXXXXXXXX--XXXXXXXXXXX-----XXXXXXXXXXXXXX-XXXXXXXXXXXXXXXXXXXXXXXXXXXXXXXXXXXXXXXXXXXXXXXXXXXXXXXXXXXXXXXXXXXXX-----XXXXXXXXXXXXXXXXXXXXXXXXXXXXXXXXXXXXXXXXXXXXXXXXXXXXSX---X-XXXX