------------------------------------------------------------------------------------------------------------------------------------------------------------------------------------------------------------------------------------------------------------------------------------------------------------------------------------------------------------------------------------------------------------------------------------------------------------------------------------------------------------------------------------------------------------------------------------------------------------------------------------------------------------------------------------------------------------------------------------------------------------------------------------------------------------------------------------------------------------------------------------------------------------------------------------------------------------------------------------------------------------------------------------------------------------------------------------------------------------------------------------------------------------------------------------------------------------------------------------------------------------------------------------------------------------------------------------------------------------------------------------------------------------------------------------------------------------------------------------------------------------------------------------------------------------------------
------------------------------------------------------------------------------------------------------------------------------------------------------------------------------------------------------------------------------------------------------------------------------------------------------------------------------------------------------------------------------------------------------------------------------------------------------------------------------------------------------------------------------------------------------------------------------------------------------------------------------------------------------------------------------------------------------------------------------------------------------------------------------------------------------------------------------------------------------------------------------------------------------------------------------------------------------------------------------------------------------------------------------------------------------------------------------------------------------------------------------------------------------------------------------------------------------------------------------------------------------------------------------------------------------------------------------------------------------------------------------------------------------------------------------------------------------------------------------------------------------------------------------------------------------------------------
-------------------------------------------------------------------------------------------------S-SSSSSSSSSSSSS--------------------------------------------------------SSSSSSSSS----------SSS---S----------------------------------------------------------------------------------------------------------------------------------------------------------------ooo--------------------------------------------------------------------------------------------------------------------------------------------------------------------------------------------------------------------------------------------------------oo--------------------------------------------------------------------SSS-----------SSSSSSSSSSS--------------------------------------------------------------SS------------------------oo--------------------------------------------------------------E---------------SSSSSSSSSSSSSSSSSSSSSSSSSSSS----------------------------------------------------------------------------------------------------------------------------------------------------------------------------------------------------------------------------------------------------------------------------------oo----------------------------------------------------------------------------------------------------------------------------------------------------oo------------------------------------------------------------------------------------------------------------------------------------------------------------o---------------------------------
----------------------------------------------------------------------------------------------------------------------------------------------------------------------------SS------------------------------------------------------------------------------------------------------------------------------------------------------------------------------------XXXX------------------------------------------------------------------------------------------------------------------------------------------------------------------------------------------------------------------------------------o------------------XXX------------o--------------------------------------------------------------------SSSSSSSSSSS--------------------------------------------------------------------------------------------E--E----------------------------------------------SS--------------------------SSSSS--SS-SSSSSSSSSS-SSSSS----------------------------------------------------------------------------------------------------------------------Q---------------------------------------------------------------------------------------------------------------------------------------------------------------E-------------------------------S---------------------------------------------------------------------------------------------------------------------EE--E---------------------------------------------------------------------------------------------------------------------------------------------------------------------------------------
--------------------------------------------------------------------------------------------------------------------X---------------------------------------------------X---SS--E-------------------------------------------------------------------------------------------------------------------------------------------------------------------------------------------------------------------------------------------------------------------------------------------------------------------------------ooo-------------------------------------------------------------------------------------------------oo-------------------------------------X-----------------------------------------------------SSSSSSSSSSS------------------E--------------------------------------------?---------------------------XXXXXXX--------------------------------------------SS--------------------------SSSSS--SS-SSSSSSSSSS-SSSSS------------------------------------------------------------------------------------E------------------------E-----------------------------------------oooooo------------------------XXX------------------------------------------------oo--oo---------------------------------------XXX----------------------------E------------o------------------ooo-------------ooo--------------------------------------------------------------------XXXXXXX--------------------------------------------------------------------------------------------------------------------------------------------------------------------------------------
--------S---------------------------E-----------------------------------------------Q-------------------------S-------o--------S-----------X----------------SSSSSS---------SS---SS-----QQQ---?------------------------------SSSS-----QS-------------------------------------------------SSSSS------SSSS-SSSSSSSSSSS-----------------------------SSSS--SSS-----oo----ooo--------?-----------------------------------------------------------------------------------------------------------S------------XX-----XXXX-----------------------XX---------------------------------------oo----------------XXX-------S---XXXX-------E-----------SSS-------------XXS-------------------------------------------------SSSSSSSSSSSSSS-S??-------------S?SSSSS-------------------SSSSS--------SSSSS-S??-----oo----oo--------------------------------------------------------------------SS-------------------S---XX--------S--SSSSSSSSSSSSSSSSS----------------Q--------------------------------------------------------------SS--SQS---X-----XXX-----SSS-------------XXoS----XXX------------------------------o----------------------------------S----------------------------------------------------Xooo----XX---------------------------------------------SS--SQS-----------------SS------XXXX-----------XXXXXX-------------------------SS-----------------------------------------------------------S---------------------------S--------------------------------------------SS----SSS--S---------------------------------oo---X-------o------------------------------------S
------X------oo-----S--------------<>------------------Q--------------------------XX----------------------------XXX--------------------------------------------------------S----SS----------------------------------------------------------------------------------------------------------------------------------------------------------------------------------------XX-----------------------------------------------------------------oooo-------------------------------------------XXX--------------------------------------------X---------------------------------------------------------XXX---------------------<>--------------------------XXXX---------------ooo------------------------------------------------------------------SS------------------------------------------------------------------------------ooooo----------------------------------------SS-----------------------------------------------------------------------------------oooo---------------------------------------------SS--S-----------XXX---------E--------------------------------X----------XXXXX----------E---------------ooo----------------------XSSS-----------------------------oooo-------------------XX----------------------------SSS-----------------------XSSS-----------------------------------------------------------------------------------------------------------------------------------------------------------------------------------------------------------------------------------E------------------------------------------------------------
-XX-oo------------XXX--------------[]---------------E-------------------------------------------------------XX------------------------------------------------Q----------SSS----SS-----------------------------------------o----------------------------------------------------------------------------------------------------------------------------------------------o----------------------------X-------------------------X------------------------------------------------------------------------------------------------------X-----------------------E-----------------------------------XXX----------------------[]-------------------------XXXX-------------------------------------------------------------------------------------SS---------------------------------------------------------------------------------------------------------------------------SS-----------------------S-----------------------------------------------------------------------------------o-------------------------S---------------XX-----------------------------------------------------------------XXXXXXXXX----------------------------------XXX-----------------------------E-----------------------oo----------------------------XSSX-----------------------XX---------------------------------------------------------------------------------------------------------------------S---o----------------------------------------------------------------------------------------------------------<>------------------------------------------------------------
-XX---------------XXX---------E----[]--------------<>--o-------------------------------------S-------------XXS-S-----------------------------------------------------------So??-SS--------------------------------E--------------------------------------------------------E---------------------------------E-----------E--------------------------------------------------X---oo--------------------XX-------E----------------XX-S--------------------o-------X-------------------------------------------------------o--------------------------------------<>-------E--------------------------XXXX----------------------[]--------------------EXEEXXXXX-----------------------E--------------E--------------------------------------------?-SS-----------------------------------?---------E---------------S--------------E-------------------------------------------oooSS-----------------------------------ooooooS--oooQ--?-------E--E-------------------E-------------------------------o-------------XSS--SS---o----------XX-------S---------------------XX---------------------------------XX------------------------------------------XXXS--S-------------------------<>------------------------------------SSSSSS----------XXS---------E-------------XXXX--SQ--------oo-oo------------------------------------------------------------------------------SS----------------E--XS--------------------------E----------------------------E-------------E-----E----------------------------------[]-----------------------XXX---------------------------------X
-XX---------------XX---------<>----[]-----------E--[]----------------XXXXXXXXXXX----SS-----E--------------XXX--X---------X---------------------E-------Q----S?S------------SSS--SSS----SS-QQQQ----------------E--<>------SS---------S?S------------------------------E----<>-----<>---S---SSS------XX--X---SSSS-----E---<>---------------E----S------------XXXXXXXXXXX-XX------o--o-------------------XXS--E--<>--------S?S----XXX-X----------------E-----------X----------------SS-------SS---------------XXXXXX--------o--------XXX-XX---X-------------------[]------<>-----E------XXX---S------XXXXX---------Q------SSS---[]--------------------XX--XXXXX------------<>--------<>-------------<>--------E--?--------SSSSS-oo--------X--X------SS---------------<>----QQQ--QQQQ-----??SSSSSS?SSS--XXXX--SSS--o------SXXXX---<>-------------<>-QQQ-------------E----------SSSSS--S-------<>-------------S---------SSSSSSS--SSS?--?SSSSSSSSSSSS---Q--QQ-Q--Q----<>--------------------XXSS--------------------XXX--EXS--S?S----------X-------------------XXXX---------XXX---XX------XX------------------------ooo----E-----E----<>---------------XXXXX----------------XXXXXX---E--[]--------XX--XXXXXXXXXXX----------------------------XXXX---------XS--S?S------XXXXX--------------o---------XXXXX-XXX---------SS-----XX--X-----------X------------------E------E-----------------E--<>--XX--S-------------E<>-----E<>----o----------SQ--S-------<>---E---E----<>----<>---------------QQ--Q-Q--------S---[]-----------XXXXX-------------------------------S----------XX
-XX---------------XX---------[]----<>-----E----<>--[]-----------------------------------XX<>-------------XXXX-----------------------------E---<>------------------------------------E------------------------<>--[]------------o------------------------------------<>----[]--E--[]---------------XXX--XX--E------XXX---[]--------E---E-<>-----------------------------------------------------------XXX--<>--[]--------------XXXX-----------------<>-----------X----------------------------------------------------------------XXXXXXX---X-------------------[]------[]----<>---XX-------------XXXXXXX------X--------------XX--XX---------------XXX--XXXXX------------[]--------[]--E----------[]-------<>--------E-EE--------------XX--XX--------E--X----------[]--------------------SSSSS---SSS---------------------------[]-------------[]----------------<>-------------------------[]-----E----E----------------------------SSSSSSSSSSSS-----------------[]------------E------------------------------XXXX-XX-----------------X------------------------------------------------E-----------------------------<>----<>----[]--------------XXXXXX--------EX--------------<>--[]--------------------------------------------------XXXXX-XX------------------XXXXXX--------E-E-----------------X-------------------XXX--XXX--------XX-----------E-----<>-----<>----------------<>--[]--XX---S-----------<>[]----<>[]---------------------------[]------<>----[]----[]----------------------------------[]---------------------------------------------------------XXX
-XXX--------------XX---------[]----[]----<>----[]--[]-----XXXXXX-----------------------XXX[]------------XXXXX-------<>-------------------<>---[]-------------------------------------------------------------[]--[]-----------XX--------------------------------<>--[]----[]-<>--[]--------------XXXX--XX------E--XXX---[]-------<>--<>-[]-------------------------------------------X---X-XX-------XXXX--[]--[]-------------XXXXX-----------------[]-----------X----------------------------------------------------XXX--------XXXXXXXX---XX------X-----------[]------[]----[]---XX------------XXXX-XXX------X--------------XX----XX------------XXXX--XXXXXX-----------[]--------[]-<>----------[]-------[]-------<>----------------XXX--XXX----------X----------[]--------------------SSSSS----SS---------------------------[]-------------<>----------------[]-------------------------[]----<>---------------------------------SSSSSSS-SSSS-----------------[]-----------<>-----------------------------XXXXX----------------E---X------------------------------------------XXX---------------------------------[]----[]----[]-------------XXXXXXX--------XX--------------[]--[]-------------------------------------------------XXXXXX-XXX-----------------XXXXXX--------XXX-----------X-----X-------oo---------XXXX--XXX-------XXX----------<>-----[]-----[]----------------[]--[]------S------------[][]----[][]---------------------------[]------[]----[]----[]----------------------------------[]-----------------------------------------------------<>-XXXX
-XX-----------E---XX----E----[]----[]--E-[]--E-[]--[]--X------------------------------XXXX[]--------E--XXXXXX-------[]ooo----------------[]---[]----EE-----EE---------------------------------E--------E-----[]--[]-------E---XXE--------E-E-E------------------[]--[]----[]-[]--[]-------------XXXXX--XX--------XXXX---[]-------[]--[]-[]--------------oo--------------------------XXX-XXXXXX----XXXXXX--[]--[]--------E---XXXXXX------------E-E--[]-----------X-----E--E-EEE-E-----------------------------------------------XXXXXX-XX---XX-----XX-----E-EE--[]------[]----[]---XX-----------XXXXX-XXX------X--------------XXE---XX-----------XXXXX--XXXXX----E--X----[]--------[]-[]----------[]---EE--[]-------[]-------E-------XXXX--XXXX---------X----------[]----------E-E----oooS----ooo------------------------------[]-------------[]----E-----------[]----------------------E--[]----[]---------------------E--E------ooSSSSSSSSSS------------E------[]---------E-[]---------------------------XXXXXXX---E-E--------------X------E----------------XXX--------------XX------------------------------------[]----[]-E--[]------------XXXXXXXX-------XXX------------E-[]--[]------------------------------------------------XXXXXXX-XX-XE---E----------XXXXXXX-------XXXX--------XXXXXX----------XXX-E------XXXXX--XXX-------XXX----E-E---[]---E-[]-----[]-X--------EE----[]-E[]-------S-----E-EE--[][]----[][]-----S---------------E-E---[]-----E[]---E[]----[]--------------E--EE--------EE-E---[]----SXXXXXX------------------------EE----E-E--EE-----[]XXXXX
-XX-XXXXXXXXXXXXXXX-XXXXXXXXXXXXXXXXXXXXXXXXXXXXXXXXX--X------------------------XXXXXXXXXXXXXXXXXXXXXXXXXXXXX--X--XXXXXXX--------------XXXXXXXXXXXXXXXXXXXXXXXXXXXXXXXXXXXXXXXXXXXXXXXXXXXXXXXXXXXXXXXXXXXXXXXX--XXX-XXXXXXXXXXXXXXXXXXXXXXXXXX--XXXXXXXXXXXXXXXXXXXXXXXXXXXXXXXXXXXXXXXXXXXXXXXXXXXo--XXXXXXXXXXXXXXX-XXXXXXXXXXXXX-XXXXXXXXXXX-------XXX----------------X-XXXXXXXXXXXXXXXXX-XXXXXXXXXXXXXXXXXXXXXXXXXXXXXXXXXXX-----XXXXXXXXXXXXXXXXXXXXXXXX--X-XXXXXXXXXXXXXXXXXXXXXXXXXXXXXXXXXX--------------------XXXXXXXXXXXXX-S--XXXXXXXXXXXXXXXXXXXXXXXXXXXXXXXXXXXXXXX-XX---XX-XXXXXXXXXXX-XXXXXXX-XXXXXXXXXXXXXXXXXXXXXXXXXXXXXXXXXXXXXXXX--XXXXXXXXXXXXXXXXXXXXXXXXXXXXXXXXXXXXXXXXXXXXXXXXXXXXXXXXXXXXXXXXXXXXXXXXXXXXXXXXXXXXXXXXXXXXXXXXXXXXXXXXXXXXXXXXXXXXXXXXXXXXX--XXXXXXXXXX-X---------XXXXX-XXXXXXXXXXXXXXXXXXXXXXXXX-XXXXXXXXXXXXX-XXX-XXXXXXXXXX-XXXXXXXXXXXXXXXXXXXXXXXXXXXXXXXXXXXXXX---XXXXXXXXXXXXXXXXXXXXXXXXXXXXXXXXXXXXXXXXXXXXXXXXXXXXXXXXXXXXXXXXXXXXXX-XXXXXXXX---XXXXXXXXXXXXX----XXXXXXXXXXX-XXX--XXXXXXXXXXX------XXX--------------------------------------------------XXXXXXXXXXXXXXXXXXXXXXXXXXXXXXXXXXXXXXXXXXXXXXXXXXXXXXXXXXXXXXXXXXXXXXXXX----XXXX----------------------------XX----XXXXXXXXXXXXXXXXXXXXXXXXXXXXXXXXXXXXXXX-----XXXXXXXXXXXXXXX-XS----------------XXXXXXXXXXXXXXXXXXXXXXXXXXXXXXXXXXXXXXXXXXXXXXXXXXXXXXXXX-X-XX-X-XXXXXXXXXXXX------XXXXXXXXXXXXXXXXXXXXXXXXXXXXXX--XXXXXXXXXXXXXXXXXXXXXXXXXXXXXXXXXXXXXXXXXXXXXXXXXXXXXXXXXXXXXXXXXXXXXXXXXXXXXXXXX----------------------------XXXXXXXXXXXXXXXXXXXXXXXXXXXX