------------------------------------------------------------------------------------------------------------------------------------------------------------------------------------------------------------------------------------------------------------------------------------------------------------------------------------------------------------------------------------------------------------------------------------------------------------------------------------------------------------------------------------------------------------------------------------------------------------------------------------------------------------------------------------------------------------------------------------------------------------------------------------------------------------------------------------------------------------------------------------------------------------------------------------------------------------------------------------------------------------------------------------------------------------------------------------------------------------------------------------------------------------------------------------------------------------------------------------------------------------------------------------------------------------------------------------------------------------------------------------------------------------------------------------------------------------------------------------------------------------------------------------------------------------------------
------------------------------------------------------------------------------------------------------------------------------------------------------------------------------------------------------------------------------------------------------------------------------------------------------------------------------------------------------------------------------------------------------------------------------------------------------------------------------------------------------------------------------------------------------------------------------------------------------------------------------------------------------------------------------------------------------------------------------------------------------------------------------------------------------------------------------------------------------------------------------------------------------------------------------------------------------------------------------------------------------------------------------------------------------------------------------------------------------------------------------------------------------------------------------------------------------------------------------------------------------------------------------------------------------------------------------------------------------------------------------------------------------------------------------------------------------------------------------------------------------------------------------------------------------------------------
---------------------------------------------------------E-----------------------------------------------------------------------------------SSSSSSSSSSSSSSSSSSSSSSSSSSSSSSSSSSSSSSSSS------------------------------------------------------------------------------------------------------------------------------------------------------------------------------------------oo---------------------------------------------------------------------------------------------------------------oo-------------------------------------------------------------------------------------------------------------------------------------------------------------------------------------------------------------------------------------------------------------------------------------------------------------SSSSSSSSSSSSSSSSSSSSSSSSSSSS---------------------------------------------------------------------------------------------------------------------------------------------------------------------------------------------------------------------------------------------------------------------------------------------------oo------------------------------------------------------------oo---------------------------------------------------------------------------------------------------------------------------------------------------------------------------------------------------------------------------------------------------------------------------------------------------------------------------------------------------------
------------------------------------------------------------E--E------------------------------------------------------------------------------SSSS-----SSSSSSS----------SSSSSSSSSSSSSSSSS---------------------------------------------------------------------------------------------------------------------------------------------------------------------------------------XX--------------------------------------------------------------------------------------------------------------XXXX------------------------------------------------------------------------------------ooo------------------------------------------------------------------------------------------------------------------------------------------------------------------------------------------------------------------------------------SSSSSSSSSSSSS-------------------------------------------------------------------------------------------------------------------------------------------------------------------------------------------------------------------------------------------------------------------------------------------------------E--E-------------------------------------------------------------------------------------------------------------------------------o---------------------------------------------------------------------------------------------------------------------------------------------------------------------------------------------------------------------------------------------------------------------------------
-------E-oo------------------------------------------------XXXXX----------------------------------------------------------------------------X-SSSS--EE-SSSSSSS----------SSSSSSSSSSSSSSSSS---------------------------------------------------------------------------------------------------------------------------------------------------------------------------------------------------------------------------------------------------------------------------------------------------------------------------------------oo--oo---oo--o------------------------------------------------------------oo----------------------------------------------------------------------------------------------------------------------------------------------------------------------------E--------------------------------------SSSSSSSSSSSSS------------------------------------------------------------------------------------------------------------------------------------------------E----------------------------------E--------------------------------------------------------------o--oo-o-------------------------------ooooo---------XXXXXXX------------------------------------------ooo-----------------o---------------------------------------------------------------Eooo---------------oo------------oo------------------------------------------------------------------------------------------------------------------------Eooo-o------------------------------------------------------------------------------------------------o---o-----------
-------XXXXX------X----------------E------------------------------------------------------------X----------------------------------------------S----SSS----------S----SSSSSSSSSSSSSS-SSSS----QQ---------------------------------SS--------------X--------------------------------------------------------------------------------------------------------------XXX---SSSS-------------------SSS----------------------------------------SSQS-----SSSSS----?SSSS----------------------------SQ----------------------------o-------------X-------------QSSSS------------SSSSSSSSSSS----------XXXX------------------------------SSSSSS----SSS----SSSSSS--E----------------------ESSS--------------------------------------------SSS---------------------------------------------------------E----QQQQS-----------------o----------------SSSSSSSS----------------------------------------------------------------------SSSSSSSS---------S---Q---------o--------SSSSSSQ-------SSS------?--------SSQS-------SQQS---------------------SQS--SSSS--------------SSSS---------------------------------XX----------------------------------------XXXXX-----------------------SS--------------------------SS-----XXXX------XX------XXX---------------------------------------------SSSSS--SSSSo------XXXXX-------o--------o-------------------------------------------------------------------------Q-----------------SSS---------------------------------------XXXXX-------------------------Q---SS-------SSS-----E------------------------------------------------------------------
--XXX-----------XXS---------------<>---------------------------------------------------------------------XXX-----------E--o---o----XXX---------S----SSS----------S----SS------------------------------------------------------------------------XX------------------------------------------------------------------------------------------------------------XXXX----------------------------------------------------------------------------------------------------------------------------------------------------------------------SoS---------------------------------------XXXXX-------------------------------------------------------------<>---------------------<>---------------------------------------------------------------------------------------------------------------------------------------------------------------------------------------------------------------------EX-----------------------------------------------------XXX---------------------------------------------------------------------------------------------------------------------------------------------------------------------XXX-------------------------------------------------------------------------XX-------------------------------------------------------------------XXX---------------------------------------XSSSS-------------------------------------------------------------------------------------------------------------------------------------------------------------------<>---------------------------------------o--------------------------
---------------XXXX---------------[]---------------------------------------------------------------------------------XXXXXXX-XXX-------------SSS----SSS----------S----S-----------------------------------------------------------o-----------X-XX---------------------------------------------------------------------------------------X-------------------EXXXX-----------------------------E-------------------------------------S-S--------------------------E---------E-----------E-------------------------------------------------------XXXX--------------------------------------------------------------------------------------X---------[]---------------------[]-----E-------------------------------------------------------------------------------------------------XX---------------------------SSS--------------------------oo-------------------------------------------------<>X-----------------------------------S-S----S---------XXXX-----------------------------------------------------------------E------------------------------------------E------------------------------------------------------o-----------------------------------------------------------------------------XX------------------------------------------------------------------------------------------------------------XXX----------------------------------------------------------------------------------------------------------------------------------------------------o-----------------[]---------------------------------------------------------E--------
--------------XXXXX------------E--XXX--------------------------E-------oo----------------------------------------------------------------------So??-SSS----?-----So-?-So----------E-EE--------------ooo--ooo--------------------------SS------XXXX-----------------------------------------------------E---------------------------------X------------------XXXXXX-------------------E--S-----<>----------------------------------------E------------------------<>-E------<>-------E-----------------------------------XX--oo--------------------------------------------------QQ--SS--------------------------E-------E-------------E--XX--------------------------------[]----<>--o------E------------------E--------------------------------------------------------------------S--------------------------------------------oooo----oS--------------------------oo-----------------------E--[]X-----------------------------------SoS--SoS--------XX-XX--------------------------------------------------------S-------<>--------------------E-----------------E--<>---?----------------------------------------------------------------XXX-------XXXXX----------------------------E-------------------XXX------------------------S----------------------------------------------------------S---------X---oo---------XXSS-SQ--------------------------------------------------<>-------------------------------------------E------------------------oo----E-----------------------------------[]---------o---------------E----------XX------------------<>-----o--
-------------XXXXXX-----------<>------S----XXXX---------S--E--<>-----E----------------------------XXXXX---------X---------------------XX-------SSS--SSSSS--SSQQ--SSS--SSSSSSSSSSSSSSSSSS--Q--QQ-Q-QQ--------------------------XXoS--------E-XXXXXX---------X----------<>------E---E-----QQQ-----------<>---------E-------XXXXX---ooo-----X---------S-------XXX-XXX-------------E----<>-----ESS[]------------------------E---------Q-o--SSS-----EX--------SSSSSS--[]<>------[]------<>--------------------------------E-----o--o---XX----------------QQ---------------------------------------------------------<>------<>-------E----<>--XX-------SSSSS---------E----------XXS---[]-----E--<>---Q-------------<>------------------------------------------Q--Q--Q-----------<>------S---QQ-QQ?SSQQQ----------E-----SSS------------SSSSS-SSS-S------------------------------------------------<>--[]X-----oX--X---------SS-----XXX------SSS--SSS-------XXX-XX--SSS------------Q---Q?S-------SSS-Q-----S-S---------------E----[]-----QQQQ--Q-------<>-------------E--<>--[]----------XXX---------------------------------------S?S----XXX----------XXX---------------------SS------------<>---SS-------------XXXX------------<>----------XXX--------------------EXXX-XX----SSSSSS------------------X-------------o--o-------EXXX---------X-S--------oooo------------E-----------------[]--------------Q-Q----QS---------E---------<>----------------------------------------------SSS---------XS?S-----------------QQQ----------<>---------XXX---------------E--[]--------
------------XXXXXXX-----------[]--------------------------<>--[]----<>----------XX-------------------------------------------------------XXX-----------SS---------------SSSSSSSSSSSSSSSS-SS----------------------------------XXX----E----<>-XXXXXX--------XX----------[]-----<>--<>-------------------[]--E-----<>--------------o------X-X----------------XXXX-XXX------------<>----[]----<>--[]--------------E--------<>-------E-------------<XX----------------[][]------[]------[]---------------------------XX--<>------------------------------------------------------------------------------SS---------[]------[]------<>----[]-XX---------------------<>--------E-------[]----<>--[]-----------------[]------------------------------------------------------------[]------S-----------------------<>----E--------------------------------E-----------------X-----------------------[]--XXX----XXX--XX--------E-----XXXX--------------------XXXX-XX----------------------------------------------------------<>----[]-------------------[]-----------E<>--[]--[]-------XXXXX---------o---XXXXXX----------E-E<>----------------------------------------------------------------[]-------E---------XXXXX-SXS-----E--[]---------XXXX--------------E-----XXXX-XX-----E-------------------XXXXXSSS-------------------XXXXX--------XX-------XX---E---------XXXXXX----------------[]-------------------------------<>---------[]------E----------XX---E----------XXX--------------------------------------E-----------------[]--Q-----XXXX--------------<>--[]--------
-----------XXXXXXXX--------X--[]--------------------------[]--[]----[]-----------X----------------------------------XXXXXX-----------------------------SS---------------SSSSSSSSSSSSSSSSSSS---------------------------------XXXX---<>----[]-XXXXXX-------XXX----------[]-----[]--[]-------------------[]--------[]-------------XXXXXX--X-X---------------XXXXX-XXX------------[]----[]----[]--[]-------------<>--------[]------<>-------------[]----XX-----------[][]------[]------[]---------------------<>----X---[]---------------------XXX----o-----------------------------------------EE---X-------------[]------[]------[]----[]-XXX--------------------[]-------<>-------[]----[]--[]-----------------[]---------------------------------------X--------------------[]------S-----------------------[]-------------X-----------------------------------------------------------------[]--XXX---XXXX--XXX------------XXXXX-------------------XXXXX-XX---------------------------X------------------------------[]----[]-------------------[]----------<>[]--[]--[]--------------XXXX--XXX-----X-----------<><>[]-------------------XX------------------------<>-----------------[]------<>--------XXXXXX---------X--[]--------XXXXX-------------<>----XXXX--XXX----------------------XXXXXX----------------------XXXXXX-------XXX------XXXXXXXXX-----------------------------[]-------------------------------[]---------[]-----<>---------XXXX--E------<>-XXXX-------------------------------------<>-----------------[]----<>-XXXXX--------------[]--[]--------
----------XXXXXXXXX-------XX--[]--------------------------[]--[]----[]-----------X-------------------------E------------------------------------------E--------E-EE-----SSSSSSSSSSSSSSSS-----------E-----------------------XXXXX---[]----[]-XXXXXX------XXXX------E-E-[]-----[]--[]---E-------E---EE--[]-----E--[]----ooo--------------XXX--------------XXXXXX-XXXX------XXX--[]----[]----[]--[]-------------[]---EE---[]------[]----E------XX[]-E-XXXXE--E------[][]------[]------[]------X---EE-E-EE-E--[]--------[]-S-------------------SS?S---------------------------------------------------------E------[]------[]------[]-E--[]-XX---------E--------E--[]-------[]-E-E---[]----[]--[]--X---EE-E-------[]------------------------E-E------------X--------------------[]------S-------E-------E-------[]-------------X-E--------E-----------------------------------------E-----EE-E---[]--XXX--XXXX-E-XXXXE---------XXXXXX-----EEE---E--EE-EXXXXXX-XX-------------------E-EE---XX-------------E--------E-EE----[]----[]-----------EE------[]----------[][]--[]--[]----------------------------------------[][][]------------X--------------------------------[]----EE-E-----E---[]------[]------XXXXXXXX---------X--[]--------XXXXX-------------[]----XXXX--XXXX-------------XXXXXXX------XX-----E--------------XXXXXXX----SSXXXX-E---XXXX-----------------------------E-E---[]-----E-EE----------------------[]---------[]---E-[]---------XXXX---------[]-XXXX-----------------------------------E-[]--E-E----E----E--[]----[]-XXXXX--------------[]--[]--------
XXXXX-X-XXXXXXXXXXXXXXXXXXXXXXXXXXXXXX--------X----XXX--XXXXXXXXXXXXXXXXXXXXXXXXXXXXXX-X---------------XXXXXXXXX----------------------------XXXXXXXXXXXXXXXXXXXXXXXXXXXXXXXXXXXXXXXXXXXXXXXXXXXXXXXXXXXXXX---XXXXX----XXXXXXXXXXXXXXXXXXXXXXXXXXXXXXXXXXXXXXXXXXXXXXXXXXXXXXXXXXXXXXXXXXXXXXXXXXXXXXXXXXXXXXXXXXXXXX--XXX--------------XXX------XXXXXXXXXXXXX--XXXXXXXXXXXXXXXXXXXXXXXXXXXXXXXXXXXXXX--XX--XXXXXXXXXXXXXXXXXXXXXXXXXXXXXXXXXXXXXXXXXXXXXXXXXXXX--XXXXXXXXXXXXXXXXXXXX--XXXXXXXXXXXXXXXXXXXXXXXXXXXXXXXXXXXXXXXXXXXXXXXXX---SS--SSSS-XXXXXXXXXXXXXXXXXXXXXXXXXXXXXX----XXXXXXXXX--XXXX---XXXXXXXXXXXXXXXXXXXXXXXXXXXXXXXXXX--XXXXXXXXXXXXXXXXXXXXXXX-XXXXXXXXXXXXXXXXXXXXX--XXXXXXXXXXXXXXXXXXXXXXXXXXXXXX---XX-XXXXXXXXXXXXXXXXXXXXXXXXXXXXXXXXXXXX---XXXXXXXXXXXX--X-XXXXXXXXXXXXXXXXXXXXXXXXXXX-XXXXXXXXXXXXXXXXXXXXXXXXXXXXXXXXXXXX--XXXX-XXXXXXX----X-X-XX-XXXXXXXXXXXXX-XXX-XXXXXXXXXXXXXXXXXXXXXXXXXXXXXXXXXXXXXXXXXXXXXXXXXXXXXXXX-XXXXXXXXXXXXXXXXXXXXXXXXXXXXXXXXXXXXXXXXXXXXXXXXXXXXXXXXXXXXXXXXXXXXXXXXXXXXXXXXXXX-XXXXXXXXXXXXXXXXXXX--XXX-XXXXX----------------------------XXXXXXXXXXXXXXXXXXXXXXXXXXXX------------------------------XXXXXXXXXXXXXXXXXXXXXXXXXXXXXXXXXXXXXXXXXXXXXXXX--XXXXXX-XXXXXXXXXXXXXXXXXXXXXXXXXXXXXXXXXXXXXX--XXXXXXXXXXX--XX------X-XXXXX--XXXX---XXXXXXXX----XXXXXXXXX------XXXXXXXXXXXXX----------------E------XXXXXXXXXXXX-XXXXXXXXXXXXXXXXXXXXXXXXXXXXXXXXXXXXXXXXXXXXXXXXXXXXXXXXXXXXXXXXXX--XXXXXXXXXXXXX----------------------XX----XXXXXXXXXXXXXXXXXXXXXXXXXXXXXXXXXXXXXXXXXXXXXXXXXXXXXXXXXXXXXXXXXXS----