--------------------------------------------------------------------------------------?---------------------------------------------------------------------------------------------------------------------------------------------------------------------------------------------------------------------------------------------------------------------------------------------------------------------------------------------------------------------------------------------------------------------------------------------------------------------------------------------------------------------------------------------------------------------------------------------------------------------------------------------------------------------------------------------------------------------------------------------------------------------------------------------------------------------------------------------------------------------------------------------------------------------------------------------------------------------------------------------------------------------------------------------------------------------------------------------------------------------------------------------------------------------------------------------------------------------------------------------------------------------------------------------------------------------------------------------------------------------------------------------------------------------------------------------------------------------------------
---------------------------------------------------------------------------------------------------------------------------------------------------------------------------------------------------------------------------------------------------------------------------------------------------------------------------------------------------------------------------------------------------------------------------------------------------------------------------------------------------------------------------------------------------------------------------------------------------------------------------------------------------------------------------------------------------------------------------------------------------------------------------------------------------------------------------------------------------------------------------------------------------------------------------------------------------------------------------------------------------------------------------------------------------------------------------------------------------------?SS------------------------------------------------------------------------------------------------------------------------------------------------------------------------------------------------------------------------------------------------------------------------------------------------------------------------------------------------------------------------------------------------------------------------------------------------------------
------------------------------------------------------------------------------------SSSSS-----S--S---------SSSS---------------------------------------------------------SSSSSSSSSSSSESSSSS------SS------------------------------------------------oo--------------------------------------------------------------------------------------------------------------------------------------------------SS----o---------------------------------------------------------------------------------------------------------------------------------------------------------------------------------------------------------------------------------------------------------------------------------------------------------------SSSSSSSSSSSSSSSSSSSSSSSSSSSS-------------------------------------------------------------------------------------------------------------------------------------------------------------------------------------------------------------------------------------------------------------------------------------------------------------------------------------------------SSS--oQ--------------------------------------------------------------------------------------------------------------------------------------------------------------------------------------------------------------------------------------------SS--------------------------------------------------------------------------------------------------------------------------oo------------------------------------------------------------------------------
--------------------------------------------------------------------------------------SS----------------------------------------------------------------------------------SSS----Q-?oS--SSSSSS?-SooS------------------------------------------------------------------------------------------------------------------------E--E---------------------------------------------------------------------------XXXX---------------------------------------------------------------------------------------------------------------------------------------------------------------------------------------------------------------------------------------------------o------------------------------------------------------------SSSS-----SSSSSSSSSSSSSSSS------------------------------------------------------------------------------------------------------------------------------------------------------------------------------------------------------------------------------------------------------------------------XX-X--------------------------------------------------------------------SSoS-----E--E-----------------------------------------------------------------------------------------------------------------------------------------------------------------------------------------------------------------------------------------------------------------------------------------------------------------------------------------------------------------------EE--E---------------------------------------------------------------------o-
-------------------------------------------------------------------------------------SSS--E-------------------------------------------------------------------------------SS--------SS--SSSSSS--SSSS-----------------------------------Eooo-----------------------------------------------------------------------------------XXXX---------------------------------------------------------------S-------------------------------------------------------------------------------------------------------E------------------------------------------------------------------------------------------------------------------------------------------------------------------oo--oo---------------------------------------------SSSS-----SSSSSSSSSS-SSSSS----------------------------------------------------------------------------------------------------------------------------------------------------oo----------------------------------E--------------------------------------------------------oo----------o-----------------------------------------------------------------------------------SSS-----X------------------------------------------------------------------------------------------ooooooo---------------------------------------------------E--------------------------------------------------------------------------------------------------------------------------------------------------------------------------------------------------------------------XXXXXXX----------------------------------------------------------------------
-------------------------------SSSQS--------------QQQQ------------------------------------SS-------------------S---------------------------------SS----SSS---------------S----SS------------SS--SS-SQ?SSS---SS---------------------S---XXXXX-------X-------------------SSS-------------S--------------------------------------------------------------------------------SSSS------------------SSSSSS---------------------------SS--S----SQSS--------------------------------------------SQQ------------SSSS-------------------------XX----SXSSS-------------------------------------------------QQQ--------------------------------------SSS---S---------S---------So----------------------------------------------------------SS--------SSSSSSSSSSSSSSS----------------------------S?SSS----------SSSSSSS---SSS---?-----------------SS-----------------------------------S------------------SSS---S------------------------------------------SSSS----------------------QQQQ---------------XXoo---------------------XXXXXX--------------------S----------------XXX----XXo--------SS-----------------------SS---Q---------S--------SS------------------------------------------------SSS-----SSS---------XXX---------------------------------------------------------SSSSS----------------------------------------------S----SSSS------SS-------------------------------------------------------------------------------?SSSS----------------------------------------------E------------------------------------o-----------S-----------------S-?--------------------SS--
--------------------------------------------------------------oooo------------------------SS------------------------------------------------------------------------------------------------SS--S---------------------------------XX---------------XX-----------------------------------------oooo-----------------------------------oo---------------------------------------------------------------------------------------------------------------------------------------------------------------------------------XXX------------------------------------------------------------------------------------------------------------------------------------------------------------o---------------------------------------S--------------------------------------------------------------------------------------------------------------E-----------------------------------------------------------------------------------------------------------------------------------------------------------------------------EE---------------------------XXX--------------------------------X-------------SS-----------------------------XXX--o---o-------------------------------------------------------------------E--------------------------------------------------------------------------------------------------------------------------------------------------------------------------------------------------------------------------------------------------<>---------o----------------oo--------X----------------------------------------------------SS--
--------------------------E-------------------------------------------------------X-------SS--------------------------------------------E--------------------------------S----S-------------SS--S-----------------------X------------------------XXXX-----------------------------------------------------------------------E---------------------------------------------------------------------------------------------------------------------------------------------------------------------------------------ooo-------------------------------------------------------------------------------------X----------------------------------------------------------------------------------------------------------------S-S--------------------------------E-------------------------------------------------------------------------------------------------X-----------------------------------------------------------------------------------------XX------------------------------------------------------------XXX-----------XXXXXXX---------------------------------------------XX------------SS---S----S-S------------X---o-----XXX-XXX-----------------------------------------------------------------XXX------------------------------------------------------------------XXXXXXXX------X----------------------------------------------------------------------------------------------------------------------------------------------------------------[]---------XX-----------------------XXS----------------------------------------------S-----SS--
-------------------------<>---------------------------------E--------------------XXX--o---SS--------------<>------------------------E----------------------------------X--E--------------??-SS--QoSSS-------------E----X------------------------XXXXX----------------------------------X----E---------------S-------S-----------------------------------------E-----E-----------E-------ooooo------------------------o--------------S------------------------------------------S---------------------------------------------------------------------------------------------------------E--------------------------------------------------------------------------XXXX-----------E----SSSSSS-------------------------------E--E--------------S--So??---S-------------------------E---------------------------------------------------------SQSQS---------------XX--oo------------------------E-----X------------------------------------------------------XX-------------------------------------------------o-----------------------------------------------XXXX------------------E------XX----------ooSS---SoS?-SoS?----------XX---------------XX--------------------------E----------------------------------------SSSSSS-------------------E----------SSSS---------------------------------------XXS-S-------------------------------------S------------------------E----------------------------------XSE----------------------------------E---------E------------[]---------------------------------XXXX----------------------------------------------S-----SS--
----------------------E--[]-----?S---------------SQQQS-----<>----------------------X--SS--SS---------SS---[]---------------E-------<>--S--------SSS--------X----------XX--SSSS-S---------S--SS--SSS-----SSSSS----------X-------------XXXX------XXXXXX----------------------S----------XX---<>---------SS------------------S?S------E--S----------------------<>----<>---SSS?---<>--------------S-SSSS---Q---SSS---E-------------XX--S-ESSSS-----X---------------E---------------X-XX-----------QQQ--QQ------XXX--SS--------------------XXXXXXS?S----Q-QQ--SQS----------------------E----<>----E?QQ?--QQQQ---------------------X--X------------SS---------SS--o------S-------------<>------------------------------E-------------SS------------SSS-SSSS--------SSS---S----X--X------------------E--SSSSSSSSSS-----ooQ------------------X----X---------------------XX-------S----S--------SSS---<>----S----------------E-------E--S--------------S----E-------XX----------?S--------------------XXX-----XXX-X-----------XXX-----------------------XXXX----------------XXX--XXX----SSS----XXXXXXX---------XSSSS---SSS--SSS----------XXX-------EE-------------X--E--QQQQ----------<>------------------------o---XXX------------------------E---E----<>---ES---------E---SS--------------------------------XXX---QQ--QQQ--Q--Q--SS----------Q-------E-------S?----------------<>---------------------oo----------XXX-XX---SS--------------------------<>--------<>------------[]--------------------------------XXXX----QQQ--QQ-Q----S---------E--o-o-------------SS-----SSSS
---------------------<>--[]--------------------------------[]------------------XX<>X----------------E-----[]--------E--------------[]-------------------X--XX--------XXX---------XXX-----------EE----------------------X----------------------XXXXXXX----S-------------E------E------XXX---[]---------SS--E-----<>----------------<>-------------------------[]----[]----------[]-----<>-------------------------<>-------------[]-S----------------X-----------E------------XX-XXXX----------------------------------------XXXX-?------------------------------------------------<>----[]------------------------------------X--X--------------------------------EX-------E------[]-----------------------------<>----------EE-------X--------------------------------E-Q--XX----------------<>-------------------------E-----------XXX---X---E----------------XXX---------------------E-----[]---------E----------<>------<>-------------<>------<>-------XX-------------------------------------------XXX------------------------XXXXXX--------------------------------------------XXXXXXXX-------EXX------------------------XXXX--XXXXXXXXXX----------XXXXXX--------------[]------------------------------------------------------<>--<>----[]----------------------E------E-----XXXXX-----------XXXX-------------------------------------<>-----------S-------------[]-------------------------E------XXXX-XX-------------------------------[]--------[]------E-----[]------------------------------EXXXXXX-------------------------<>-----------X-----------E---SS
---------------------[]--[]--------------------------------[]--------------<>-XXX[]X----------------------[]-------<>--------------[]------------------EX--XXX------XXXX--------XXXX-----------------------------------X---------------------XXXXXXXX-----------------<>-----<>-----XXXX---[]------------<>-----[]----------------[]-------------------------[]----[]----------[]-----[]-------------------------[]-------------[]--------------X---X------------------------XX-XXXX----------------------------------XX----------------------------------------------------------[]----[]------------------------------------E--XXX--------------------------------------<>------[]-----------------------------[]--------------E---XXX------------------------------<>-X--XXX----E----------[]------------------------------------XXXXX--X--------------------XXX---------------------------[]--------<>----------[]------[]-------------[]------[]-------XX-----------------------<>-----------------XXXXX-----X-------XXXXX------------------------------------------------------XXXXXXXXX-------XXX-----------------------XXXXX------------------------------------------[]-----------------------XXXX---XXXXX-------------------[]--[]----[]--------------------------------------------------XXXXX-------------------------------------[]-------------------------[]------------------------<>-----XXXXX-XXX-------XX---------------------[]--------[]-----<>-----[]------------------------------XXXXXXX-------------------------[]----------XXX--------------SS
-------EE-E----E-E---[]--[]-----EE-E-----------------------[]--E-E---------[]XXXX[]X----E-E------E-E-E----[]-------[]--------------[]------------------XX--XXXX--E-XXXXX-------XXXXXE----------------------------------X---EE---------------XXXXXXXXX---E------EE-----[]-----[]----XXXXXE--[]------------[]--E--[]-----------E----[]----------------EE-E-----[]----[]----------[]-----[]-----------------E-E-----[]-------------[]--------------X---X------EE---E---------------XXXX----------------------------------XX----------------------------------------------------------[]E--E[]-----------E--------------E-------EE---XXXX---E-EE------XE-E-------------X-E----[]------[]-------------------EE--E-----[]-------------------XX-E----------E-----------------[]XX--XXXX---S----------[]-E--------------E----------E-----E-XXXXXX------------E-E-EE-----XXX-------E--------------E----[]--------[]----E-EE--[]------[]-------------[]------[]------XX-----------E-----EE-----[]----ooo---------XXXXX----------------------------------EE------------------------------------XXX-XXXXXX------XXXXE-EE------------------XXXXXX---------------------------------------E--[]----------------------XXXX--------------------------E-[]--[]-E--[]-----------------------------X-------------------XXXXXX---------------EE-E--------E---------[]----------------------E--[]---E-E-------E-----EE---[]----XXXXXX-XXX---E---XX----EE-E-------E-----[]-----E--[]-----[]-----[]-------------------------E--XXXXXXXXX----EE-E-----------------[]-E-------XXXX-----E-------E--
XXXXXXXXXXXXXXXXXXXXXXXXXXXXXXXXXXXXXXXXXXXXXXXXXXXXXXXXXXXXXXXXXXXX-XXXXXXXXXXX-XXXXXXXXXXXXXXXXXXXXXXXXXXXXXXXXXXXXXXXXXXXXXXXXXXXX--XXXX-XXXXXXXXXXXXX--XXXXXXXXXXXXXXXXXXXXXXXXXXXXXXXXXXXXXXXXXXXXXXXXXXXXXX----XXXXXXXXXXX--XXX---XXXXXXXXXXXXXXXXXXXXXXXXXXXXXXXXXXXXXXXXXXXXXXXXXXXXXXXXXXXXXXXXXXXXXXXXXXXXXXXXXXXXXXXXXXXXXXXXXXXXXXXXXXXXXXXXXXXXXXXXXXXXXXXXXXX-XXXXXXXXXXXXXXXXXXXXXXXXXXXXXXXXXXXXXXXXXXXXXXXXXXXXXXXXXXXXXXXXXXXXX---XXXXXXXXXXXXXXXXXXXXXXXXXXXXXXXXXXXXXXXXXXXXXXXXXXXXX----E---XXXXXXXXX-------X--XXXX-----XXXX---XXXXXXXXXXXXXX----XXXXXXXX--XXXXXXXXXXXXXXXXXXXXXXXX---X----XXXXXXXXXXXXXXXXXXXXXXXXXXXXXXXXXXXXXXXXXXXXXXXXXXXXXXXXXXXXXXXXXXXXXXXXXXXXXXXXX--XXXXXXXXXXXXXXXXXXXXXXXXXXXXXXXXXXXXXXXXXXXXXXXXXXXXXXXXXXXXXXXXXXXXXXXXXXXXXXXXXXXXXXXXXXXXXXXXXXXXXXXXXXXXXXXXXXXXXXXXXXXXXXXXXXXXX----X-X-XXXXXXXXXXXXXX-XXXXXXXXXXXXXXXXXXXXXXXXXXXXXXXXXXXXXXXXXXXXXXXXXXXXXXXXXXXXXXXXXXXXXXXXXXXXXXXXXXXXXXXXXXXXXX--XXXXXXXXXXXXXXXXXXXXXXXXX---XXX--XXXXXXXXXX-------XXX-----------------------XXXXX----------------------------XXXXXXXXXXXXXXXXXXXXXXXXXXXXXXXXXXXXXXXXXXXXXXXXXXXXXXXX----------------------------XXXXXXXXXXXXXXXXXXXXXXXXX----XXXXX----------------------XXXXXXXXXXXXXXXXXXXXXXXXXXXXXXXXXXXXXXXXXXXXXXXXXXXXX-XXXXX-------XXXX--XXXXXXXX----XXXXXXXXXXXXXXXXXXXXXXXXXXXXXXXXXXXXXXXXXXXX------XXXXXXXXXXXXXXXXXXXXXXXXXXXXXXXXXXXXXXXXXXXXXXXX--XXXXXXXXXXXXXXXXXXXXXXXXXXXXXXXXXXXXXXXXXXXXXXXXXXXXXXXX-XXXXXXXXXXX-XXXXXX---X-XX-XXXXXXXXXXX--XXXXXXXXXXXXXXXXXXXXXXXXXXXXXXXXXXXXXXXXXXXXXXXXXXXXXXXX