------------------------------------------------------------------------------------------------------------------------------------------------------------------------------------------------------------------------------------------------------------------------------------------------------------------------------------------------------------------------------------------------------------------------------------------------------------------------------------------------------------------------------------------------------------------------------------------------------------------------------------------------------------------------------------------------------------------------------------------------------------------------------------------------------------------------------------------------------------------------------------------------------------------------------------------------------------------------------------------------------------------------------------------------------------------------------------------------------------------------------------------------------------------------------------------------------------------------------------------------------------------------------------------------------------------------------------------------------------------------------------------------------------------------------------------------------------------------------------------------------------------------------------------------------------------------
------------------------------------------------------------------------------------------------------------------------------------------------------------------------------------------------------------------------------------------------------------------------------------------------------------------------------------------------------------------------------------------------------------------------------------------------------------------------------------------------------------------------------------------------------------------------------------------------------------------------------------------------------------------------------------------------------------------------------------------------------------------------------------------------------------------------------------------------------------------------------------------------------------------------------------------------------------------------------------------------------------------------------------------------------------------------------------------------------------------------------------------------------------------------------------------------------------------------------------------------------------------------------------------------------------------------------------------------------------------------------------------------------------------------------------------------------------------------------------------------------------------------------------------------------------------------
----------------------------o-------------------------------------------------------SSSSSSSSSSSSSSSSSSSSSSSSSSSS--------------------------------------------------------------------------------------------------------------------------------------------------------------------------------------------------------------------------------------oo---------------------------------------------------------------------------------------------------------SSSSSSSSSSSSSSSSSSSSSSSSSSS---------------------------------------------------------------------------------------------------------------------------------------------------------------------------------------------------------------------------------------------------------------------------------------------------------------------------------------------------------------------------------------------------------------------------------------------------------------------------------------------------------------------------------------------------------------------------------SSS---X--S---------------------------------------------------------------------------------------------------------------------------------------------------------------------------------------------------------------------------------------------------------------------------------------------------------------------------------------------------------------------------------------------------------------oo------------------------o-----------------------------ooo-------
-----------------------------------------------------------------------------------------------------------------------------------------------------------------------------------------------------------------------------------------------------------------------------------------------------------------------------------------------------XXXX-------------------------------------------------------------------------------------------------------SSSSSSS--SS--SSSSSSSSSSS--SS----------------------------------------------------------------------------------------------------------------------------------------------------------------------------------------------------------------------------------------------------------------------------------------------------------------------------------------------------------------------------------------------------------------o-----------------------------------------------------------------------------------------------------------------------------------------------------------------SS-----Q--------?----------------------------------------------------------------------------------------------------------------------------------------------------S----------------------------------------------------Q-----------------------------------------------------------------------------------------------------------------------------------------------------------------------------------------------------------------------------------------------------XXXX------
-------------------------------XXX---------oooooooo--------------------------------------------------------------------------------------XXX-------------------------------------------------------------------------------------------------------oo-----------------------------------------------------------------------------------------------------------------------------------------------------------------------------------------------------------SSSSSSS--SS--SSSSSSSSSSS--SS-----------------------------------------------------------------------------------------------------------------------------ooo-oo-----------------------------------------------------------------------------------------------------------------------------------------------------------------------------------------------------------------------------------------------------------------------------------------------------E-------------------------------------------------------------------------------------------------Eooo-----------------------------------SSS--E-------------------------------------------------------------------------------------------------------------------------------------------------------E----------------------------X----------------------------------oo-------------------------------------------------------------------------------------------------------------------------------------------------------------------------------Eooo-----------------------------------------------------oo--oo--------------
SSS--SSSSS------------------E------------XXo----------------------------------------------------oooooo----------------oo-----XXSooo---------------------------SSSSS---------------------------------SSSSS----?SSS-------?----------------------------------------------SSS--SSSSSSSS-----?SSS---?-------------------------------------------------SS-----------------------S----------------SSS-S--------------------------XX----------------------------SSS----SSSSSSS--SS-------SSSSSS--SS-----------------------------------------------?SSS------QQSQ--Q-Q---------------------------------SSSSSS------------oo--XXX-----------------------------------XXX-----------------------------SSSSS--------------------------------------------SQSS-------------------------------------------E--------------------------------------oo-------------------------------?--Qo-------------------------------------XXXX----ooo------------ES----SSSSSSSSSS-----SSS---?-------------SSSSSSS------------------SSSSSSSSSS----QQ----------------XXXXX----------------SS---------------------SS------------------SS-SS---SS---------------E---S--------------------------------------------------------S-----oo---XXXoo-------------SSS-------------SQS-SS----S------------------XXX-------------oo--XXX----ooo----X--------------------------?-SQ-------------------------SSSS-----------S------------SSSS----XX----------E------------S-?------------------------S----------------SSSSSS------------XXXXX-------XXX-------------XXXX-----XXX-------------------------------------
-------------------------------------------------------o-------------------------------------------------------------XX----------------------------------------------------------------------------------------------------------------------------------------------------------------------------------------------------------------------------------------------------------------------------------------------------XX--------------------------------------------SS------------S--SS------------------------------------------------------------------------------------------------------------------------------------XS------------------------XXX----------------------------------E------------------------------------------------------------------------------------------<>-----------------------------------------------X-------------------------XXX-------------------------------XXX-------------------XXX--------------------------------------------------------------------------------------------------------------------------------------------------SS------------------------------------------<>------------------------------------------------------------XXX-----------------------------------------------------------------------XXX-------S----XX-E--------------------------------------------XXX-------------------------------------------------------------o----E-------------E------------------------------------------------------------------------o-----XXX----------------------XXX--------------------------SS---------
------------------------------------------------------XX----------------------------------------SSSSSSS-------------------------------------------------------------------------------------------------------------------------------------------------XXXX------------------------------------------------------------------------------------------------------------------------------------------------------------XX-XX--------------------------------------------SS---------------SS--------------E-----------XX------------------E-------X-----------------------------------------------------------------------------XX----------------------EXXXX-----------------------------------------------------------------------------------------------------------------------------[]-------o----------------------------------------------------------------ooo----------------------------S----------------------------XX------------------------------------------------------------------------------------------------------------------------------------------------SS------------------------------------------[]--------------------------------------------------o-------------------------------------------------------SS------------------------X-XXX--------------<>---------------------------------------------------------------------------------------------------------------XXXXXX--------XXXXXX-------------------------------------------------------------------------XXXXX----------------------XXX-------------------------------------
------------------------E--X----------------XXXXX-------XXXX----------E------E-----------------SSSSSSS--------------------------XXXXX----------------------------E------------E--?-----------E--------------------------------------------------------------------------X-------------------------------------SSSSSS-----------------------------------------------E--------SS----------S-------------------------------X--X-----------------------E---------------------SS----??oooooo??-SS-------------<>----------XXX-------------------------XX-----------------------------S-----------------------------------------------XX------o--------------XXXXXXX------------------E-----------SSSS-----------E---------------------------------------------------------ooo----------ES-----------------------------------------------XX---------oo------oo-----------------------------------------XX-----------------------------S----------------------------------------------------------------------------------------------oo---oo--------------------------------------------SS-------E----------------------------------[]-------------------------------X----------------------------------XXXX-----------------------------------SSS----??-S---------E-E-EE-X-XXX--------------[]-----------------------------oo----------------------------------------SSS----------------------------------------------------------------------------------------------E----------------------------------XXXXXX-------------------XXXXXX---------X---------------------------
-----SS--SSS--------E--<>--X--------XXXXX----------------------------<>-----<>------S------E-XX-------------------------XXXXX-------------------------------XXX-SSSSS----S---<>-------------<>---------Q-Q---SQQ---------------X------------------------------SSQS-----XXX-XX---SSS-------SSS----------------------------------------------------QQQQ------------E<>-----SSS---------------E--S------------------------XX--X----------------------<>-------------SSSSSS-SSSSS--??SS-SSSSS-SS----E----<>--[]---------XXXX----------------S?S-----XXX-??QQQ--SQS---------------------E-----Q--Q--QQQS----------------XXXX---------XX---------------------XXXXXX------------------------XX-------------------<>----X--------------------------EQQQ--QQQQ--------------E-------------<>S----------XXX-----------------XXXXX-------XXXX------------------------XXXXX--XS--------------E--------------XXX-S------------XXXXX--XXX-----S--QQQQ--Q--Q--S-------------ooo-------XX-XX---SS------X-------------SSSSSSSSSSS---XQQQQ-----------------SSSSS-----QQQQ--Q-----S---------E----SS--SS--S---<>----------SS-SQ---SSS------E---E--[]-------------------S----------XX----------------S----QQQQ---------------XX--XXXXXXXX------SS-------X-----SS---XSSSSS---XX----------XX-XXX--------------XXX---XXX----XXXX-XXX---------------XX------------------------X-------------------------E--------E------?----XXXX--------------------oo-Q-------------X-----------------E-XXX--XX--XX------------------------XXXXXXX-----------------XXXXXXX-------------------------------------
--------E----------<>--[]--X-------------------------------------<>--[]-----[]----------XXXX-XX----------------------------------------------------------XX-----E------------[]-------------[]--XXX----------------------------X---E----------------------------------XXXX-XX------------------------------------------E---------------------------------------E<>[]-----SSS--------------<>--------------------------XXXX-X----------------------[]-------------SSSSSSSSSSSSS---SS------------<>----[]--[]--------EXXXX---E-------------------XXXXX------------------------------<>-----E-----------------X--------------------XX-SSS---------------XXXXXXXXX-------------------X---XX---------E---E-----[]---XX-------------------------------------------------<>-------------[]S--------------------------------------------------------------------------------------------<>-------------XXXX-----------------------------S------------------------------------XXXX-XX---E------XX---------------------------X-------------------------------------------------X--<>----------------[]---------XSX--------------<>--<>--[]--X------------E------E------XXX-----------------------------------------------------------------XXX--XX---E--E---E---XXX----------XX-XXX-------------------------------------E------------S-----------X-------------X---X--------------------<>-------<>-------------------------------------------------E--X--------------XX<>-XXX--XX--XX----------------------XXXXXXXXX--S-------------XXXXXXXX----------------------XX-------------
-------------------[]--[]--X--------------o----------------------[]--[]-----[]---------XXXXS-XX-------------------------------o-----------------------XXX-X---------o-oo-----[]-------------[]--XXX----------------<>----------X--<>-----------------------X---------XXXXX-XXX-----E---X-------------------------------------------------X--------------------<>[][]----<>-S--------------[]--<>-------E-------------XXXXX-XX---------------------[]--------------SSSSSSSSSSSS---SS------------[]----[]--[]----<>-XXXXXX--<>------------------XXXXXX------------------------------[]----<>-----------------X------------XXX-X--XXX----------------<>XXXXXXXXXX-------------------X---XX---------E--<>-----[]---XXX---------X--------------------------------------[]-------------[]---X-------------------------------------------------------------------------------XX--------[]-----------EXXXXX------------------XXX--------S--------------------------Q--------XXXXX-XXX------EXXXX-----E---X-------------E---X-------------------------------------------------X--[]----------------[]------<>-XXX--------------[]--[]--[]--X-----------<>-----<>-----XXXX-------------------------------XXXXX----------------------------XXXX--X--------------XXXXX---------XX-XXX----------------------------------o-<>------------------------X-------------X---X---------X----------[]-------[]------------------XXXX---XXXX--------------------XXXX-------------XXX[]XXXX--XXX-XXX--------------------XXXXXXXXXX---------------XXXXXXXXX--------------------XXXXX--XXXX------
-------------------[]--[]--X-XXXXXXX-----XXX---------------------[]--[]--E--[]-E-EE---XXXXXX-XX-------------------XXXXX------XXX---------------------XXXXXX-----------XX-E---[]-------E-----[]--XXX----------------[]----------X--[]-----------------E--E--X-E------XXXXX--XXXX-------XX----------------------E-E-----------EE-----E-E---X-------EE---------E-[][][]----[]-----------E-E--[]--[]-------S-------------XXXXX-X----E----E-EE------E--[]---E-EE-----SSSSSSSSSSE---oooSS---------E--[]----[]--[]----[]-XXXXXX--[]-----E-----------XXXXXXX------------------------------[]----[]-E--------------XX-XXXoo---------X---XXX---XX-----------[]XXXXXXXXXX-------------------X---XX-----E-E----[]-E-E-[]---XXX----E---XX-------------------E-EE---------EE-E--[]-------------[]-----------------------------ooo---XXXXX-------------------------XXXX--------------XX-EE-E---[]------E----XXXXXX----------XXXX---------------S--------E--E----------------------XXXXXX-XXXX-----QXX-X---------X-----------------X-------------------------------E----EE-E-----EE-----[]-E-E--E------E--[]------[]XXXXE-E-----------[]--[]--[]--ES---EE-E---[]---E-[]----XXXXX----------------------------------------------------------EE---XXXXXE-X-------------XXXXXX------------XXX---E--X------ooo--------------------[]------------------------X---E----EE-E-X---X--------XX---E------[]-------[]-E---------o-----------------------E-----------XXXXXX------------XXXXXXXXXX--XXX-XXX------X------------XXXXXXXXXXX--------------XXXXXXXXXX---EE---------XXXXXXXX---------------
XXXXXXXXXXXXXXXXXXXXX--XX--X-----------------------------XXXXXXXXXXXXXXXXXXXXXXXXXXXXXXXX-XXXXXXXXXXXXXXXXXX-XXX----------------------------XXXXXXXXXXXX---------XXXX---XXXXXXXXXXXXXXXXXX-XXX--XXSXX--XXXXXXXXXXX-XXXXXXXXXXXXXXXXXXXXX----XX---XXXXXXXXXXXXXXXXXXXXXXXX--XXXXXXXXXXXXXXXXXXXXXXXXXXX---XXXXXXXXXXXX---XXXXXXXXXXXXXXXXXXXXXXXXXXXXXXXXXXXXXXXXXXXXXXXXXXXXXXXXXXXXXXXXXXXXXXXXXXXXX--XXX--XXXXXXXXXXXXXXXXXXXXXXXXXXXXXXXXXXXXXXXXXXXXXXXXXXXXXXXXXXXXXXXXXXXXXXXXXXXXXXXXXXXXXXXXXXXXXXXXXXXXXXXXXXXXXXXXXXXXXXXXXXXXXXXXXXXXX---XXXXXXXXXXXXXXXXXXXXXXXX--XXXXXXXXXXXXXXXXXXXXXXXXXXXXXX----XX------X-XXX-XXXX------XXXXX---XXXXXXXXXXXXXXXXXXXXXXXXXXXXXXX--XXX-XXXXXXXXXXXXXXXXXXXXXXXX--XXXXXXXXXXXXXXXXXXXXXXXXXXXXXXXXXXXXX---XXXXXXXXXXXXXXXXXXXXXXXXXXXXX-------XXX--XXXXXXXX--XXXXX-XXX------------------------------XX---------------XXXXXXXXXXXXXXXXXXXXXXXXXXXXXXXX--XXXXXXX-X----------------XX----XXXXXXXXXXXXXXXXXXXXXXXXXXXXXXXXXXXXXXXXXXXXXXXXXXX-XXXXXXXXXXXXXXXXXXXXXXXXXXXXXXXXXXXXXXXXX-XXXXX---XXXX---XXX-XXXXXXXXXXXXXXXXXXXXXXXXXXXXXXXXXXXXXXXXXXXXXXXXXXXXXXXXXXXXXXXXXXXXXXXXX-XX--XXXXXXXXXXXXXXXXXXXXXXXXXXXXXXXXXXXXXXXXXXXXXXXXXXXXXXXX------------------------------XXXXXXXXXXXXXXXXXXXXXXXXXXXXXXXX--XXXX---XXX--XXXXXXXXXX----XXX-X-------------------XXXXXXXXXXXXXXX------XXXXXXXXXXXXXXXXXX--XXX-XXXXXXXXXXXXXXXXXXXXXXXXXXXXXXXXXXXXXXX--XX------------------------XXXXXXXXXXXXXXXXX--XXXXXXXXXXXXXX-XXXXXX--Xo--XXXXXXXXXXXX------XXXXXXXXXXXXXXXXXXXXXX------XXXXXXXXXXXXXXXXXXXXXXX-----S-?-------------E---