-----------------------------------------------------------------------------------------------------------------------------------------------------------------------------------------------------------------------------------------------------------------------------------------------------------------------------------------------------------------------------------------------------------------------------------------------------------------X?SSS--------------------------------------------------------------------------------------------------------------------------------------------------------------------------------------------------------------------------------------------------------------------------------------------------------------------------------------------------------------------------------------------------------------------------------------------------------------------------------------------------------------------------------------------------------------------------------------------------------------------------------------------------------------------------------------------------------------------------------------------------------------------------------------------------------------------------------------------------------------------------------------------------------------------------------------------------------------------------------------------------------------------------------------------------------------------------------------------------
-----------------------------------------------------------------------------------------------------------------------------------------------------------------------------------------------------------------------------------------------------------------------------------------------------------------------------------------------------------------------------------------------------------------------------------------------------------------?SSSS-X-------------------------------------------------------------------------------------------------XX---------------------------------------------------------------------------------------------------------------------------------------------------------------------------------------------------------------------------------------------------------------------------------------------------------------------------------------------------------------------------------------------------------------------------------------------------------------------------------------------------------------------------------------------------------------------------------------------------------------------------------------------------------------------------------------------------------------------------------------------------------------------------------------------------------------------------------------------------------------------------------------------------------------------------------------------------------------------------------------------
-------------------------------------------------------------------------------------------------------------SSS------------------------------------------------------------------------------------------------------------------------------------------------------------------------------------------------------------------------------------------------------------------------------ooo---------------------------------------------------------------SSSSSS------SSSS?SSSSS---SSS--------------------------------------------------------SSSSSS---S-SSSSSS?S-------SS----------------------------------------------------------------------------------------------------------------------------------------------------------------------------------------------------------------------------------------------------------------------------------------oo------------------------------------------------------------------------------------------------------------------------------------------SSSSSSSSSSSSSSSSSSSSSSSSSSS---------------------------------oo----------------------------------------------------------------------------------------------------------o---------------------------------------------------------------------------------------------------------------------------------------------------------------------------------------------------SSSSSSSSSSSSSSSSSSSSSSSSSSSS--------------------------------------------------------------------------------------------------------------------------------------------
----------------------------------------------------------------------------------------------------------------------------------------------------------------------------------------------------------------------------------------------------------------o-Q---------------------------------------------------------------------------------------------------------------------------XXXX--------------------------------------------------------------SSSS--------------------------------------------------------------------------------------------------------------------------------------------------------------------------------------------------------------------------------------------------------------------------------------------------------------------------------------------------------------------------------------------------------E--E-----------------------------------------------------------------------------------------------------------------------------------------------------------------------------------------------XXXX-------------------------------------------------------------------------------------------------------------?-----E--E--------------------------------------------------------------------------------------------------------------------------------------------------------------------------------------SSSSSSSSSSSSSSSSSSSS----------------------------------------------------------------------------------------------------------------------------------------------------
----------------E------------------------------------------------------------------------------------------------------------------------------------------------------------------------------------------------------------------------------------------------------------------------------------------------------------------------------------------------------------------------------------o-----------------------------o----------------------------SSSS-----------------------------------------------------------------------------------------------------------------------------------------------------------------------------------------------------------------------------------------------------------------------E-------------------------------------------------------------------------------------------------------------------------------XXXX----------------------------------------------------------?-----------------------------------------------------------------------------------------------------------------------------------------------------------------------------------------------------------------------------------------------------------XXXXXXX------------------------------------------------------------------------------------------------------------------------------------------------------------------------------------SS-SSSSSSSSSSSSSSSSS-----------------------------o----------------------------------------------------------------------------------------------------------------------
--------------SSQSS--?-----------------------------------------------------XXX-------oooo--------SSQSSSSS?------------------------------------------------------------SQ----------------------------------------------------------------------------------SSo?SSS---?---XX-------------------------------SSSSS----S--------QQQ-------------E----------------------SSSS---------------E--E---------------SSS---?--------S----ooo------------------------------------S--oQ---oooo-----------SS-S----S----------------S------------ooo---------------------------------oo--------SS---------------------------------------Q-------------------oo-----------------------------------------------SSSS--------------------------XX?SSS---------SSSSSSSSSSSSS----------------------------------------------SSSSS-----ES------------------SSS-----SS----------------SSS---------------------------------------Q-----------------------------SQS-S?X------XX---------S------------------------------------------Soo----oo------Q---------------------------------------------------------------------SSS--------------SSSSS---E----------------------------------------------------------------QQQQQ-XXX--------------------------------------------------------------SSSS---------------SSSSS--??SS------E---------------------------------SS-------------------------------SS--------------------------SSSSSSSSSSSSSSSSSSSS--QS----------------------XXXXX-----------SSSSS--E--------------SS--------------SSSSSS---SSS--------------------------------------------SSSSSSS-----
---------------------------------------------------------------------------XXX----------------------------------------------------------------------------------------------XX------------------------------------------------------------------------------------------------------------------------------------------------------------<>---------------------------------------------XXX---------------------XXX----------------------oooo--------------------SS------------------------E--------------------------------------------------------------------------------------------------------------------XXX----------------X------------------------------------------------------------------------------------XXX------------------------------------o--------------------------------------------<>----------------------------------------------------------------------------------------------------------------------------------XSS------------------------------XXX------------XXX----------------------------------------------------------------------------------------------------------------<>---------------------------------------------------------------------------XXXX-------------------------------------------------------------------------------------------<>-----XX---------------------------------------------------------------------------------------------------------------------------------------------XX------------<>--------------------------------------------------------------------------------------------------
---------------------------------------------------------------------------XXX---------------------------------------------------------------------------------------------------XXXXX------------------------------------X----Q---------------------------------------------------o------------------------------------------------------[]----------------------------------------E-----------------------------------------------------------------------------SS---S-SSSSSSSS------------------------------E--------S------SSSSS------------------------------S-SSS------------------------------------------oo----------------XX-----------------------------------------------------------------------------------XXXX---------------------------------------------------------------------------------[]---------------------------------------------------------------------------------------------------------------------------------XXX--------------------------------------------------------------------------------------------------------------------------------------------E--------------------[]--------------------------------------------------------------------------------------------------------------------------------------------------------------------------[]----------------------------------------------------------------------------------------------S-------------------------------------------------------------------[]--------------------------------------------------------------------------------------------------
------------------------------X------------------E--------------------E-EXEXXX---o---------------------------------------------------E-----------------XXX-------------------------------------------S-----------------------E------------------------------SSSSSS------------------------------------------------------------------------[]------------ooo-----------------------------------------------------------------------------E---------E-------------ooSS---SoS-SSSSSS------E-------------------E---------E---------SSSSS-------------------------------SSSS------------------------------------------------------------XX-----------------------------------------------------------------------------------XXXX--------------------------------E-----------------ooo--------------------------------------------------------------------E------------------XXXX-----------------E-----------------------------E-------------------EXXX-----------------------------------------------X----------------------------SS----------------------------------------E--S--------E--S------E--------------------[]---------------------------------------E-------------E--------E-----------------------XXX-------------------------------oooo-----E----------------------------------------[]E------------------------E--SSSSSSSS------------------------------E-------------------S----------------EE--E-?--------ooo-------------------------------E---------[]----------E----------------------------------------ooo----------------S--------E------------------
----X----Q--Q--SS----S----E------------------E--<>-------------------------XXX----------XXX-----?SSSSSSSSS--------------------------<>-----------------------------------------------ooo------------------------S----X--XX--<>--------------SSQS----E-----------------------XXX--SSS-------X------XXS---S-------Q---QQQQ---SS-------------[]-----------------------------E--------XXX---------------------XXXX-----------XXXX--XXXX----<>-------E<>-----E-------SSSS---SSS---------E--<>----Q---SSS-------<>---E----<>--SSSS--------------------------------------------------SS----------<>--------E--S---------------SSQS--S-----XX--------XXX------------------------QQQ------X--XX---------X-----------------------XXXXX------------ES----X----SS---o--<>-------------E--------------------E--?-----------ES--------------------------E----E----<>------SSS------XX---------------------<>-------SS-------------------<>----Q---S?S--------XXXX--------------------<>--------------------SS------------XXX-XXXX-SSS-----------------------------------<>---S--------<>-----E----<>-----E---E-------------S----SSS<--------------------------------------<>------------<>-------<>-?SQS--XXXXX---XXXXX---------------------------------E---o-------<>-----QQQ------------<>-----------S?S----XXS-----------------------<>----------------------------E-----------XS------------------------S-SSSSSSSSSSSSSSS??SS--SQS-SSS-------------XXXXXXXXXXX-----<>-------S-XXS--------<>--X-S--------E----------S-----X-------------------------------E----<>------SS---------X
-E--X--------------------<>-----------------<>--[]--E----------------------XXX----------XXX-------------------E------E--E-----------[]----------------------E-----------------------------------------------------E--Q--XXX-[]---------------------<>--------------------------------------X----------------------------------------------[]-------XX----------------------------------------------------------------------------------[]------<>[]----<>-------------------------<>--[]------------------[]--<>----[]-------------------------------------------------------SSS----------[]-------<>-------XX---------------------XX-----------------------------EX-------------X--XX--------XX---------------------XXXXXXX---------------E--XX-----------[]------E-----<>-------------------<>--------------E--------------------------<>---<>----[]-------------X-XXXX-------------------[]----------------------------[]------------------XXXXX--------------------[]--------------------SSS--------------------------------------------XXXX----------[]------E-----[]----<>----[]----<>--<>-------S-----------------E------E---------------------E-----[]------E-----[]-------[]----------------------------------------------E----E<>-----------[]--------------------[]--------------------------------------------[]---------------------------<>-----------------------------E---E--X--SSSSSSSSSSSSSSS--SS--------------------------------------[]--------------E-----[]--X---------<>---------------XX----E-------------------------<>----[]----------------XX
----X--------------------[]-----------------[]--[]----------------EXXX-----XXX--------XXXXX------------------<>-----<>--------------[]------------------------------------------XXXXXXXXX----------------------------XXXXXX-[]---------------------[]------------------------------E---X---X----------------------------------------------[]-----XXXX----------------------------------------------------------------------------------[]------[][]----[]-------------------------[]--[]------------------[]--[]----[]-------------------------------------------------------SSS----------[]-------[]-------XXX--------------------XX----------------------------<>X-------------X---X-------XXX--------------------XXXXXXXX------------------XXX-------E--[]-----<>-----[]-------------------[]-------------<>--------------------------[]---[]----[]------------EX-XXXX-------------------[]----------------------------[]-----------------XXXXXX--------------------[]--------------------SSS-------------------o--------------------------------------[]-----<>-----[]----[]----[]----[]--[]------------------------<>-----<>--------------------<>-----[]-----<>-----[]-------[]---------------------o-----------------------<>---<>[]-----------[]--------------------[]--------------------------------------------[]---------------------------[]----------------------------<>--<>--X--SSSSSSSSSSSSSSS--SS-------------XXXXX--------------------[]-------------<>-----[]--X---------[]---------------XX---<>-------------------------[]----[]---------------XXX
EE--X----EE-E---------E--[]-----E-----EE-E--[]--[]-------------------------XXX--------XXXXX-----------E------[]-----[]--------------[]----E-----------------------------------------------------------------E----E---XXXXXX-[]-S----------EE--E----[]-----E---------------------------XXE--X-----EE-E---------------E--------------EE-E---[]--E-XXXXX-------------E-EE-----E-------------------------------------o----------------X?E--[]------[][]----[]----------E--------------[]--[]-----E-E-------E--[]--[]-E--[]-S--------------------------X------------------E-------SSS------E-E-[]-------[]-E---E-XS--------E-----E------XX----------------------------[]X---EE----E---XX--X------XXXXE-----E-EE----EEE--XXXXXXXXX------------------X-X----------[]-----[]-----[]----------------E--[]-------------[]-----EE-E-----E-----------[]---[]--E-[]-E--E----------XXXX-------------------[]------------------------E---[]------E---------XXXXXXX-------XX-----E-E---[]--E---------------------oo------------------------------------------------EE-E---[]-----[]--E--[]----[]----[]----[]--[]-------S----------------[]-----[]-E----EE----------E-[]-----[]-S---[]-EE--[]-------[]--------------------X-X----------------------[]---[][]-----------[]------------------E-[]-----------o--------------------------------[]---------------------------[]-----------E--E-----------E-[]--[]--X--SSSSSSSSSSSSSSSooSS----E--E------------------------------[]--------E----[]-E-E-[]--X---EE-E--[]---------------XX---[]---------------EE--------[]----[]--------------XXXX
XXXXXXXXXXXXXXXXXXXXXXXXXXXXXXXXXXXXXXXXXXXXXXXXXXXXXXXXXXXXXXXXXXXX-------XXXXXXXXXXXXXXX--XXXXXXXXXXXXXXXXXXXXXXXXXXXXXXXXXXXXXXXXXXXXXXXXXXXXXXX------XXXXXXXX--QXXXXXXXXX---------------------XXXXXXXXXXXXXXXXXXXXXXXXX-XXXXXXXXXXXXXXXXXXXXXXXXXXXXXXXXXXXXXXXXXX-XXXX------XXXXXXXXXXXXXXXXXXXXXXXXXXXXXXXXXX-XXXXXXXXXXXXXXXXXXXX--XXXXXXXXXXXXX-----XXXXXXXXXXXXXXXX---XXXX-X-XXXXXXX-----X----X------XXXX------------------XXXXXXXXXXXXXXXXXXXXXXXXXXXXXXXXXXXXXXXXXXXXX-XXXXXXX-XXXXXXXXXXXXXXXXXXX-XXXXXXXXXXXXXXXXXXXXXXXXXX----XXXXXXXXXXXXXXXXXXXXXXXXXXXXXXX--SXXXXXXXXXXXXXXXXXXXXXXXXXXXXXXX-----XXXXXXXXXXXXXXXXXXXXXX-XXXXX---XXXXXX-X-XXXXXXXXXXXXXXXXXXXXXXXXXXXXXXXXXXXXXXXXXXXXXXXXXXXXXXXXXXXXXXXXXXXXXX---XXXXXXXXXXXXXXXXXXXXXXXXXXXXXXXXXXXXXXXXXXXXXXXXXXXXXXXXXXXXXXXXXXXXXXXXXXXXXXXXXXXXXXXXXXXXXXXXXXXXXXXXXXXXXXXXXXXXXXXXXXXXXXXXX-XXXXXXXXXXXXXXXXXXXXX--XXXXXXX-XXXXXXXXXXXXXXXXXXXXXXXXXXXXXXXXXXXXXXXXXXXXXXXXXXXXXXXXXXXXXXXXXXXXXXXXXXXXXXXXXXXXXXXXXXX-X-------------------XXXXXXXXXXXXXXXXXXXXXXX----XXXXXXXXXXXXXXXXXXXXXXXXXXXX-XXXXXXXXXXXXXXXXXXXXXXXXX-XX-X-XXXXXXXXXXXX-XXXXXXXXXXXXXXXXXXXXXXXXXXXXXXXXXXXXXXXXXXXXXXXXXXXXXXXXXXXXXXXXXXX--------------XXXX---------------XXXXXXXXXXXXXXXXXXXXXXX-XXXXXXXXXXXX---XXXXXXXXXXXXX-------XXXX------XXXXXXXXXXXXXXXXXXXXXXXXXXXXXXX-XX-XXXXXXX-------X--XXXXXXXXXXXXXXXXXXXXXXXXXXXXXXXXXXXXXXXXX-XXXXXXXXXXXXXXXXXXXXXXXXXXXXX-------------------------XXX-XXXXXXXXXXXXXXXXXXXXXXXXX-XXXXXXXXXXXXXXXXXXXXXXXXXXXXXXXXXXXXXXXXXXXXXXXXXXXXXXXXXXXXXXXXXXXXXXXXXXXXXXXXXXXXX