-----------------------------------------------------------------X---X-oES----------------------------------------------------------------------------------------------------------------------------------------------------------------------------------------------------------------------------------------------------------------------------------------------------------------------------------------------------------------------------------------------------------------------------------------------------------------------------------------------------------------------------------------------------------------------------------------------------------------------------------------------------------------------------------------------------------------------------------------------------------------------------------------------------------------------------------------------------------------------------------------------------------------------------------------------------------------------------------------------------------------------------------------------------------------------------------------------------------------------------------------------------------------------------------------------------------------------------------------------------------------------------------------------------------------------------------------------------------------------------------------------------------------------------------------------------------------------------------------------
-------------------------------------------------------------XX--XX--X-X------------------------------------------------------------------------------------------------------------------------------------------------------------------------------------------------------------------------------------------------------------------------------------------------------------------------------------------------------------------------------------------------------------------------------------------------------------------------------------------------------------------------------------------------------------------------------------------------------------------------------------------------------------------------------------------------------------------------------------------------------------------------------------------------------------------------------------------------------------------------------------------------------------------------------------------------------------------------------------------------------------------------------------------------------------------------------------------------------------------------------------------------------------------------------------------------------------------------------------------------------------------------------------------------------------------------------------------------------------------------------------------------------------------------------------------------------------------------------------------------
----------------------oo----------------------------------oo-----XX----XSS----------SSSSSSSSSSSSSSSSSSSSSSSSSSSS--------------------------------------------------------------------------------------------------------------------------------------------------------------------------------------------------------------------------------------------------------------------------------------------------------------------------------------------------------------------------------------------------------------------------------------------------------------------------------------------------------------------------------------------------------------------------------SSSSSSSSSSSSSSSSSSSSSSSSSSSS----------------------------------------------oo------------------------------------------------------------------------------------------------------------------------SSSSSSSSSSSSSSSSSSSSSSSSSSSS-----------------------------------------------------------------------------------------------------------------------------------------------------------------------------------------------------------------------------------------------------------------------------------------------------------oo-----------------------------------SSS?SSSSSSSSSSSSSSSSSSSSSSSS---------------------------------ooo------------------------------------------------------------------------------------------------------------------------------------------------------------------------------------------------------------------------
--------------------------E------------------------------------Xo-XXX--XX----------o--------------------------------o-------------------------------------------------------------------------------------------------------?-----------------------------------o-------------------------------------------------------------------------------------------------------------------------------------------------------------------------------------------------------E--E----------------------------------------------------------------------------------------------------------------------------------------------------------------------------------------------------------------------SSSS-----------------S---S----------------------------------------------XXXX-?----------------------------------------------------------------------------------------------------------------------------------------------------------------------------------------------------------------------------------------------------------------------------------------------------------------------------------------------------------------------------------------------------------------------------------------------------------XXXX----------------------------------------SSSSSSSSSSSSSS------------------------------------o----XXXX-----------------------------------------------------------------------------------------------------------------------------------------------------------------------o-------------------------------------------?---
-------------------------XXX--------------------------------------XXX--------------------------------------------------------------------------------------------------------------------------------------------------------------------------------------------------------------------------------------------------------------------------------------------------------------------oo--oo--oo--------------------------------------------------------------------XXXXXXX--------------------------------------------------------------------------------------------------------------------------------------------------------------Eooo--------------------------------------------------SSSS-EE-----------------ES---------------E-----------------------ooooooooooo-------------------------------------------------------------------------------------------------------------------------------------------------------------------------------------------------------------------------------------------------------------------------------------E---------------------------------------------------------------------------------------------------------------------------------------------------------------oo--oo---------------------------------------------SSSSSSSSSSSSS-----------------------------------------------------------------X---------------------------------------------------------------------------------------------------------------------------------------------------------------------------------------------------
--XXoo----X------------------------------------------------XXX--------------------------------------------------S?SSS---------------------------------QQQ---SSS-----------------------------------SSSSS------SSS-----E--?-o-----------------------------------SSS-----SSSSS----------------------------------------S------SS---------------E---S------------SSSS---------------XXXXX------------X-----------------------------------SSSSS-------------------S---S---------------------------S-------------------------------------------------------SSSSS-------------SS-?------------SSSSSS-------------------------?SSSS------------------XXXXX--------------------------XXXX-------------------SS---SS-----------------SS--------------SSSSSS--------------------X-----------------SS-----QQQ------------------------------------------------------------SSSSSS-----X---------------------------S------------------------------------------------------------------------------------SS-------SSS--------?-----------------XX-----------------------E-----------E-------------------SSSSSSSSSSSSS----------------------SSSS------------------------SSSSS--SS-SSS-----E--S--------------------------------------------XX-------------------------------------------------------------SSSSSSSSSSSS-------------------------XX------SSSS------------------------------SSSS-----------------------------------------------------------------SSSSS-------------------------------------S--------------------------------oo-XXXX---------------SSS--SS---SSS---------o-----
---------------XXX----------------------------------------o-o------------XX-----E-----------------------------------------------------------------------------------------------------------------------------------<>---------------oo---------------------------------------------------------------------------------------------------<>---------XX---------------------------------------------------------------------------------------------------------------------------oooo----------------------------------------------------------------------------------------X-------------------------------------------------------------------------------------------------------------------SS---SSS----------------SS-------------------------------------------------------E---------------------oooo----ooo--------------------------------------------------XX---------------------------------------------------------------------------E-------------------------------------------------------------------XXX------------E---------------<>--------------XXX-------------------------------XXX------------------------------------------------------------<>--------------------------------------------------------------XXXX-----------------------XSSSS-----------------------------------------------------XXX-------------------------------------------------------------------------------------------EX------------------------------------------------------------------------------------XXXXXXX--------------------------------------------XXXX-
---------------------------------------------------------------XXXXX---------XXXXXXX---------o--------------------------------------------------------------------------------------------------E-------------------[]--------------------------------------------------------------------------------------------------------------------[]----XX--oo----------------------------------------------------------------------------------------------------------------------------------------------------------------------------------------------------------------------ooo-----------------------------------------------------------------------------------o-------------------------------SS---SS-----------------SS---------------------------------------------------XXXXX--------------------------------------------------------------------------------XXSS--------------o---------------------------------------------------------------------------------------------------------------------------------------------------------------[]---------------------------------------------------------------------------------------------------------------[]-------------------X-----------------------------------------------------------------------------------------------------------------------------XXXXX--------------------------------E---------------------------------------------------------<>X----------------------------------------------------------o---------------------------------------------------------------------------------
-------------------XX---------------------------------------------------------------------S---------------------SSSSSSS-----------------SSSS--------------------------E---E-----------------E---------SQ------------[]--------------------------------oo----SSSSSS-----------------------------------------------E------------------------[]----XX----------E-------------E-------------------------------------------------------------------------------------SS----------------<>---------------------------------SSS-------------------------------------oooo-------------------------------------------------------------------------------------------------------------------------------X--So??SS-----oooooo-----oSS---------------------------------------------------------------------------E---------------------------------------------o-------------XXXXS----------------------E--------------------------------------------------X-----------------------------------------E-------------------------------------------S-----------E--XXX--------------------------------------------------------o--------------------SSSSSSSS-------------------------[]-------E-------E------------------------------------------------------XXX--o-------------------------------------------------------------------XXXXXXX-------------------------------<>---------------------------------------------------------[]X---------------------------------------------------oo-------------------------------------XXX-----------------------------------E-----------
-----XXXXXXX------------------SS------------------------X----------ooo---------------------S-------------------------------------------------------QQ??QQQ-----------<>--<>--------E-------<>----E?S-----Q--QS?S------------XXX------XXXX---------X-------------------------------------------------------------<>----Q---SSS------E---E--[]----XX----S----<>------------<>--------XXXX---XXX----X--------------------------------ESSS---------------X-------------E--------------[]--------------Q--Q-------------------------------------------------------------XXXX--SSS---------S---SSS----X--------------QQQ--QQQQ---------------X----------------XXX-SSS----------XXX--------------------X--SSS-SS----SSSS---S---SSSS---X---------------SSS---------------------XXXX---------------QQQSS?SS---E<>-----E------------------------------S------E--------S?----XXX-X-------------S--------<>----------------------------------XXXX----XXX---------------------------oo------XX---------<>-----S?S----------------------------------X-----------<>--------X--XXX------------ESQS-----XXX-X---SSSSSSS-----------------XXX---S---------------------------SS-----------SXXX-----<>------<>-------------------------E-XX-----------XXXXXX------------------------------------------XX---S----SSSQS---------------QQQQ-----XXXXXXX--------------------------E-E--[]--------SS----------------------X----------Q---------<>--[]X---------X------SSSSS---------------------------ooo------S--------E------------------------------XX-------------------S--S?S---<>--XX------o
-------------------------------------XX------E-----------------------E----------------EXXX---------------------------------------------------------------------------[]--[]-------<>-------[]----------------------------------------------------XXX------------------------------------------------------------[]----------------<>--<>--[]----XX---------[]------------[]-------------------------o--------E------E---E--------<>-------------------------------<>---------E----[]------------------------------<>-------------------E-X---X----------------------------------------------o---X-------------------------------------XX-------------------------------------------------------X------------------------------XXXXXX-<>-------------------------------------------------------E----E<>[]----<>------------------------------------<>-------------XXXX-XX---------------------[]--------------------------------------------------------------------XX---E--X---XX---------[]-----------------------------------------XX--XX-------[]----------------------E-----------XXX--XX----------------------------------------------------------------------------------[]------[]---X--------------------<>-XX--------------------------------------------XXX-----------XXS-----ES----------------------------XXXXXXXXX-------------------------<><>--[]--------------------------------X--------------------[]--[]X---------XX-----E------------------------------------------------<>------------------------------------------------------------[]----------X
------------------------------------XXXX-----------------------XXXXXXXX----XXX-------XXXXX--SS----------------------------------------------X------------------------[]--[]-------[]-------[]---------------------------------------------------XXXXX----------------------------------X------------------------[]----------------[]--[]--[]----XX---------[]------------[]-------------------------XXXXX---<>-----<>--<>--------[]-------------------------------[]--------<>----[]----------------------<>------[]------------------<>-X--XXX-<>-----------------------------X------------E---X-X----------------------------------XXX------------------------oooo-------------E------------XX-----------------------------XXXXXXX-[]-----------------------------------XXXXX-------------------<>[][]----[]------------------------------------[]------------XXXXX-XX---------------------[]-------------------------------------------------------------------XXXXXXXX-----XXX--------[]----------------------------------------XXX--XXXX-----[]---------------------<>----------XXXXX-XXXX--------------------------------------------------------------------------------[]------[]---X--------------------[]-XXX-----------------o-----------------------XXXXXX-XXX------XXX---S-SSS--------------------------XXXXXXXXXX--------X----------------[][]--[]--------------------------------X-------------------X[]--[]X---------XXX-----------------------------------------------------[]------------------------------------------------------------[]----------X
XXXX------------------------E-EE---XXXXX-----------------XX-------------------------XXXXX---------------EE-----E-----------E----------E-E---XXX----EE---E---E--------[]--[]----E--[]E------[]--------------------------------------------------XXXXX-----------------------------EE---XX-----E--E------E-----E--[]----E-----------[]--[]--[]----XX-----E-E-[]------------[]-----ooo-----------------------E-[]-----[]--[]--------[]-EE----------------------------[]--------[]----[]----------------------[]------[]------------------[]-XE-XXX-[]----------------------------XX----------------X-----EE-E-X---E-----------------EE-XXXX---------XXXXX-----------------o---------------------XXX----------------------E-E---XXXXXXXX-[]---E------------X--XXXXXXXXX-------------------------------[][][]----[]-E----------------------------------[]-------EE--XXXXXX-XX--------E--------EE--[]-------------------------------------------------------------EE---XXXX----------XXX--------[]---------------------------------------XXXXE-XXXX-----[]---------------------[]---------XXXXX--XXXX----------E---------------------------------------------------------------------[]------[]---X------E--------E--E-[]-XXX--------ooo----------------------XXXX-XXXXXX-----S-------XXX---------------E-------EE--------XXXXXXXXXXX--EE-E--X--E--EE-E-------[][]--[]-----E--------------------E-E-E-X-------EE-----EE--XX[]--[]X---------XXXE-----------------------EE---------------------------[]------------------------------------------------------o-----[]----------X
----------------------------XXXXXXXXXXXXXXXXXXXXXXXXXXXX----------------------------XXXXX-------XXXXXXXXXXXXXXXXXXXXXXXXXXXXXX---XXXXXXXXXXXXXXXXXXXXXXXXXXXXXXXXXXXXXXXXXXXXXXXXXXXXXXXXXXXXXXXXXX----XXXXXXX-X-XXXXXX---XXX---XXXXX----XXXXXXXXXX------XXXXXXXXXXXXXXXXXXXXXXXXXXXXXXXXXXXXXXXXXXXXXXXXXXXXXXXXXXXXXXXXXXXXXXXXXXXXXXXXXXXXXXXXXXXXXXXXXXXXXXXXXXXXXXXXXXXXX--XX----------------------XXXXXXXXXXXXXXXXXXXXXXXXXXXXXXXXXXXXXXX--------X-XXXXXXXXXXXXXXXXXXXXXXXXXXXXXXXXXXXXXXXXXXXXXXXXXXXXXXXXXXXXXXXXXX-----X-XXXXXXXXXXXXXXXXXXXXXXXXXXXX-X-----E---XXXXXXXXXX--XXXXXXXXX--XXXXXXXXXXXXXXXXXXXXXXXX-----XXXXXXXXXXXXXXXXXX-----------------------XXX---XXXXXXX---XXXXXXXXXX--XXXXXXXXXXXXXXXXXXXXXXXXXXXXXXXX---XXXXXXXXXXXXXXXXXXX----------------------------XXXXXXXXXXXXXXXXXXXXX-X-XXXXXXXX----XXXXXXX-----XXXXXXXXXXXXXXXXXXXXXXXXXXXXXXXXX---XXXXXXXXXXXXXXXXXXXXXXXXXXXXXX---XXXXXX-XXXX--X---XXXXXX----------------------------XXXXX-XX---------XXXXXXXXXXXXXXXXXXXXXXXXXXXXXXXXXXXXXX---XXXXXXX-XXXXXXXXXXXXXXXXX-XXXXXXXXXXX-XXX---XXXXXXXXXXXXXXXXXXXXXXX--XXXX--XXXXX--XXXXXXXX---XXXX--XXXXXXXXXXXXXXXXXXXXXXXXX---XXXXXXXXX-X-----XXXXXXXXXXXXXXXXXXXXXX-XXXXXXXXXXXXX--XXXXXXXXXXXXX-------XXX-----XXXX---------XXX-------XXXX----------S---XXXXX--XXXXXXXXXXXXXXXXXXXXXXXXXXXXXXXXXXXoXXXXXXXXXXXXXXXXXXXXXXXXXXXXXXXXXXXXXXXXXXXXXXXXXXXXXXXXXXXXXXXXXXXXXXXXXXXXXXXXXXXXXXXXXXXX--XXX--XXXXXXXXXXXXXXXXXXXXXXXXXXX---XXXXXXXXXXXXXXXXXXXXXXXXXXXXXXXXXXXXXXXXXXXXXXXXXXXX----XXXXXX-XX-------X-XXXXXXX--XXXXXXXXXXXXXXXXXXXXXXXXX