---------------------------------------------------------------------------------------------------------------------------------------------------------------------------------------------------------------------------------------------------------------------------------------------------------------------------------------------------------------------------------------------------------------------------------------------------------------------------------------------------------------------------------------------------------------------------------------------------------------------------------------------------------------------------------------------------------------------------------------------------------------------------------------------------------------------------------------------------------------------------------------------------------------------------------------------------------------------------------------------------------------------------------------------------------------------------------------------------------------------------------------------------------------------------------------------------------------------------------------------------------------------------------------------------------------------------------------------------------------------------------------------------------------------------------------------------------X?-------------------------------------------------------------------------------------------------------------
------------------------------------------------------------------------------------------------------------------------------------------------------------------------------------------------------------------------------------------------------------------------------------------------------------------------------------------------------------------------------------------------------------------------------------------------------------------------------------------------------------------------------------------------------------------------------------------------------------------------------------------------------------------------------------------------------------------------------------------------------------------------------------------------------------------------------------------------------------------------------------------------------------------------------------------------------------------------------------------------------------------------------------------------------------------------------------------------------------------------------------------------------------------------------------------------------------------------------------------------------------------------------------------------------------------------------------------------------------------------------------------------------------------------------------------------------------------------------------------------------------------------------------------------------------------------
----------------------------------------------------------------------------------------------------------------------------------oo--------------------------------------------------------------------------------------------------------------------------------------------------------------------------------------------------------------------------------------------------------------------------------------------------------------------------------------------------------------------------o-----------------------------------------------------------------------------------------------------------------------------------------------------------------------------------------------------------------oo------------------------------------------------------------------------------------------------------------------------------------------------------oo------------------------------------------------------------------------------------------------------------------------------------------------------------------------------------------------------------------------------------------------------------------------------------------------------------------------------------------------------------------------------------------------------------------SSSSSSSSSS-----SSSSSSSSSSSSS----------------------------------------------------------------------------------------------------------------SSSSSS-------S-SSSSSSSSSSSSS----oo---------------------------------------------------------------------oo-------
------------------------------------------------------------------------------------------------------------------------------?------------------------------------------------------------------------------------------------------------------------------------------------------------------------------------------------------------------------------------------------o----------------------------------------------------------------------------------------------------------------------------------------------------------------------------------------------------------------------------------------------------------------------------------------------------------------------------------------------------E-------------------------------------------------------------------------------------------------------------------------------------------------------------------------------------------------------------------------------------------------------------------------------------------------------------------------------------------------------------------------------------------------------------------------------------------------------------------------------------------------------------------------------------------------------------------------------------SSSSSSSSSSSSSS----------------------------------------------------------------------------------------------------------------SSSS--------------------------------------------------------------------------------------------------XXXX------
---------oo------------------------------------------------------------------------------------------------------------Eooo-----------------------------------------------XXX--------oooooo--oo-------------------------------------------------------------------------------------------------oo--ooo-----------------------------------------E----E-------------------------------------------------------------------------------------------------------------------------ooo---o--------------------------------------------------------------------------------------------------------------------------------------------------E--------------------------------------------------------------------E---------------------XXX-XXX----------------------------------------------------------------------------------------------------------------------------------------------------------------------------------------------------------------------------------------------------------------------------------------------------------------------E----------------------------------------------------------------------------------------------------------------oo--oo-----------------------------------------------------------------------------------------------------------------------------------SSSSSSSSSSSSSS----------------------------------------------------------------------------------------------------------------SSSS-----------------------------------XXX-----------------------------------------------------oo---------------
---------XXX------XXX---------------S---------XX-----------------------------------------------------------------------XXXXX------XX--------------------------S?SSS----o------o------XX------------------------------------------------------------XSSS--------------------SSSSS--------oo-----------------------------------------SQQS---------S---SQS---?-----XX-----SSSSS--SS-----------------SSS-----------SS---------------------Q---------------------------------------E---------------------------------------------------------------------------------------------SSQQSSSSS---?SSS-----E----------SSSS-S-----SSSS----------------SSQS---?SSS----------SSSS---------------------------------------SSSS-SSSS-SS-------------------------------------SQS----------------SSSSS------SS-------------------------------------S-------SSS--------------------------------------------XXX---------SSS---------XXoo---??------------------SSS----------SSSS---------QQQS-------------------------------------------------------------------------------------SSSSSSSSSSSSSS-S-?---------------XX--------------------------------------------------------------------------------------------------------------------------------SSSS--------------------------------------------------------------------------o---------SSSSSSSSSSSSSSS----------------------SSSSSS----S-S-----------E------S------------------------------SS---------------SSSSS-----------------ooo------------SS---------------------------S--------------------------S----------XX-----------------
-------------o----XXX-------------------------XXS------------------------------------------------------oo---------XX---------oo---XXS----------------------SSS--------XXE--------------------------o---------------------------------------------------------------------------------------------------------oooo-----------------------------------------------XXX---------------------------------------------------------------------------------------------oo------------------------------------------------------------------------------------------------------------------------------<>------------------------------------------------------------------------------------------------------------------------------------------------------------------------------------------------------------------------------------------------E-------------------------------------XXX-------------------------------XXXXX---------------------------------------------------------------------------------------------------------------------------------------------------------------SXX-------------------------------------XXXXX-----------------------------------XX-----------------------------------------------------------------------E------------o----------------------------------------------------------------------------------------------------------------<>-------------------------------------------------oooo---------------S---------------------------E-------------oo---------------oooo----------------------------------------------
-----------------XXXX------------------------XXXX--------------------------------------------------------------------------------XXXX------------------------------------------------------------XXX------------E-------------E--------------------------------------------------------------------------------------------------------------------------------XXXX----------------------------------------------------------XX----o---------------------------------XXX-XXX-------------X------------------------------------------------------------------------------------------------------[]---------------------------------------------------------------------------------------------------------------------------------------------------------------------------------------------------------------------------------------<>------<>-----------------------------------X-XXX------------------------------------------------------------------------------------------------------------------------------------------------------------------E-------------------------------oooo------------------------------------------------------------------------------------------------------------------------------------------------------XX----------oo-------------------------------------E--------------------------------------------------------------------------[]-------------------------------------------------------------------SS---S---SSSSSS----------S-----------------------------------------------------------------------o------------
oo---oo---------XXXXX-----------------------XXXXX--o------------------------------------------------------------Q---------------XXXX-----------------------S---------------------------------------------------<>-------------E------S-------------S----------------------------------ESSQSSS--------------E-----------------E------------------E-------------XXXXX-----------------------------------------------------S---X-X------------------------------------------------------------------------------------o-------------E--E----X------------------------------------------------------[]-------------------------------------------------------------------------------------------------------------------------XS--E---------------E----------------------------------------------------------------------------E------------[]------[]------oo---------------------------XXXXX----------------------------------------------------------------------------------------SSSSS---E--------E-----------E----------------------------------------------------------------o---------EXS-----------------------------S-------------------------------------------------------------------E----------------------E---------------E-------------------------------------------------------E-------E--<>-----E-----------------------------------------------------------------------------------------------------E---------------E----------------XooSS---So---SSSS-------------SQSQ-------S--------------E----E---------o-----------EX----------------------------
---------------XXXXXX-----------------------XXXXX--------Q-------------------------------------------E-------------------------XXXXXX---------------------XXXXX-S---------------XXXXX--------XXXX--------------[]---S--------<>--------------------------------------Q-QQ---S--------<>----------XXX-----E<>-----E----------<>----E?QQQ--QQQQ---XS--S?S------XXXXXX--------------------------------------------SS--------S--XXX--S--SSSS-------------------------XX--------ooo--XXX--------------------------------------------------XX-XXX-----------------------------E----------E-Q--Q-------[]-------------QQQ--QQQQQ----X-------------ESS------XX-------------------------------S---------------------XX--X----------XX--<>-----E-----E-E<>--<>--------SSS-----X--X------------Q-----SS---------------S-S------------E<>-------E----[]------[]-------S--------------------------XX-XXX-------------------XXX---XXXX------------QQQ----XXX-XXX-------S---------o?SQQQ-----------------<>-------<>---------E<>--------------E------E----------------X-X----S?SSSSSS-S-SS-ooooo-o-------XXXX-------------------------S------E--S-------------------------------------XXXX-------------------<>------QQ-------------<>--------------<>-----E-----------------------------------------------E<>-----E<>--[]------------E--?SSSSSSSSSSSSS-----------E------------SSS-----SSS--------S--E------------------------S-----<>-----QS-------<>--------S------XXSSSS---SSS---S--------------------S--------E--S------------<>-----E---------E----<>X--------XXXXXXX-------------
--------------XXXXXXX--SS-------------------XXXXX-------------------XXXX-----------------XXXXX-----E<>------------------------XXXXXXXSS--S-------------XXXX--XX------------------------------------------------[]------------[]--------------XX--------------------------------------[]----------------E<>[]----<>----------[]------E-----------------------XXXXXXX------------------------------------X------------------X-X-X------------------------------XX?------------E------------------------------------X---------E---------XX-XXX-------EX--E----------------<>-----------------------[]--------------------------------------------------XX--XX--------------------------------X---------------XXX--XX--------XXX--[]----<>----<><>[]--[]---------------XX--XX---------------------------------E--------------<>[]------<>----[]------[]----------------------------------XXXXXX-----------------------------------------------XXXX-XXX----E-----------------------------------[]-------[]-------E<>[]-------------<>----E<>-------------XXX--XX------------------------------XXXXX-------------------------------<>--E------------------XXX----SSSS-------------------------------[]---------------------[]--------------[]----<>------------------------------X---------------<>[]----<>[]--[]----------X<>--------------------------<>---------------------------E-----<>------------------------------[]--------------[]--------------XXX------------------------------------------<>---------------[]----<>--------<>----[]X----------------------------
-------------XXXXXXXX----------------------XXXXXX-------------------------------------------------<>[]--------------------<>-XXXXXXXX-----------------XXXXX---------oooo--------------o------------------------[]------------[]-------------XXX--------------------------------------[]---------------<>[][]----[]----------[]-----------------------------XXXXXXXX--------X---------------------------X------------------X-XXX-------------------------------------XXXXXXXXXXX------------------------------E---X-------------------XXXXXX-------XX-<>----------------[]------X----------------[]--------------------------------------------------XX---XX---------------------------E---X--------------XXXX--XXXX-----XXXX--[]----[]----[][][]--[]--------------XXX--XXX-----------------------------------------------[][]------[]----[]------[]------------------------------<>--XXXXXX----------------------------------------------XXXXX-XXX----------------------------------------[]-------[]------<>[]---------------[]---<>[]------------XXXX--XXX----------------------------XXXXXX-------------------------------[]-<>---------------XXXXXX--X-----------------XXXXX--XXXX--------[]---------------------[]--------------[]----[]------------------------------X---------------[][]----[][]--[]----------X[]--------------------------[]--------------------------<>-----[]------------------------------[]--XXX---------[]-------------XXXX------------------------------------------[]--?------------[]----[]--------[]----[]X------------------------XXXX
------------XXXXXXXXX-----------------------XXXXX------X------------------------------------------[][]--------------------[]XXXXXXXXX---?-----------XXXXXX?-----------XX--XXXX-------XXX-----------------E-EE--[]---------E--[]------------XXXX--------------------EEEE-E------------[]-------------E-[][][]----[]-E-EE-E---[]------------------E------------XXXXXX-------XX---------------------------X--EE-E-E-----E----X-X-X----------------------------------------------------------------------------------X---------------E---XXXXX-------XXX-[]---------E-EE---[]------X------------E---[]-------E-----------------------------X-E--------XXXX--XXX--EE----X--------------E-E-----X--------E----XXXXX--XXXX----XXXXX--[]----[]----[][][]--[]--------E----XXXX--XXXX-----------E-EE-E-------------------------E---[][]------[]----[]------[]-------------E---------E------[]--XXXXXX------------------o-----o--------------------XXXXX--XXX----------------------------------------[]-E-EE--[]---E--[][]---------------[]---[][]-----E-EE--XXXXX--XXXX---------------E----------XXXXXXX-XS------------EEEE--E-----EE--[]-[]----XXXXXXX-X-------X--S-EES--------------------------------[]----E-------EE-E-E---[]--------------[]----[]-E--------------------------------------E-EE--[][]----[][]--[]-----E--E-X[]--------E----------E-EE---[]-------------------EE---E-[]-----[]------------E--E-EE-E--EE-E---[]--XXXE--------[]------------XXXXX--E----------------------------------E----[]-E---------SE--[]----[]--------[]----[]XXXXXX-----------------------
XX-XX---XXXXXXXXXXXXXXXX--XXXX----XXXXXXXXXXXXXXXXXXXXXXXXXXXXXXXXX-----XX-XXXX---XXXXXX-----XXXXXXXXXXXXXX---XXXXXX----XXXXXXXXXXXXXXX-XXXXXXXXXXXXXXX-----------E-XXXX----------------------------XXXXXXXXXXXXXXXXXXXXXXXXXXXXXXXXXXXXXXXXXX-------XX-XXXXX--XXXXXXXXXXXXXXXXXXXXXXXXXXXXX--XXXXXXXXXXXXXXXXXXXXXXXXXXXXXXXXXXXXXXXXXXXXXX---XXXXXXXXXXXX-XXXXXXXXXXXXXXXX--XXXXXXXXXXXXXXXXXXXX-X---XXXXXXXXXXXXXXXXXXXXXXXXXXXXXXXXXXXXXXXXXXXXX---XXXX----X----------------------------XXXXX---XXXXXXXXXXX--XXX-XXX----XXXXXXX--XXXXXXXXXXXXXXXXXXXXXXXXXXXXXXXXXXXXXXXXXXXXXXXXXXXXXXXXXXXXXXXXXXXXXXX---XXXXXXXXX------XXXXXXXXXXXXXXXXXXXXXXXX--XXXXXXXXXXXXXX--XXXXX-XXXXXXXXXXXXXXXXXXXXXXXXXXXXXXX--XXXXXXXXXXXXXXXXXXXXXXXXXXXXXXXXXX-XXXXXXXXXXXXXXXXXXX--XXXXXXXXXXXXXXXXXXXXXXXXXX-XXXXXXXXXXXXXXXXXXXXXXXXXXXXXXXXXXXXXXXXXXXXXXXXXXXXXXXXXXXXXXXXXXXXXXXXXXXXXXXXXXXXXXXXXXXXXXXXXX-------XXX---XXX-------XXXXXXXXXXXXXXXXXX--XXXXXXXXXXXX-XXXXXXXXXXXXX----XXXXXXXXXXXXXXXXXXXXXXXXXXXXXXXXXXXXXXXXX---XXXXXXXXXXXXXXXXXXXXXXXXXXXXXXX-XXXXXXXXXXXXXXXXXXXXXXXXXXXXXXXXXXXX-----XXXXXXXXXXXXXXXXXXXXXXXXXXXXXXXXXXX-------------XXXXX-XX--XXXX---X------------------------XXXXXXXXXXXXXXXXXXXXXXXXXXXXXXXXXXXXXXXXXXXXXXXXXXXXXXXX---XXXX-XXXXX---XXXXXXX-----XXXXXXXXXXXXXXXXXXXXXXXX-XXXXXXXXXXXXXXXXXXXXXXXXXXXXXXXXXXXXXXXXXXXXXXXXXXXXXXXXXXXXXXXXXXXXXXXXXXXXXXXXXXXXXXXXXXXXXXXXXXXXXXXXXXXXXXX-XXXXXXXXXXXXXXX-X-XXXXXXXXXXXXXXXXXXXXXXXXXXXXXXXXXXXXXXXXXXXXXXXXXXXXXXXXXXXXX--XXXXXXX--XXXXXXXXXXXXXXXXXXXXXXXXX----------------------------