------------------------------------------------------------------------------------------------------------------------------------------------------------------------------------------------------------------------------------------------------------------------------------------------------------------------------------------------------------------------------------------------------------------------------------------------------------------------------------------------------------------------------------------------------------------------------------------------------------------------------------------------------------------------------------------------------------------------------------------------------------------------------------------------------------------------------------------------------------------------------------------------------------------------------------------------------------------------------------------------------------------------------------------------------------------------------------------------------------------------------------------------------------------------------------------------------------------------------------------------------------------------------------------------------------------------------------------------------------------------------------------------------------------------------------------------------------------------------------------------------------------------------------------------------------------------
------------------------------------------------------------------------------------------------------------------------------------------------------------------------------------------------------------------------------------------------------------------------------------------------------------------------------------------------------------------------------------------------------------------------------------------------------------------------------------------------------------------------------------------------------------------------------------------------------------------------------------------------------------------------------------------------------------------------------------------------------------------------------------------------------------------------------------------------------------------------------------------------------------------------------------------------------------------------------------------------------------------------------------------------------------------------------------------------------------------------------------------------------------------------------------------------------------------------------------------------------------------------------------------------------------------------------------------------------------------------------------------------------------------------------------------------------------------------------------------------------------------------------------------------------------------------
-------------------------------------------------------------------------------------------------------------------------------------------------------------------------------------------oo--------------------------------------------------------------------------------------------------------------------------------------------------------------------------------------------------------------------------------------------------------------------------------------------------ooo--------------------------oo----------------------------------------------------------------------------------------------------------------------------------------------------------------------oo------------------------------------------------------------------------------------------------------------------------------------------------------------------------------------------------------------------------------------------------------------------------------------------------------------------------------------------------------------------------------------------------------------------------------SSSSSSSSSSSSSSSSSSSSSSSSSSSS--------------------------------------------------------SSSSSSSSSSSSSSSSSSSSSSSSSSSS--------------------------------------------------------------------------------------------------------------------------------------------------------------------------------------------------------------------------------------------------o-----------------------------------------------------------------
-----------------------------------------------------------------------------------o------------------------------------------------------------------------------------------------------XXXX---------------------------------------------------------------------------------------------------------------------------------------------------------------------------------------------------------------------------------------------oo-------------Q------------------------------------XXXX------------------------XXXX--------------------------------------------------------------------------------------------------------------------------------------------------------------------XXXX-----------------------------o---------------------------------------------------------------------------------------------------------------------------------------------oo----------------------------------------------------------------------------o-------------------------------------------------------------------------------------------------------------------------------------------------------------------SSSSSSSSSSSSSSSSSSSSSSSSSSSS--------------------------------------------------------SSSSSSSSSSSSSSSSSSS-----------------------------------------------------------------------------------------------------------E-------------------------------------------------------------------------------------------------------------------------------------------?---------------------------------------------------------------------
--------------------------------------------------E------------------------o-----------------------------------------------E----------------------------------------------------------------------------------------------------------------------------------------------------------------------------------------E----E-----------------------------------------------------------------------------------------------------------------------------------Eoo-------------------------------------------------------------------------------------------------------------E-------------------------------------------------------------------------------------------------------------------------------------------------------------------------o-----------------------------------------------------------------------------------------------------------------------------------------------------------------------------oo---------------------------------------------------------------------------------------------------------------------------------------------------------------------------------------------SSSSSSSSSSSSSSSSSSSSSSSSSSS--------------------------------XXX----------------------SSSSSSSSSSSSSSSSSSS--------------------------------------------------------------------------------------oooo---oo------------XXX-XXX------------------------------------------------------------------------------------------------------------------------------Eooo-------------------------------------------------------------------------
---------------QSS----------SSS---?-------oo-----o---E---------------------------------SSSSS--------------------SSS--------E---SSSSS-----------------------------------------------------------------------------------------?----------E--------o------------------------------------------------------------------S---SQS---?SSS----------SSSS-----------------SSSS-----------------------------------------S-Q----------------------------SS--------------XXX-SS-SQS--------------SSS-----S-------------------------S-S-?---------------------S-SS-----------------------SSSS--------------------------------------------SSS---------------------------------------------------------------------------------------------S?SSS-----XXXX----oo-------o----------------SSSS-----SSS---------XXXX-----XXX----------------XXXX---------------------------------------------------------E----------o--------------SS---SSSSS----------XXX-----E---------------S?SSS---?----------------------------------------------------------------------------S----S--------------------------------------------------------------------SS-------SSSSSSSSSSSSSSSSSSSSSSSSSSSS----------SSS-----S-------------------------------------SSSSSSSSSSSSSSSSSSSS-QQ----------------------------------------------------SS---SSSS---------------------XXXX---XXX-------------------------S-----------------------------------------------------------------------------------SSS------SSS-----E-----------------XXXXX--------X--------------------------------------------------------------S
----------------------------------------------------XXXX-------------------------E---------------------------------------------------------------o-------------------------------------------------------------------------------------<>---<>------------------o--E--------------------------So------------------------S----------------------E----------------------------------------------------------------------------------------------------------------E--------------------------------------------------------------------------------S----------------------------------------------------------------------------------------------------------------------------------------------------------------------------XXXX-------------------XXX----------------------------------------------XXX----------------------------------------------------------------------E-----------XX----------------------------------X-----------<>------------------------------------oooo----------------------------------oo--------------------------------------------------------------------------------------------------SS----E-----------SS----------------------------------------------------------------oooo---------------------------------------------------------------------------------S-----------------------------------------------------------ooo--------------------XXXXX---E------------------------------------------------------------------------<>------------XX---------o----EXX------------------o--------------------------------------------
-----------------------------------------------------------------------------XXXXXXX-----------------------------------------------------------------X---------------------------------------------------------------------------------[]---[]-----------------XXX-XXXXX----------------------------E-------------E-----------------------------------------------------------------------E-----------------------------------------------------------------------------------------------------------------------------------------------------SS----o----------------------------------------------------------------------------------------------------------------------------------------------------------------------------------------------oo----------------------------------------------XXXX----------------------------------------X---o----------------------XXXXXXXX------------------------------------------o------------[]-----------E------------------------------------------------XX----------------XXXX------------------------------------------------------------------------S-------------------SS-------S--------SS--------------------------------------------------------------------------------------------------------------XXXX-----------------------------------S-----------------------------------------o---------------------------------------------XXXX--------------------------------------------------XSS-------------------[]---------------------------XSSX---------------------------------------------------------------
------------------------------------------------------------------------------------------------------------SSSS---E----------------------------------------------------SSSSS--------------E--------------------E----------------------[]---[]-----------------------------------------------------<>------------<>-E-----------------------SSSS--E-------------------------------E------<>-------------------------------------------------------E--S------E--?---------------E---SSSSSSS---------------------------E--------------------------SS------------------------------Q----S---------------------------------------------------------------------------------------------------------------E---------E----S--------------------E----------------------------------------------oo----------XXXXX---------------------------------------XXS-----------------------------------------------XX---------------------------------------XXX---------<>---SSS--------------E-E------------E-----------XXS----------------------------------------------------E-----------------------------------------------------------SS---------E------SS----?-----oooo------E-------------------------------E---------E-------------------------?--------------------------XXX-------XXX-----E---------oo----S-------o------------------------------------XXXXX------------------------------------------ooo---o------------------------------------------XXX--o---XXX-----------X--ooo----------------------XXX-X----------E------------------------------------------------o---
-------QQQ--QQQQ--QQQQ---<>------------XXX--XXXXX------o-------------------------------QQQQ-----------------------<>-----Q--Q--Q--Q--S----------XXXX---ooo----------------------Q---------<>-------------------<>---------E--S---------XXX--XXS---------E---SS---------ooo---------------------S---[]-------E-E--[]-XS--S?S----------------------<>------------------------------<>------[]-------------Q-Q---SQS------E--S------------------S---<>-----E--<>------?SSS-------<>------------QQ-------------E--------<>-SQS----------------------SSSS-S--------E--------------------E--------S------------------------------------o----------------X--------------X----------------------------------<>--------<>---------E---------------XXXXX---XX--------------------S-----------o---o--o--------XXXXXX----------------------X---------------XXX-SS---------------SSSS-XX-----ooo--------------------------------XXXX-SSSSS--------------------------[]----------QQ-------<>[>-----------<>----------XXX---------X---XXX----------------------QQ------------<>------------Q-----------------------------------------------So-----SSSSSS--E-SSSS--??SSSSSSSS-S----E-----QQQQ---SQS------------E--<>-----E--<>----------S?SSSSSSSSSSSSS??SS--QQ------EE-EE-E-----------------------<>-----<>------------SSSS-----XXXXXXX----------------XX-----------------XXX----------------o--XXXXX-------------------------------------X------------S-------XXXX--S----------SSS----X--------------------------XXXX-X---------<>---------------------------<>-----<>---S----E-------
-------------------------[]--------------------------------------------------------X------------------------------[]-------------------------------------E----------XX-----------------E--[]-------------------[]--------<>---------------------E------<>----------XX---EE---------XXXXX-----------[]------<><>--[]------------------X-----------[]------------------------------[]------[]---------------------------<>-----------------E-------[]----<>--[]-----------------[]--------------------------<>--------[]-S-------------------------SSS----E----<>---------<>--------<>--------------------------------------------------E--------o-XX--XXX--------EXXX------------------E-------------[]--------[]--E-----<>---------------------------------------------------------------------E-XXXXXXXX------------------------XX-----------XXXX---------SSSS--------------o----E----------------------------------E--E---------E-------------E------[]-------------------[][]-----------[]------E--XXXX-------EXX---------------------------------------E--[]--E----------------------------------X-------<>---------------E------------E---SS-----------------<>--------------------------<>--[]----<>--[]----------SSSSSSSSSSSSSSS--SSS--------XXXXXXXXXXXXXXX----------------[]-----[]------E-E-------------------------------o--E------------------------------------------------------------------------XX--------XX-------------------XXXXX-------------------<>-------------------------XXXXX-XX--------[]---------------------------[]-----[]------E<>-------
-------------------------[]----XXXXX----------------------------------------------XX------------------------------[]-------------------------------XXXXXXXX---------------------------<>--[]-------------------[]--------[]-----XXX------------<>------[]--------XXXXXXXXXX------------------------[]------[][]--[]------------------X-----------[]------------------------------[]------[]---------------------------[]----------------<>-------[]----[]------X--------------[]--------------------------[]--------[]-S-------------------------SSS---<>----[]---------[]--------[]----------------------------------------------------------XXXXE---X--------XXX-X-----------------<>-------------[]--------[]-<>-----[]-------------------XXX------EX-------------<>-----------------------<>-XXXXXXXX------------------------XXX---------XXXXX--SSS----SSQ--------------XXXXXXXX--------------------------------------E-o-Eo---------------<>------[]-------------------[][]-----------[]-----<>-XXXXXX------XXX-------XXXX---------------------------<>--[]-<>-----<>--------------------------XX-------[]--<>-----------------------<>--ESS-----------------[]--------------------------[]--[]----[]--[]----------SSSSSSSSSSSSSSS--SS----------------------------------------[]-----[]-----<><>------------------XXXX--XXX---XXXXX---------------------------------XXXXXX-------------------------------XXXX-------XXX------------------XXXXXX-------------------[]---------------------<>-XXXXXXXXXX-------[]---------------------------[]-----[]-----<>[]-------
--------E---E---E-----E--[]---------oo-----------------------------------------E-XXX------------E-------------E-E-[]------------E-E-------------------------------------------------E-[]--[]-------------E-EE--[]----E---[]--------------------[]------[]-------XXXXX------------------------E-EE--[]------[][]--[]------------------X-----------[]----E----E-EE--------------E--[]------[]--------E-E----------------[]----------------[]-------[]----[]------X--E--------E--[]------------E--E--E-EE-E--[]-E---E--[]-SE--E--E----E--EE-E-------SSX---[]-E--[]---------[]--------[]---------------------------------E---E-------------------XXXXX----X-------XXXX-X-----------------[]---E-E-E-----[]----E---[]-[]--E--[]-----------XXXXo------------XX---E----EE-E-[]-------E-E-------------[]XXXXXXXXX-----------------XXXX----------E---XXXXXX--------E---------------------------------------------------XX-XX-----------XX---------------[]------[]---------------EE--[][]-------E---[]-----[]XXXXXXX-----XXXX-------------------------ooo----------[]--[]-[]--E--[]--E---E-E-E------E---------X-------[]--[]-E---------------------[]--E-------------------[]--------------------------[]--[]----[]--[]----------SSSSSSSSSSSSSSSooSS--------E-------------------------------[]-----[]-----[][]---------ooo--------------------------------------------------------------------------E-EE---------------XXXX------XXXX-------------E---XXXXXXX--------------E-E--[]---------------------[]XXXXXXXXXXX-------[]------------------------E--[]-E-E-[]-----[][]-------
X-XXXXXXXXXXXXXXXXXXXXXXXXXX-------XXX----------------X-XXXXXXXX--XXXXX----XXXXXXXXXX-XXXXXXXXXXX--XXXXXXXXXXXXXXXXXXXXXXXXXXXXXXXXXXXXXXXXX-XXXX-----------------------XXXXXXXXXXXXXXXXX-XX---XXX---XXXXXXXXXXXXXXXXXXXXXXXXXXXXX------X----XXXXXXXXXXXXXXXXXXXXXXX------------X-------XXXXXXXXXXXXXXXXXXXXXXXXXXXXXXXXXXXXXXXXXXXX-XXXXXXXXXXXXXXXXXXXXXXXXXXXXXXXXXXXXXXXXXXXXXXXXXXXXXXXXXXXXXXXXXXXXXXXXXXXXXXXXXXXXXXXXXXXXXXX--XXXXXXXXXXXXXXXXXXX--XXX-XXXXXXXXXXXXXXXXXXXXXXXXXXX-XXXXXXXXXXXXXXXXXXXXXXXXXXXXXXXXXXXXXXXXXXXXXXXXXXXX--SSXXXXXXXXXXXXXXXXXXXXXXXXXXXXXXXXXXXXXXXXXX---XXXXXXXXXXXXXXXXXXXXXXXXXXXXXXXXXXXXXXXXXXXXXXXXXXXX---XXXXXXXXXXXX-XXXXXXXXXXXXXXXXXXXXXXXXXXXXXXXXXXXXXXXXXXXXXXXXXXXXXXXXXX----XXXX-X---------XXXXXXXXXXXXXXXXXXXXXXXXXXXXXXXXXXXXXXX----XXXXXXXXXXXXXXXXXXXXXXXXXX----XXXX-----------XX-XXXXX------XXXXXXX---XXXXXXX----------------------------XXXXXXXXXXXX---------XXXXX-XXXXXXXXXXXXXXXXXXXXXXXXXXXXXXXXXXXXXXXXXXXXXXXXXXXXXXXXXXXXXXXXXXXXXXXXXXXXXXXXXXXXX-------------------------XXXXXXXXXXXXXXXXXXXXXXXXXXXXX--XXXXXXXXXXXXXXXXXXXXXXXXXXXXXXXXXXXXXXXXXXXXXXXXXXXXXXXXXXXXXXXXXXXXXXXXXXXXXXXXXXXXXXXXXXXXXXXXXXXXXXXXXXXXXXXXX-XXXXXXXXXXXXXXXXXXXXXXXXXXXXXXXXXXXXXXXXXXXXXX-XXXXXXX----------------------------X--XXXXXXXXXXXXXXXXXXXXXXXXX--XXX----------X-----------------------------------XXXXXXXXX-----------------XXXXXXXXXXXXX--XXXXXXXXX---XXXXXXXXXXXXXXXXXXXXXXXXXXXXXXX--X-X-----XXXXXXXXXXXXXXXXXXXX---XXXXX---XXXXXXXXXXXXXXXXXXXXXXXXXXXXXXXXXXXXXXXXXXXXXXXXXXXXXXXXXXXXXXXXXXXXXXXXXXXX