------------------------------------------------------------------------------------------------------------------------------------------------------------------------------------------------------------------------------------------------------------------------------------------------------------------------------------------------------------------------------------------------------------------------------------------------------------------------------------------------------------------------------------------------------------------------------------------------------------------------------------------------------------------------------------------------------------------------------------------------------------------------------------------------------------------------------------------------------------------------------------------------------------------------------------------------------------------------------------------------------------------------------------------------------------------------------------------------------------------------------------------------------------------------------------------------------------------------------------------------------------------------------------------------------------------------------------------------------------------------------------------------------------------------------------------------------------------------------------------------------------------------------------------------------------------------
-----------------------------------------------------------------------------------------------------------------------------------------------------------------------------------------------------------------------------------------------------------------------------------------------------------------------------------------------------------------------------------------------------------------------------------------------------------------------------------------------------------------------------------------------------------------------------------------------------------------------------------------------------------------------------------------------------------------------------?SS----------------------------------------------------------------------------------------------------------------------------------------------------------------------------------------------------------------------------------------------------------------------------------------------------------------------------------------------------------------------------------------------------------------------------------------------------------------------------------------------------------------------------------------------------------------------------------------------------------------------------------------------------------------------------------------------------------------------------------------------------------------------------------------------------------------------------------------
--SSSSSSSSSSSSSSSSSSSSSSSSSS----------------------------------------------ooo-----------------------------oo------------SSSSSSSSSSSS-------------------------------------------------------------------------------------------------------------------------------------------------------------------------------------------------------------------------------------------------------------------------------------------------------------------------------------------------------------------------oo-------------------------------------------------------------------------------------------------------------------------------------------------------------------------------------------------------------SSSS------------------------------------------------------------------------------------------------------------------------------------------------------------------------------------------------------------------------------------------------------------------------------------------------------------------------------------------------------------------------SSSSSSSSSSSSSSSSSSSSS----------------------------------------------------------------------------------------------------------------------------------------------------------------------------------------------oo----------------------------------------------------------------------------------oo--------------------------------------------------------------------------------------------------------------------------------ooo--------------------
SSSSSSSSSSSSSSSSS---------------------------------------------------------XXXX--------------------------------E-------------------------------------------------------------------------------------------------------------------------------------------------------------------------------------------------------------------------------------------------------------------------------------------------------------------------------------------------------------------------------------------?-----------------------------?-----------------------------------------------------------------------------------------------------------------------------------------------------------------------------------ooSS------------------------------------------------------------------------------------------------------------------------------------------------------------------------------------------------------------------------------------------------------------------------------------------------------------------------o---------------------------------------------------------------------------------------------------------------------?-------------------------------------------------------------------------------------------------------------------------------------------XXX------------------------------------------------------------------------------------------------------------------------------------------------------------------------------Q-------------------------------------XXXX-------------------
SSSSSSSSSSSSSSSSS-------------------------------------oo---------------oo------------------------------------XXX----------------------XXX--------------------------------------------------------------------------------------------------------------------------Eooo----------------------------------------------------------------------------------------------------------------------------------------------------------------------------------------------------------------------------oooo--------------------------------------oo---------------------------------------------------------------------oo----------------oo---------------------------------E---?-------------------------------E--------------SSSS----------------------------------------------------------------------------------------------------------------------------------------------------------------------E------------------------------------E------------------------------------------------Eoooo---------------------------------------------------------------------------------------------------------------------------------------E-----------E------------------Eooo----------------------------------------------------------------------------------------------oooo----------------------------------------------------------------------------------------------------------------------Eooo----------------oo--------------------------------------------------------------------------oo-------------------------------------------------------------------
SSSSSSSSSSSSSSSSSS---------------oo--XXX------oo--------------------XX-----?------------Xoo--------Xooo----X-----------------------SS-----E------------------------------SSSS-------------Q-------------------------------------SSSSS---?S--------Q----------------XXXX---------XXX----------------S-------------------------SSSS-------------------------------XX-----------------QQQ-------------------------------------------------?------------SS----SSSSSS----SSS---?SSS---------------------XXXXX-----XXX---------------------XX---------------------------------SSSSS-------------------XX----------o-------------XX--oo----------------------------------------SQS-S??----------------------------SSSSSSSSSSSS-------SS---Q---oo----S--------SS----------?SSS-------------------------------------------?SSS---SS----------------------------------------------------------------------------SS---SS-----------------------------SQS---SSSS-----------------------------------S----XXXXX-----E-----oo------S-----------------XXSSS-------------XXXX--------------------S------SSS--------------------------------------------SSSS--------SSQSS----------------XXXXX------E----------SSS-------------------------------------SSSS----------S--------------XX-----XXXXX--------------------------------X------------XXX---------------------------------------S------------------SSSS-------XXXX-------XXXX----XXX-----SSS-------------E----?-SQ-o--SS-----------XX----------SSS----------------E------------------------------------------SS-------------------S
---------------------------------X-------XX-----------------------------------XXXX-------------------------------------------------------<>------------------------------------------------------------------------------------------------------E--ooo------------------------XXXX--------------------------------------------------E--------------------------XXSS--------------------------------------------ooo-----------------------------------------------------------------------------------------XXXX---------------X----------------------------------------------------------------------------------------------------------------------------------------------------------------------------------------------SS----------------------------------------------------------------------------------------------------------------------------------------------------------------------SS---S-----------oo-----------------------------------------------------------------------------------------XX------------ooo---------------XXXX---------------------------------------------------------------------------------------------------------------------------<>----------S-----------------------------------------------------------------------------------------------------------------------------------------------------------------------------------------------------------------------------o--XXX--------------------XXX----------------XSSSS-------------------------XXXXXX-----------ooooo----------------------SS--------------------
----------------------------------------------------------------------------------XX-----------------------------------------------------[]o----------------------------------------------------------------------------------------------------<>---------------------------XXXXXX---------------------------------------------------------------------------EXXX-----------------------------------------------------------------------------------------------------------------------------------------EXXXX-------------------------------------------------------E----------------------------------------------------------------------------------------------------------------------------------------------------S-SS---S-S--S-S---------------------------------------------------------------------------------------------------------------------------XS------------------------------SS---S-------------------------------------------------------------------------------------XXX-------------EoX-------------------------------------------------------------------------------------------------------------------------------------------------------------[]----------------------------------------------------------------------------------------------------------------------------------------------------------------------------------------------------------------------------------------------------------------oo-o---------------EXXX------------------------------------------------------------------------SS-----------------E--
---?-------------------------------------------XXX----------------------------------------------------XXX-----------------E--------------[]S-S---------------------------------------------------------E----------E-------E---------------------[]--E-----------------------XXXXXXX------------------------------E---------------------------E------oo--------XXXX--S---------------------------------------SSSSSS-----E---SSS-------S-------E-----------------X-------------------------E----------------XXXXXX------------------------------------S--------E-----E---------------------------------Q------X---------------XXXXXX------------------------------------------------------------------------------------------ooSS---SoS--SoS--------------S------------------SS------------------------------------S--------------------------------------------------XX--S------------------S-------X-SS---So--------------------------------------------------------------------------X--------------------------------------E-E------------------------------------------------------------------------------------------------------------------------------------------------[]---------oS----------------SS-S?S-S----------------------------------------------------------oo---------------------XX-X-?----------------------------------------------S------------------------------XXSSo-E-------------XXX---------------------------------------X---oo-------XXXXX--SQ---------------------------------X---------------------E------------SS-------E--------<>--
---??SS----SS-------------Q--------XXXX--XXXX---------------------XXXXXXXXX---------XX-----XXXXX--------------XX-S----E--<>--------------[]S------------X--X---------------------------Q--Q--Q--Q--Q--<>---------<>------<>--------SS--------E--[]-------------------------XXXXXXXX-----------------------------<>-------Q--QS-Q----E-------<>---o-oo-o-----XXXXXX---------X--Q----SSS-----E--S-----------------------<>--------------------<>-----E----------XX----SQS--------S--------<>----------------XXXXXX---------------XXXXX------------------------<>----<>-------Q-------------XXX-------------------------XXX--------------------------Q-----------------QS--S?SQ------------X------------------XX--X------------SSSS---SSS--SSS-------X---XX------S--------E---------------------------E---------E------------SS---XXX----------------------------------XXX-----------------------------X-SSS--SSS---Q-Q---------E---------QQQQQQ--Q-------------------------------------<>X--XX------------XXXXXXXX----S---E----<>---------------------------SSSS-XX--------------------------------------X-------------------------E-----SSS---S--Q--QQQQ--QQQ---------------S-----XX----------SS----SS-------------------------SSSS--SSQS---------E-Q--------XXXX---------------X----------------------XXX-X---------XXX----------------X----------------------E--S-----------------------XXX---------XXXXXXX--------XXX---XX----Q---------XXXX--SSS--------o--o-----XXXXXX----------S-------oo--XXX---------------------------------<>------------SS--S---<>--------[]-S
---------------------------------------------------------------------------------------------------------------------<>--[]--------------[]-------------X--XX---------XX------------------------------[]---------[]------[]-----------------<>--[]------------------------XXXXXXXXX-----------------------------[]--------------------------[]-------------EXXXXXX--------XX--------------<>--------------------------[]--E---E-------------[]----<>--------EXXX-----------E------E-----[]--------------XXXXXXXX-SS------------------------------XXX--------[]----[]-----------------------------------------------------------------------------------------------------------------X--XX----------------XXX--XX--------------------------------XX---XX--------------<>---------E----------------<>--------<>------------------------------------------E----------XXXX----------------E------------------------------------<>-------------------------------------------------------[]X-------------------------------<>----[]--------------------------E-------XX--------X--------------------------XXE----------XXXXX---------------------------------------------E-----------XX--XX------------------E----------------E-----SS------------------------------------------XXXX---------------------XXXX-XX-----------------E---------------E---------------<>-------------------X-----XXXX---X-------------------------------------------------------X-----------XXXXXXX--------------------E---------------------<>--------------[]--E-----------------[]--<>----[]-S
---------------------------------------------XX---------------------------XXXXX--------------------------------------[]--[]--------<>----[]-------------X--XXX-------XXX------------------------------[]---------[]------[]-----------------[]--[]--------------------<>-XXXXXXXXXX-----------------------------[]--------------------------[]------------XXXXXXXX-------XXXX-------------[]--------------------------[]-<>--<>-------------[]----[]--------XXXX----------<>-----<>-----[]-------------XXXXXXXXX---------------------XX------XX-------------[]----[]--<>---------------------XXXX------------------------o-----------------------------------------------------------X--XXX--------------XXXX--XXX--------XX--------------------XXXX--XX--------------[]--------<>----------------[]--------[]-----------------------------------------<>---------XXXXX---------------<>------------------------------------[]---------------------------------------<>--------------[]X------------------X-XX----E----[]----[]------------------------------E---XX-------XX-------------------------XXX-------------------------------------------------------X----<>-------E---XX---------------------<>---------------<>-----SS-----------------------------------------XXXXX--------------------XXXXX-XX---------------------E----------<>---------------[]---------------E---X----XXXXX---X------------------------XXX----------------------------X----------XXXXXXXX---------X----XXXXXXXX--------------------[]--------------[]-<>-----------------[]--[]----[]-S
-----------o------------------XXXXXX------------------------------------------------------------------------------E--[]--[]--------[]----[]-------------X--XXX----E-XXXX------------------------------[]---------[]-E----[]---------------E-XX--[]-------EE-----------[]XXXXXXXXXXX---------------E-----E-------[]------------------------E-[]-----------XXXXXXXXX--SSSSXXXXX-----EE-E----[]--------------------------[]-[]--[]------EE-E---[]-E--[]-E----XXXXXX---EE-----[]---E-[]--E--[]------------XXXXXXXXXX----------X--------------------------EE-E---[]----[]--[]------------XXXXXXXXXX--------------o--XXXXX------------------------------------------------E-E--------------X--XXXX---E--------XXXXX--XXXX------XXXE-EE-----------EE--XXXX---XX--------------[]--------[]--------E--E-E--[]--------[]-------------------------EE---------E-EE-[]-EE-E---XXXXXXX---------E----[]--------------EE--------------------[]----------E-------E---------------E----[]--------X-----[]X----------XXXXX-----------XXE--[]----[]----------------------------------XX------XXX---EE--------X-------EE-XXXX--------------------EE-------------------------E-EE----X----[]-----------XX---------------------[]---------------[]---------------E-EE----------------------------XXXXX--------------------XXXXXX-XX-------------------------XX-----[]--EE----EE-EE--[]-----E-------------X---XXXXXX---S------------------------------------------E-X----------X---------XXXXXXXXX--------XX--------------------------------[]-----------E--[]-[]-E--E---------E--[]--[]-E--[]-S
XXXXXXXXXXXXXXXXXXXXXXXXXXXXXX--XXX---------------------XXXX----X-----------------------------------------------XXXXXXX--XXX-XXXXXXXXXXXXXXXXXXXXXXXXXXXXX-XXXXXXXXXXXXXXXXXXXXXXXXXXXXXXXXXXXXXXXXXXXXXXXXXXXXXXXXXXXXXXXXXXXXXXXXXXXXXXXXXXXX-XX----XXXXXXXXXX----XXXXXXXXXXXXXXXXXXXXXXXXXXXXXXXXXXXXXXXXXXXXXXXXXXXXXXXXXXXXXXXXXXXXXXXXXXXXXXXXXXXXXXXXXXXXXS-----XXXXXXXXXXXXXXXXXXXXXXXXXXXXXXX-XXXXXXXXXXXXXXXXXXXXXXXXXXX--XXXXXXXXXXXXXXXXXXXXXXXXXXXXXXXXXXXXXXXXXXXXXXXXXXXXXXXXXXX-----XXXXXXXXXXXXX----XXX----------------------------XXXXXXXXXXXXXXXXXXXXXXXXX--XXXX-------------------------XX-----------------------------XXXXXXXXXXXXXXXXXXXXXXXX-XXXXXXXXXXXXXXX--XXXXXXXXXXX----XXXXXXXXX--XXXXXXXXXXXXXXXXXXXXXXXXXXXXXXXXXXXXX--X-XXXXXXXXXXXXXXXXXXXXXXXXXXXXXXXXXXXXXXXXXXXXXXXXXXXXXXXXXXXXXXXXXXXXX----XXXXXXXXXXXXXXXXXXXXXXXXXXXXXXXXXXXXXX-XXXXXXXXXXXXXXXXXXXXXXXXXXXXXXXXXXXXXXXXXXXXXXXXXXXXXXXXX-XXXXXXXXXXXXXXXXXXXXXXXXX-XXXXXXXXXXXXXXXXXXXXXXXXXXXX----------------------------XXXXXXXXXXXXXXXXXXXXXXXXXXXXX---XXXXXXXXXX---X-XXXXXXXXXXXXXXXXXXXXXXXX-XXXXXXXXXXXXXXXXXXXXXX------XXXXXXXXXX-XX-XXXXXXXXXXXXXXXXXXXXXXXXXXXXXXXXXXX-XXXXXX-XXXXX--XXXXXXXXXXXXXXXXXXXXXXXXXXXXXXXXXXXXX--XX---XXXXXXXXXXXXXXXX----XXXXXXXXXXXXXXXXXXXXXX--XXXXXX---XX-X--XXXXXXXXX--X-------------------X--X------XXXXXXXXXXXXXXXXXXXXXXXXXXXXXXXXXXXXXXXX--XXXXXXXXX---------------------------------X---XXXXXXXXXX--XXXXXXXXXXXXXXXXXXXXXXXXXXXXXXXXX--XXXXX----------------------------XXXXXXXXXXXXXXXXXXXXXXXXXXXXXXXXXXXXXXXXXXXXXXXXXXXXXXXX