------------------------------------------------------------------------------------------------------------------------------------------------------------------------------------------------------------------------------------------------------------------------------------------------------------------------------------------------------------------------------------------------------------------------------------------------------------------------------------------------------------------------------------------------------------------------------------------------------------------------------------------------------------------------------------------------------------------------------------------------------------------------------------------------------------------------------------------------------------------------------------------------------------------------------------------------------------------------------------------------------------------------------------------------------------------------------------------------------------------------------------------------------------------------------------------------------------------------------------------------------------------------------------------------------------------------------------------------------------------------------------------------------------------------------------------------------------------------------------------------------------------------------------------------------------------------
-----------------------------------------------------------------------------------------------------------------------------------------------------------------------------------------------------------------------------------------------------------------------------------------------------------------------------------------------------------------------------------------------------------------------------------------------------------------------------------------------------------------------------------------------------------------------------------------------------------------------------------------------------------------------------------------------------------------------------------------------------------------------------------------------------------------------------------------------------------------XX-----------------------------------------------------------------------------------------------------------------------------------------------------------------------------------------------------------------------------------------------------------------------------------------------------------------------------------------------------------------------------------------------------------------------------------------------------------------------------------------------------------------------------------------------------------------------------------------------------------------------------------------------------------------------------------------------------
SSSSSSSSSSSSSSSSSSSSSSSSSSSS-------------------------------------------------------------------------------------------------------------------------------------------------------------------------------------------------------------------------------------------------------------------------------------------------------------------------------------------------------------------------------------------------------------------------------------------------------------------------------------------------------------oo-------------------------------------SSSSSSSSSSSSSSSSSSS-SSSSSSSS--------------------------------------------------------------------------------------------------------------------------------------------------------------------------------------------------------oo----------------------SSSSSSSSSSSSSSSSSSSSSX----S-------------------------------------------------------------------------------------------------------------------------------------------------------------------------------------------------------------------------------------------------------------------------------------------------------------------------------------------------------------------------------------------------------------------------------------------------------------------------------------------------------------------------------------------------------------------------------------oo----------------------------------------------------------------------------------------------------------
---------------SSSSSS--SSSS---------------------------------------------------------------------------------------------------------------------o-----------------------------------------------------------------------------------------------------------------------------------------------------------------------------------------------------------------------------------------------------------------------------------------------------------------------------------------------------------------------------------------------------------o------------------------------------------------------------------------------------------------------------------------------?Q----------------------------------------------------------------------------------------------------------------------XXXX-----------------------------------------------------------------------------------------------------------------------------------------------------------------------------------------------------------------------------------------------------------------------------------------------------------------------------------------------------------------------------------------------------------------------------------------------------------------------------------------------------------------------------------------------------------------------------------------------------------------------------------------E--E----------------------------------------------------------------------------------------------------
---------------SSSSSS--SSSS----------------------------------------------------------------------------------------------------------------------------------------------------------------------------------------------------------------------------------------------------------------------------------------------------------------------------------------------------------o------------------------------------------------------------------------------------------------------------------------------------------------------------------------------E----------o---------------------------------------------------------------------------------------------o------------------------------------------------------oo---o-------oo---------------------------------------------------------------------------------------------------------------------------------------------------------------------------------------------------------------------------E-oE-----------------------------------------------------------------------------------------------------------------------------------------------------------------------------------------------oo--oo---------------------------------------------------------------E--------------------------------------------------------------------------------------------------------------------------------------------------------------------------------------------------------XXXXXXX--------------------------------------------------------------------------------------------------
---QQ--------------S----SSS-----------------------Q-Q-----------S---------------------------------------S--SSSSS--------------------------SS--SSS---?--------------------------SS------------XX---------------------------------------------------------------------------------XXX--------------------------------------------------------SSSSS-----------------------------------XXXX---------------------------------------------SSSSS------------SSS-?------QQ--------------------Q-Q--------------SSS----XX----------------XX-----------XX---------oo----XXX------o-----------------------------S-----------------SS----SSSSSS-SSSS---------------------X--------------XXXX-------XXX--------------------E-------------oo-----------XXX------------XX-----E--------oo----------SSSS-------------SSSS?---------S-----------------------S-S---------------------SS-----E--E-----------------------------E--SS--------------------------------------------------------------XXXXX------------------------------------------------------------------------SSS-----------------------?-SS----------------------------------------SSS----------------------------o-----------XX---------------------------------------S--------------------------------E--E--------------------SX----------------------------------------------------------------------------------------SSS---------------------------------SSSSSSSSSS--------------------------------------------------------------SSSS-------------SSSSSSS----------------------------X----------SS------------------S
------------------------------------------------------------------------------------------------------------------E---------------------------------------------------------------------------X----------------------------------------oooo-------------------------------------XXX----------------------oo------------------------------------------------------------------------------o----ESX------------------------------------------------------------------------------------------------------------XXX----------------------------XXX-------XXX----------------XXX---X-----------------------------------------------------------------------------XX--------XXX-------------XXX-------X-----------<>---------------------------XX------------------XXXXXX----------------------------------------------E---------------------------------------------------------XXXXXX------------------------<>-----------------------------------------------X---------------------------------------------------------------oo--------------------------------------------------------------------------------------------------------------o------------------------------------SSS---------------------------------------------------------------------XXXXXX-------------------------------------------------E----------------------------------------------------------------------------------------------------------------------------------------------------------oooo---------------------------------------------------------XX-------------------------------
--------------------------S-----------------------------------------E-----------------------------------S--------<>---------------X-----------------------------------------oo---------------XXS---o--------------------------------------------------------X-----------------XXXXX----------------------------------------------------------------------------------------------------------<>S--------------------------------------------------------------------------------------------XX---------------XXX--------------------------XXXXX-----------------------------------------------X-----------------------------------------------------------XXXXX----------------------XXXXX-------------------[]-------------------------------------------------------------------------------------------------------------------------------------------------------------------------------X--------E--[]----------------------------------------------XX-------------------------------------------------------------------------------------------------------------------------------------------------------------------------------------------------------------------XX----------------------------------XS----------------------------------------------------------------------------------------XXXXXXXX------------------------------------------------------------------------------------------------o---------------------------------------------------------------------------------------------------------------X--X-------------------------------
------------------------ooS-------------------------------E--------<>---------------------E-------------S--------[]--------------------------SSSS----------E----SSSSSSS---------------------XXXX-S--SQSSSSS-------------S----------------------------E------------------------XXXXX------------------------------o----------------E----------------------------------------------------------[>S-----------------------E-------------------E-------------------------------o-------------------------E-------XXX--------------------------XXXXX------------------------XXXX----------------XX-X--X------------------------------------------------------S--XXXX-----Q---------------XXXXXS-----------------X-[]--------------------------------------------------------------o-------E-----SSSS------------------SQ-------------------------------SS-----ooo---------------------------------XXX--E---<>--XXX--------------------------------------------XXX-------------------------oo----------------E---------------E--S?S----------S--------S-------------------------------------------------E---------------------------------------------------E---------XX-SoS--------XXX-S-------------------------------XX--oo------------------------------------------------------------------------------XX--o------------------------------oo-------------------------------------------------------------------------------------------------------------S--E-------------------------------------------------------------------------XXXX-------------------------------
--S?S-------------------SSS----------------------E?QQQ---<>--------[]-------E------------<>-------------S--SSSS--[]---------------XX-------------EE-------<>--------------------S-----------XXXX-SS----------------------------X----<>-----------E--<>---S---------X----------XXXX-----------------------------------------------<>-----------S----E---------E--SSS--------------------------XXXXX-----------E---E----<>-----QQQQ------E--<>--------XXX--SSS----QQQQ-----------------QQQQ-------QQQ---------XXXX--------------------------XXXXX-----------XX----XXXX-------------oo-------XXX-XXXX-------------Q--------X--X------------------------------XXXXX--------------------EXXXXXX-------------------XXX--XXXXXXX------------XXX-----XX--------------------XX---------------SSS-------------SSS----S-------------------E--S------ESSS----------E-----------SSSS-X-------------------XXXX-<>---[]-----QQQ----------------------------------------XXXXQQQ------------E--------------------------<>-----------X--<>------------------E--------QQQQ-------------Xo---S----QQQQQ--Q-Q---------<>---Q--------------SQS-----------------------------<>---------------o-------XX-----------X---------------------XXX---------E--EE-E----------------X---------------------XX-XX----------------------XX--------------------------------------------S------X--X---------SQS------X--XX-------------------------SSS--SSS----E----------------------------Q--<>-----E-------E----------S------E--S-----------------E------------------XXXXXX----------SS--------S--So------
---------------------------------------------------------[]--------[]------<>------------[]---------------EE-----[]---------------X-----------------------[]------------------------------XXXXXX-------------------E----------XX----[]----------<>--[]--------X---------------XXXX---------------------------------------E-------[]-----<>--------<>--------<>----------XXX-----------------XXXXXXX---------<>--<>----[]--------------<>--[]----------------------------------------------------------------XXXX----------X---------------XXXX-------------------------------------------XXXX-XXXX--------------------XXX--XX-----E--E------------E-------XXXXX-------------------XXXXXXXX--SS--------------------------------------------------------------------------------------------------------------------------------<>--------<>SSS---E-----<>----------------X------------------XXXXX-[]---[]---------------------E------------------------XXXXXX-----XXX-?----<>--------------------------[]--E-------XX--[]-----------------<>-------------------------X----------------------------[]--E------X----------------------------------E-----[]----------------------XX-----------XX-----XXXX?----------XXXX-------XXXXXXXXXXXX-------------X---------------------XX-XXX--------------------XXX--------------------------------------------------XX--XX----------------XX--XX-------------XXXX-------------------<>-------------------------------[]----<>-----E<>----------------<>--------------------E-----X------------XXXXXX-------------------------------
--------------------------------X------------------------[]--------[]------[]------------[]--<>------------------[]-------------X-XX----------------------[]------------X----------------XXXXXXX--SS--------------<>---------XXX----[]----------[]--[]--------X---------------XXXX-------------------------E------------<>-------[]-----[]--------[]--------[]-----------------------------XXXXXXXX---------[]--[]----[]--------------[]--[]----------------------------------------------------------------XXXX----------X---------------XXXX-----------------------XX-----------------XXXXX-XXXX-------------------XXXX--XXX------------------------E---XXXXX------------------XXXXXXXXX---------XXXX----------------------------------o------------------------------------------------------------------------------------[]--------[]SSS--<>-----[]----------------X-----------------XXXXXX-[]---[]--------------------<>-----------------------XXXXXXX--------------[]--------------------------[]-<>------XXX--[]-----------------[]-------------------------X----------------------------[]-<>------XX--------------------------------<>-----[]---------------------XXXXX--------XXX-------------------XXXXX-----------------------E--------X-------------------X-XX--XX-----------XXX-----XXXX-------------------------------------------------XXX--XXXX-------------XXX--XXX-----------X-XXX-------------------[]-------------------------------[]----[]----<>[]----------------[]--E------------------------------------XXXXXX-------------------------------
------------------------E----E--X------------------------[]--------[]------[]---------E--[]--[]---E---------E-E--[]---------E-EE--XX---------E------------[]------E-E-----E--E-E-----E---XXXXXXX--S---------------[]--------XXXX-E--[]----EE-E--[]--[]--------------------E---XXXX---E-E-------------------X---------E--[]-------[]-----[]--------[]-----E--[]---------------------------EXXXXXXXXX---------[]--[]----[]--------------[]--[]----------------------------------------------------------------XXXX-------X--X-----------E---XXXX----------------------------------E------XXXXXX-XXXX------------------XXXXX--XXXX---------------------------XXXXX--------ooo----XXXXXXXXXXXX----------------------------------------X-----XXX------------------------------------------------------------------------E--E-EE-E--[]-E------[]SSS--[]-----[]-------E--------X-------E---------XXXXXX-[]---[]----E---------------[]--------EE--------E----XXXXXXX--------------[]---------------EE-E-------[]-[]-----XXXX--[]-------------E---XXX--E--------------E------X-----------E-E--------E-----[]-[]------XX------E--E--EE------EE----------[]-----[]--------------------XXXXX---SS?SSXXXX------------------XXXXXX--------------------------------X----E-E--E-EE-EE-E---XX--XX------------------XXXXX---------------------E--------------------------XXXXE-XXXX-E----------XXXX--XXX-------------XXX------E------------[]------E-E----------------------[]----[]----[][]----------E-----[]E--E----------------o------------------XXXXXX-----EE-E-E----E--E------------
XXXXXXXXXX----XXXXXXXXXXXXXXXXXXXXXXXXXXXXXXXXXXXXXXXXXXXXXXXXXXXXXXXXXXXXXXXXXXXXXXXXXXXXXXXXXXXXXXXXXXXXXXXXXX-XXXXXXXXXXXXXXXX-XXXXXXXXXXXXXXXXXXXXXXXXXXXXXXXXXXXXXXXXXXXXXXXXXXXXXXXXXXXXX--XXXXXX---------XXXXX---XXXXXXXSXXXXXXXXXXXXXXXXXXXXXXXXXXXXXXX---XXXXXXXXXXXXXXXXXXXXXXXXXXXXXXXXXXXXXXX--XXXX-XXXXXXXXXXXXXXXXXXXXXXXXXXXXXXXXXXXXXXXXXXXXXXXXXXXXXXXX----XXX-X---XXXXXXXXXXXXXXXXXXXXXXXXXXXXXXXXXXXXXXXXXXXXX---XXXXXXXXXXXXXXXXX----XXXXXXXXXXX--XXXXX---XXXXXXXXXXX---XX--XXXXXXX--XXXXXXXXXXXXXXX-XX---XXXXXXXXXXXXXXXXXXXXXX--------XXX-----------------XXXXXXXXXXXXXXXXXXXXXXXXXXXXXXXXXXXXXXXXX--XXXXXXXXXXXX-XX-XX-XX-XXXX-XXXXXXXXXXXXXX---XXX--X-XXXXXXXXXXXXXXXXXX----------------------------XXX---------------------------------XX--XXXXXXX-----X-X-XXXXXXXXXXXXXXXXXXX--XXXXXXXXXXXXXXXXXXXXXXXXXXXXXX-SSSXXXXXXXXXXXXXXXXXXXXXXXXXXXXX----XXXXXXXXXXXXXXXXXXXXXXXXXXXXXXXXXXXXX----XXXXXXXXXXX--XXXXXXXXXXXX-XXXXXXXXXXXXXXXXX-----XXXXXXXXXXXXXXX----XXXXXXXXXXXXXXXXXXXXXXXXXXXXXXXXXXXXXXXXXXXXXXXXXXXXXXXXXXXXXXXXXXXXXXXXXXXXXXXXXXXXXXXXXXXXXXXXXXXXXXXXXXXXXXXXXXXXXXXXXXXXXXXXXXXXXXXXXXXXXXXXXX--XXXXXXXXXXXXXXXXXXXXXXXX-XXXXXXXXXX-----Q-ESXXSXXXXX-----XXXXX-XXXXXXXX--------------------------XX-XXXXX--XXXXXXXXXXXXXXXXXXXXXXXXX-XXXXXXXXX------XXXXXX------XXXXXXXXX--XXXXXXXXXXXXX----X---XXXX-XXXXXXXXXXXXXXXXXXXXXXXXXXXXXXXXEoXXXXXXXXXXXXXXXXXXXXXXXXXXXXXXXXXXXXXXXXX-XXXXXXXXXXX---XXXXXXXXXXX--XXXXXXXXXXXXXXXXXXXXXXXXX-XXXXXXXXXXXXXXXXXXXXXXXXXXXX-XXXXXX-----XXXXXXXXXXXXXXXXXXXXXXXXXXXXXXXXXXXXXXXXXXXXXX