-----------------------------------------------------------------------------------------------oXEXo-S------------------------------------------------------------------------------------------------------------------------------------------------------------------------------------------------------------------------------------------------------------------------------------------------------------------------------------------------------------------------------------------------------------------------------------------------------------------------------------------------------------------------------------------------------------------------------------------------------------------------------------------------------------------------------------------------------------------------------------------------------------------------------------------------------------------------------------------------------------------------------------------------------------------------------------------------------------------------------------------------------------------------------------------------------------------------------------------------------------------------------------------------------------------------------------------------------------------------------------------------------------------------------------------------------------------------------------------------------------------------------------------------------------------------------------------------------------------
------------------------------------------------------------------------------------------X--X-XSS-XXX-S----------------------------------------------------------------------------------------------------------------------------------------------------------------------------------------------------------------------------------------------------------------------------------------------------------------------------------------------------------------------------------------------------------------------------------------------------------------------------------------------------------------------------------------------------------------------------------------------------------------------------------------------------------------------------------------------------------------------------------------------------------------------------------------------------------------------------------------------------------------------------------------------------------------------------------------------------------------------------------------------------------------------------------------------------------------------------------------------------------------------------------------------------------------------------------------------------------------------------------------------------------------------------------------------------------------------------------------------------------------------------------------------------------------------------------------------------------------
-----------------------------------------------------------------------------------------------------S--------------------------oo--------------------------------------SSSSSSSSSSSSSSSSSSSSSSSSSSSS------------------------------------------------o-----------------------------------------------------------------------------------------------------------------------------------------------------------------------------------------------------------------------------------------------------------------------------------------------------------------------------------------------------------------------------------------------------------------------------------------------------------------------------------------ooo---------------------------------------------------------------------------------------------------------------------------------------------oo----------------------------------------------------------------oo--------------------------------------------------SSSSSSSSSSSSSSSSSSSSSSSSSSSS--------------oooo--------E----------------------------------o-----------------------------------------------------------------------------------------------------------------------------------------------------------------------------------------------------------------------------------------------------------------------------------------------------------o----------------------------------------------------------------------------------------------------------------------------------------------
-------------------------------------------------------------------------------------------X------XXX-------X-X--------------------------------------------------------------------SSSSSSSSSSSSSSSSS-----------------------------------------------XXX----------------------------------------------------------------------------------------------------------------------------------------------------------------------------------------------------------------------------------------------------------------------------------------------------------------------------------------------------------------------------------------------------------------------------------------------------------------------------------------XXXX------------------------------------------------------------------------------------------------------------------------------------------------E-----------------------------------------------------------------E--E------------------------ooo-------------------SSSS---S--SSS-SSSSSS--SSSS--------------XXXXX---o--E--------------------------------------E--E-------------------------------------------------------------------------------------------------------------------------------------------------------------------------------------------------------------------------------------------------------------------------------------------------X----oo--------------------------------------------------------------------------------------------------------------------------------------------
--------------------------------------------------------oooo----------------------------o--------XXX-X---X-------------Eoo----------------------------------------------o----------SSSSSSSSSSSSSSSSS---------------------o--------------------------------------------------------------------------------------------------------------------------------------------------------------------------------------------------------------------------------------------------------------------------------------------------------------------------------------------------------------------------------------------------------E---------------------------------------------------------------------------------------------------------------------------------------------------------------------------------------------------------------------------------------XX--------oooooooooo-----X-------------oo--oo--oo-----E----------------------------------XXXXXXX--------------------------------------------SSSS--E---SSS-SSSSSS--SSSS---------------------XXXXXX-E----------------------------------XXXXXXX-------------------------------------------------------------------E---------------------------------------------------------------------------------------------------------------------------------------------------------------------------------------------------------------------------------------------------------------------------------------------------------------------------------------------oo---X---E-----------------------
--------------------XXX------SSS-------------------------XXXX------------o-------------XXXX----------------------------XXXX------XX--------------------SSS--SSSSSS-----------------SSSSSSSSSSSSSSSSS------------------XXXXX-----S?SS-------SSS------------------------SSSS--------------SSSSS---?------------?---S-----------------SQSSSS?------?SSSS---?--SSSS---------------------------------S---SSSS-------------------------?---------?SSSS----------------SSSSS----------------SSSS-------------------------------------S--------------------SSSSS----------------SSSSS---------------------S------SSSSSSS-------E----------E--E--?SSS---QQQ-------------------------XXXX----------XXX--------------------------------S------SSQ---------------------------------------------------------------SSSSS--------SS-----------------SSS----SSQQQS------SSSSSSSSSSSSS--------XXX-----XX------------E-----oo---XXX---------------SS--SQS---------------SSSSSS---------------------------------ooo--XXXX---ooo-----------S----S---S-------SS-----S-------XXXX-------XX--------SS--SSS----SSS--XX--------------------------------------------------------------SS-----S----S--------------SSSSS------S--------------------SSSS------SSS-----E--?-----------------------------------------------------SSSSS--SS------------------------------------------------------------------------SSSSSSS----------------------E----XXX--------------------------------------------------------------------------------------SQ-----------------------XXX-----SQQ----------------------
-------------oo---XXXXX------------------------------------------------------------------------------XXX-------------------------XX---------------------------------------------------------------------------------------------------------------------------------------------------------------------------------------------------------------------------------------XX------------------------------------------------------------------------------------------------------------------------------------------------------------------------SS----------------------------------------------------------------<>------------XXX-------------------------------------------------XXXX-----------------------X------------------------------XX------------------------------------------------------------------------------------------------------------------------------------XX------------------------SSS-----------S--------------------------------------------ooo--------XX--XXX------------------XXX--ES-<>-S---S-------SS-----S-------------o----XXSSS---------------------XX------------EE-------------ooo--------------------------------SS---------------ooo--------------------------------------------------------<>-----XXX----------------XX------------------------------------------------------------------------------------------------------------------------------------------------XXXX------------------------------------------------------------------------------------------------------------------------------------------------
-----------------XXXXXX--------------------------------------------------------------------XX-X---------------------------------XXXX---------------------------------------------------------------------------------------------------------------------------------------------------------------------------E--------------------------------------------------------ooo---------------------S----------------------------------------------------------------------------------------------------------------------------------------------------S----------------------------------------------------------------[]---------------------------------------------------------------XXXXS-----------------------X---------------------------------------------------------E-----------------------------------------------------E-------------------------------------------------------------X-X--------------------------------------------------------------------------------------------------------------o--SSS-[]-S---S-------SS----SS------------------XXX----------------------XXX---------------------------------------------------------------S--------------------X-----------------------------------------------------[]-------------------------------------------------------------------------------------------------------------------------------------------------------------------------XXXXS---------X--------------------------------------------------------------------------E--------------------------------S-S------------------------
-o---oo---------XXXXXXX--------------------E--S------------------XXX------------------------------XXX---------XX----------------XXX----------------------------------------------------oooooooooo--------------o--------------------------------------------------------------------------SS------------------------S--------E------------------S-SS-----------S-------------------------oo-----S---Q----------------------S-------------S---------------------------------------------------------------------------------------------E-----------XSS--------E-----------E-------------------------------------------[]--------------------------------------------------------------XXXXX----------------------S-------------------------------------------E---------------E-------------------------------------------E-----E--<>-SQ----------------------------E------------------------------------------------------------E--------------------SSSSS-----------------E-------------------------------------------So[]-----?oooooooSS--QoSS--E---------------XXX-------------------X----X-----oo----SQSQ-----------------------------------E-E---------SS--------------------X------------------------E--------------SX------------[]-------------------------------------------------E-E--------------------------------------------------------------------E-----------------------------------------------XXXXX-------------oo---------------------------------E-----SSS------------S-----------E--<>------------------------------X---S---------------------S--
---------------XXXXXXXX------QQ?----------<>------------XXX----------XXX----XXXXXX--XX------E----------------------------------XXXX---------------------Q------S-----------------------?SSSSSSSSSS------------------XXX--SXS-------Q--QQQ------E---------------QQQQ--QQQ--------E------------Q--Q--Q-----Q---S?S------------<>----E?QQQ--QQQQ------S?S---------XXX--SSS-----Q---S-S----E-----------SSSS-----------------------E--S---<>-----E--S--------E---------S---------E----Q---S-------S--------E--XX-XX---------X------S-------<>----------XXSS-------<>XX-X-------S-S------------------------S?S--------------XXXX----XXX-------QQ--Q-QQQQ--QQQQ--Q---------------X----------XXXXXX--------------------XXX--------------------Q----XXXX-------------<>--------------<>----------------E---SSSSSSSSS----X--S-----<>----<>--[]--------E?SSSS-------------SSSSSSS---------XXXXX-----------------------XXXX---XXX-----------XS--S?S-----------------------------------<>---------E---------XXXX-XXXX----XXX--------SS[]-S---??SSSSSSSS--SSSS-<>-------------X-XXX-------o---S?S----XXX-XXX----o--------------------E---------E-------------------X--X---SSSSQ--------<>-------X--------S--Q---S?S-----<>---------XXX---------S?S----XXX----------------XXXXX--------XXXXX--------------XX--XX---SSS-----X--------------------------S-----------E-------------<>-----------<>----QQ?--QQ----------XXX----------XXXXX---------XX----------------------QQ------------<>------------------------E------<>--[]-----------------------------XX--ESSS-----------QQ---------
--------------XXXXXXXXX-------------------[]-------------------------------------------XXXXXXXXXXXX------------X--------------XXXXX-----------------------------------------------------------------------------------------------------------<>-------------------------------<>----------------------------------X--------[]-----------------------------EXXX------------X----------<>----------EE-------------------------<>------[]----<>----------<>------X----------X---------------------------E--XX-XX-------EXX--------------[]---------XXX---------[]XX-XX-----E----------E------E----------------------------------------E-----------------------------------------------XXXXXXX-------------------XXXX------------------------------------------[]----E-E---S---[]--E------------<>---------------EX--------[]----[]--[]------------------XX--------E-----------------------------------------------------E------o------------------------E-------------------[]--------<>-----------------------------------[]--X-------------------[]-------------XXXXX-----------------XXXX-XXX------------------------<>--------<>-S----------X------X--XX-----S---------[]------XX-----------------------[]--------EXXX-----------------------------------------------------------------XXXX---X-----------S-------------------------------------<>-------------[]-----------[]-----------------XXX-------------XXXXXX--------XX-------------------------------------[]-----------------E-----<>-E----[]--[]-----------------------------XX----------------------------
----------<>-XXXXXXXXXX-------------------[]---------------------------------------------------------------------------------XXXXXX-----------------------------------------------------------------------------------------------------------[]-------------------------------[]------X---------------------------X--------<>-----------------------------XXXX-----------XX----------[]-------------------------------------[]------[]----[]----------[]------X------<>---X-----------E---X---------<>--XX-XX-------XXX--------------[]--------XXXX--------X[]XX-XXX--------------<>-----<>---------------XXXXXXXX----------------<>----------------------------------------------XXXXXXXX---------------<>-XXXXX-----------------------------------<>-----[]---<><>-------[]-<>------------[]--------------<>X--------[]----[]--[]-----------------XXXX--X------------------------------XXXX------------------------XXXX--XXXX---------------------<>-------------------[]--------[]-----------------------------------EX--XXX-----------------[]-----------XXXXXXX----------------XXXXX-XXX------------------------[]--------[]-----------XXX---X-X--XX----SS-----X---[]-----X-X-----------------------[]------EX-XXX---------------------------X------------------------------------XXXXX---X-X--------XX---------------------------X---------[]-------------[]-----------[]---------------X--XX------------XXXXXXX--------XXX------------------------------------[]---------X------<>-----[]<>----[]--[]---------------------------XXXX----------------------------
----------[]XXXXXXXXXXX-------------------[]------------------------------------------------------------------------------------XXX---------E--------EE-E-------------XX---EE-E--------------E---------------------------------X--------------[]---------------------E---------[]-E-E--X----------------------E----X--------[]-----------EE-E------------XXXXX---S-------XXX---E-EE---[]---------------------E-EE-----E-EE---[]-E----[]----[]-----E----[]------X-EE---[]------------------XX---E-----[]--XXXXX------XXXX-E-E-------E--[]-------XXXXXE------XX[]X--XXXX-------------[]-E---[]-------E------XX---------o-------------[]-------------------E-E-----------------------XXXXXXXXX---------------[]-XXX-X------EE---------------------------[]-----[]---[][]----E--[]-[]------------[]--------------[]X-EE-----[]----[]--[]----------------XX-X-E-X-------------XXXXXX------------------------ooo----XXXX--------------EE-E-------E--E------[]------E-E-------E--[]-----E--[]-S----ooo--------------------------XX--XXX--------E-E------[]-----------E--XXXX------X--------XXXXXX-XXX--------XX-E-E-----E-E--[]--------[]----------XXXX-E-X-X--X----E--E-EE-X---[]---E---X----EE-E------------E--[]-E----XX-XXX---------o------------E--E-X-XXX-------------------------------XXXXXX---X-X-------XXX------E--E-E---------------X---EE-E--[]-------------[]--E-EE-E-X-[]-E-------EE---XX-XXX----------XXXXXXXXX-----XE-XXX----EE-----E------E-EE--------------[]---------X------[]-----[][]----[]--[]--------------------------XXXXX-E-----------E-------EE-E---
XXXXX---XXXXXXXXXXXXXXXXXXXXXXXXXXXXXXXXXXXXXXXXXXXXXXXX--------------------------------------------------------XXXX----X-XXXXXXXXXXXXXXXXXXX--XXXXXXXXXXXXXXXXXXXXXXXXXXXXXXXXXXXXXXXXXXXXXXXXXXXXXXXXXXXXXXX--XXXX-XXXXXXX----XXXXXXXXXXXXXXXXXXXXXXXXX---X---XXXXXXXXXX-XXXXXXXXXXXXXXXXXXXXXXXXX-----XXXXXXXXXXXXXXXXXXXXXXXXXXXXXXXXXXXXXXXXXXXXXXXXXXXXX---X---XXXXXXXXXXXXXXXXXXXXXXXXXXXXXXXXXXXXXXXXXXXXXXXXXXXXXXXXXXXXXXXXXXXXXXXXXXXXXXXXXXXXXXXXX-XXXXXXXXXXXXXXXXXXXXXXXXXXXXXXXXXXXXXXXXXXXXXXXXXXXXXXXXXXXXXXXXXXXXXXXXXXXXXXXXXXXXXXXXXXXXXXXXXXXXXXXXXXXXXXX-XXXXXXXXXXXXXXXXXXXXXXXXXXXXX------------------XXXXXXXXXXXXXXXXXXXXXXXXXXXXXXXXXXXXXX-XXXX---XXXXXXXXXXXXXXXXXXXXXXXX----XXXXXXX--XXXXXXXXXXX---XXX-XXXXX-----------XXXXXXXXXXXXXXXXXXXXXXXX-XXXXXXXXXXXXXXXXXXXXXXXXXXXXXXXXXXXXXXXXXXXXXXXXXXXXXXXXXXXXXXXXXXXXXXXXXXXXXXXXXXXXXXXXX----------------------------------XXX----------------------XXXXXXXXXXXXXXXXXXXXXXXXXXXXXXXXXXXXXXXXXXXXXXXXXXXXXXXX----XXX-----------------------XXXXX--XXXXXXXXXXXXXXXXXXXXXXXXXXXXXXXXXXXXXXXXXXXXXXXXXXXXXXXXXXXXE-XXXXXXXXXXXXXXXXXXXXXXXXXXXXXXXXXXXXXXXXXX-X-XXXXXXXXXEXXXXXXXXXXXXXXXXXXXXXXXXXXXXXXXXXXXXXXXXXXXXXXXXXXXXXXXXXXXXXXXXXXXXXX---XXXXXXX--------XXXXXXXXXX----------------------------XXXXXXXXXXXXXXXXXXXXXXXXXXXXX--EXXXXXXXXX--XXXXXX--XXXXXXXXXXXXXXXXXXXXXXXXXXXXXXXXXXXXXXXXXXXXXXXXXXXXXXXXXXXXX-XX------XXXXXXXXXXXXXXXXXXXXXXXXXXXX-XXXXXXXXXXXXXXXXXXXXXXXXXXXXXXXXXXXXXXXXXXXXXXXXXXXXXXXXXXXXXXX--XX--XX--XXXXXXXXXXXXXXXXXXXXXXXXXXXXXXXXXXXXXXXXXXXXXXXXXXXXXXXXX