------------------------------------------------------------------------------------------------------------------------------------------------------------------------------------------------------------------------------------------------------------------------------------------------------------------------------------------------------------------------------------------------------------------------------------------------------------------------------------------------------------------------------------------------------------------------------------------------------------------------------------------------------------------------------------------------------------------------------------------------------------------------------------------------------------------------------------------------------------------------------------------------------------------------------------------------------------------------------------------------------------------------------------------------------------------------------------------------------------------------------------------------------------------------------------------------------------------------------------------------------------------------------------------------------------------------------------------------------------------------------------------------------------------------------------------------------------------------------------------------------------------------------------------------------------------------
------------------------------------------------------------------------------------------------------------------------------------------------------------------------------------------------------------------------------------------------------------------------------------------------------------------------------------------------------------------------------------------------------------------------------------------------------------------------------------------------------------------------------------------------------------------------------------------------------------------------------------------------------------------------------------------------------------------------------------------------------------------------------------------------------------------------------------------------------------------------------------------------------------------------------------------------------------------------------------------------------------------------------------------------------------------------------------------------------------------------------------------------------------------------------------------------------------------------------------------------------------------------------------------------------------------------------------------------------------------------------------------------------------------------------------------------------------------------------------------------------------------------------------------------------------------------
--------------------------------------------------------SSSSSSSSSSSSSSSSSSSSSSSSSSSSSSSSSSSSSSSSSSSSSSS-------------------------------------SSSSSSSSSSSSSSSSSSSSSSSSSSSS-------SSSSS-S-------------------------------------------------------------------------------------------------------------------------------S-S--SSSSSSSSSSSS-----SSSSS------------------------------------------------------------------------------------S-----------SS------------------------------------------------------------------------------------------------------------------------------------------------------------------------------------------------------------------------------------------------------------------------------------------------------------------------------------------------------------------------------------------------------------------------------------------------------------------------------------------------------------------------------------------------------------------SSSSSSSSSS--------S-SSSSSSSS--------------------------------------------------------SSSSSSSSSSSSSSSSSSSSSSSSSSSS------------------------------------------------------------------------------------------------------------------------------------------------------------------------------------------------------------------------------------------------------------------------------------------------------------------------------------------------------------------------------------------------------------------------------------
----------------------------------------------------------------------------------------------------------------------Q-------------------------------------------SSSS-S--------------------------------------------------------------------------------------------oo-------------------------------------------------S------------SS--------oS---o---------------------------------------------------------------------------------------------------------------------------------------------------------------------------------------------------------------------------------------------------------------------------------------------------------------------------------------------------------------------------------------------------------------------------------------------------------------------------------------------------------------------------------------------------------oo-------------------------------------------------------------------------------------------------------------------------SSSSS-SS------------------------------------------------------------------------------------------------------------------------------------------------------------------------------------------------------------------------------------------------------------------------------------------------------------------------------------------------------------------------------------------------------------------------------------------------------------------------------------------------------------------------
-----------------------------------------------------------------------------------------------------------------------------------------ooo----------------------SSSS------------------------------------------------E------------------------------------------------------------------------------E----------------SS------------SS-------------------------------------------------------------------------------------------------------------------------------------------------------------------------------------------------------------------------------------------------------------------------------------------oo---------------------------------E-------------------------------------------------------------------------------------------------------------------------------------------------------------------------------------------------------------------------------------------------------------------------------------------------------------------------------------------------------------------SSSSSSSS--------------------------------E----------------------------------------------------------------------------------------------------------------------------------------------------------------------------------------------------------------------------------Eooo------------------------------------------------------------------------------------------------------------------E----------------------------------------------------------------------o----------oooooo---------------------------------------
---------------------------------------------------XXX----------------------------------------------------------SSS----E--E------E----XX-------------------------SSSSSSS---------------------------------------------SQSSSSSS---S?SSS---?SSSS---------------------oo--XXX----------------------------E--E-E----------SS-Q--SS---------------SSSo-SSS--S--------------SSSS---S-----------S--S-S---?----------------------------SS------SQQ-----------------------------------------SSSSSSSSQ-------S------------------------S-----------------------------------------------------------------------E----------------------------------------------------------------S-----S------------------SSS-QQS---------------------------------------------SSSS----SQSQ-----------------------------------QQQQ---------------SQS-----SS--------?QQQ---------SQ-------------------S------------------S?SSS-----S-S--------XXX------ooo-----------------------------------------------------------------SQS------------------------S-----------SSSSSSSSSSSSS-----E--S------------------------S----QQQS---------------------------------------------------------------------S----------------------------SS---------------------SSSSSSSS--------------------------------------------------------------QQQ-----------------------XXXXX----XXX-------------SQS----------------SSSSS-------XXX------------------------S--------------------------------SSSSSSSSSSS------QSSS---SS--SSSS------QQQQ----------------------------?--XX------------------------------------------------------
-----------------------------------------oo-------XXXX-------------------------------------------------------------------XXX----<>--------------------------------------------------------------------------------------------------X-----------------------XXXX-XX--------------------X---------------XXXXXX-------------------------------SSS-E----------------oo---------------------------------------------------------------------------------------------------------------------------------------------------------------------SSS-----------------------------------------------<>---------XXX------------------XXSSS------------------------------------------------------------------------------------------------------------------------------------------------------------------------------------------------------------------------------o----------------------------------------XXX--------------------------------------------------------------------------------------------------------------S---------------------------------------------------------------------------------------------------------------------------------------------------------------------------------------------------------------------------------------------------------------------------------------------------XXXX-------------------------------------------------oooo------------------------------------------------------------------------------------------------------------------------------------------------------------------------------------
--------------------------------------------------XXXX--------------------------------------------------------------------------[]--------------------------------------------------------------------------------------------------------------------------------------------------------------------------------------S------------S-SS-S-SS-----------------------------------------------------E------------------------------------E--------------E---E---------------------------------------------------------------------------X--o------------------------------------------X----[]--------------------------------------------------------------X----------------------------------------o---------------------------------------------------------------------------------------------------------------S-----------------------------------------------E-------------------------------------------------------------------------------------------------------------------------------------------------S-S-----------------------------o---E------------------------------------------------------------------------------------------------X-------------------------------------------------------------------------------------E------------------------XX-----------------------------------------------EXXXX-----------------------------------------------------------------------------------------------------------------------------------------------------------------------------------------------------------------------------------------
-----------------------XXX----------o-------------XXXX--------------------------------------------------------------------------XXXXX--------------------oooo--------------------------------E----------------------------------SSSSSS-------E-------------------------------------------------------------------o----SoS------------SoS--SoSS-----------------E------------------------------------------------------------SS---------------E--------<>--<>---------------E-EE--------E------------------------------E-X---oo---------XX------------------------------------E-------X----[]----------------o-----------------------------------------------------------------------------E----------------------------E--o----------------E-----SSSSSS------------o-------------------------o--------------------------------------------------------------------<>-------------ooo--------------------------------------------SQ-------E--S-----<>-------------------E-------------------------------E--SSSSSSSS----------------------------------------------------------S---------------------------------------o-------------------------------S-----X-----------------------E-----------------------------SS------------------E----------<>--o---------------------XX----------------------------------------------XXXXXX---------------------ooo------------------------------------------------------------------------------------------------X------------------------------E---------------E---------------XXXXX---------------------------------------------
-----------------------XXX--S---------------------XXXX-------------------------------------------------------------XXX---XXXX-------X---XXX------------E---------SSSSS----------------------<>---S-------------------S----SSS------------------XX-------------------------XXXX-----------------XXX--------------------SSS--S----SS---SSS--SSSSS?--S---SS------<>---------------QQQ---Q--Q--------S----E-------------X--X-----------X--S?S---<>------SS[]--[]-------S--------X--XX-XX---SSS----QQ--QQQQ---------------<>--ooo----------XXX-----------------------S-----------<>-----XXX----XXSS-S--------------------XXX--------------------XXX------------XX--------Q---SSS-------ES-----<>---QSSSSS---------------E--<>---E-----E--------<>--------------S?S--------------------------XXX------ES-----------------S?S--Q-------QQQ--QQQQ-----Q---SSS------E---E--[]--------------------SSS--S?S---------------XXXXXXXXXX--XXXX----E----<>-----E--[]-----E------------<>----------------Q---SSS-------<>-----------------------E--?-SSSSSSSSSSS--------SSS-------S----------S--QQQ--Q?SSQS--------E--SS----------------------------------------------S---XX-----------------S----<>------ESSQS---S--------------------S------------<>-------E--[]----------E--S----------XX------------Q-SSQQQ---------------------------XXXXXX-------------SSS---E---------------------E-----------------------Q--Q--Q------------------------QQ---------------------XXQ--S?Q--QQQQ----------QQQ----<>--------------<>---E--S--X-------------------------------------------------------
-----XXX-?-----------XXXXX----------------------XXXXXX----------------------o-------------------------------------------------------------------------<>------------------------------------[]-------------------------E--E--------------------------------------------------------------------------------------------------XX-------------------------------[]--------------------------------------E------------XX--XX---------XX--------[]--------[]--[]--------------XXX--XX-XX---------------------------------[]--------------XXXX-----------------------------------[]-----XXX--------------------------------------------ooo-----XXXX------------XX---------------------<>---E--[]------------------E----<>--[]-------------E----[]------------------------------------------XXXX---------E------------------------------------------------------<>--<>--[]--------------------------------------------------------------<>----[]----<>--[]----<>------------[]------E-----------------------[]----------------------<>----------------XX---------------------X----S--------------------<>--E----------------------E--------------------------EXXX----X-----------------[]-----<>-----------------------------------------[]------<>--[]---------<>-------------X----------------------------X----------------EXXXXXXX------------------<>---------------XE---<>---E------------------------------------------------------------------E-----XXX-----------------------------[]--------------[]--<>----------------------------------XXXXXXXXXXX-----XXX--------
--------------------XXXXXX----------------------XXXXXX------------------------------------------------------------------------o-----------------------[]------------------------------------[]----------------------------X------------------------X-------X-----------------------------------------X----------------------XXX-------------------------------[]-------------------------------------<>-----------XXXX-XXX-------XXX--------[]--------[]--[]-------------XXXX--XX-XXX--------------------------------[]-----------XXXXXXX----------o------------------------[]---X-XXX-----------------------------------------XXX----XX-XXXXX------------X----------------------[]--<><>[]-----------------<>----[]--[]------------<>----[]----------------------------------------XXXXXX------------X---------------------------------------------------[]--[]--[]--------------------------------------------------------------[]----[]----[]--[]----[]------------[]-----<>-----------------------[]----------------------[]----------------XX---------------------X----S--------------------[]-<>---------XXX--------------E-------------E---X----XXXX---SSE----------------[]-----[]-----------------------------------------[]------[]--[]--X------[]----------------------------------------------------------XXXXXXXXX------------------[]---------------XXX--[]--<>--------------------------------------<>----------------------X--------XXXX-----------------------------[]--------------[]--[]--------XXXXX------------------------------------------------
---------------EE--XXXXXXX--E---------------E--XXXXXXX-------------------------------------------------------E-E-------------XXX----------------E-E---[]-----------------------E------------[]--------------X----E---------------------------------X---EE-XX----------------------------------------------------------E----XXXXXX-----------------E--------E--[]-E----------------E------------------[]--E-E-----XXXX--XXXX--E--XXXX-EE-----[]--------[]--[]-----------XXXXXX--XX-XXX-----------E--E-----------------[]----------XXXXXXXXX-SSSSS--XX------E-EE----EE--------[]-XXX-XXX-----------------------------------------SS-S-----XXXXXX------E-EE--X-X---EE-----EE--------[]--[][][]----XE-----------[]----[]--[]-----E------[]----[]---------------------------------EE-----XXXXXX------------E-----EE-E-E-----------------E-EE-----------E----E--[]--[]--[]--------------------------------------------------------------[]----[]----[]--[]----[]-E---EE-E---[]-----[]--EE-E-E------------E--[]----------------E-----[]----------------XX--------E----EE-EE---X----S----E-EE------------[]-[]-----------------------------------------E--------XXX----XS----E-EE-----E--[]-----[]-----E-----------------------------------[]------[]--[]--X--E---[]------------------------------------EE--------------------XXXXXXXXX--------X---EE----[]---------------XXX--[]--[]-----EE--------EEEE----EE-------------[]-----E------------E-E-X-------XXXXX-----------------------------[]---E-E-----E--[]--[]-E------X-------------------------------------------------EE-
---------XX-XX-XXXXXXXXXX--XXXXXXXX----XXXXXXXXXXXXXXXXXXXXXXXXXXXX---XX-----XX-XXXXX--XXXXXXXXXXXXXXXX--XXXXXXX----------------------------XXXXXXXXXXXXXXXXXXXXXXXXXXXXXXXXXXXXXXXXXXXXXXXXXXXXXXXXXXXXXXXXXXXXXXXXXXXXXXXXXXXXXXXXXXXXXXXXX----XXXXXXXXXXXXX--XXXXX-XX-----------XXXXX---XXXX---------------------XXXXXXXXXXXXXXXXXXXXXXXXXXXXXXXXXXXXXXXXXXXXXXXXXXXXX--XXXXXXXXXXXXXXXXXXXXXXXXXXXXXXXXXXXXXXXXXX--XXXXXXXXXXXXXXXXXXXXXXXXXXXXXX-XXX-XXXXXXXXXXXXXXXXXXo--XXXXXXXXXXXXXXXXXXXXXXXXX----XXXXXXXXXXXXXXXXXXXXXXXXXXXXX------SXXXXXXXXXXXXXXXXXXXXXXXXXXXXXXXXXXXXXXXXXXXXXXXXXXXXXXXXXXXX---X--X------XXXX-------S-S-XXXXXXXXXXXXXXXXXXXXXXXXXXXXXXXXXXXXXXXXXXXXXXXXXXXXXXXXXXXXXXXXXXXXXXXX--XXXXXXXXXXXXXXXXXXXXXXXXXXXXXXXXXXXXXXXXXXXXXXXXXXXXXXXXXXXXXXXXXXXXXXX---XXXXXXXXXXXXXXXXXXXXXXXXXXXXXXXXXXXXXXXXXXXXXXX-XXXXXXXXXXXXXXXXXXXXXXXXXXXXXXXXXXXXX--XXXXXXXXXXXXXXXXX-------XXX------------------XXXXXXXXXXXXXXXXXXXXX-XXXXXXXXXXXXXXXXXXXXXXXXXXXXXXXXXXXXXXXXXXXXXXXXXXXXXXXXXXXXXXXXXXXXXXXXXXXXXXXXXXXXXXXXXXX---X-XXXXXXXXXXXXXXXXXXXXXXXXXXXXXXXXXXXXXXXXXXXXXXXXXXXXXX----------XXXX-X-XX-XX-X----XXXXXXXXXXXXXXXXXXX--XXXXXXXXXXXXXXXXXXXXXXXXXXXXXXXXXXXXXXXXXXXXXXXXXXXXXXXXXXXXXXXXXXXXXXXXXXXX--XX--XXX-XXXXXXXXXXXXXXX----XXXXXXXXXXX--XXXXXXXXXXXXXXXXXXXXXXXXXXXXXXXXXXXXXXXXXXXXXXXXXXXXXXXXXXXXXXXXXXXXXXXXXXXXXXXXXXXXXXX-XXXXXXXXXXXX--XXXXXXXXXXXXXXXXXXXX---XXXXXXXXXXXXXXXXXXXXXXXXXXXXXXXXXXXXXXXXXXXXXXXXXXXX----XXXXXXXXXX--XXXXXXXXXXXXXXXXXXXX-XXXXXXX------------------------X---------------X-XX-----XXXXXXX