------------------------------X-----------------------------------------------------------------------------------------------------------------------------------------------------------------------------------------------------------------------------------------------------------------------------------------------------------------------------------------------------------------------------------------------------------------------------------------------------------------------------------------------------------------------------------------------------------------------------------------------------------------------------------------------------------------------------------------------------------------------------------------------------------------------------------------------------------------------------------------------------------------------------------------------------------------------------------------------------------------------------------------------------------------------------------------------------------------------------------------------------------------------------------------------------------------------------------------------------------------------------------------------------------------------------------------------------------------------------------------------------------------------------------------------------------------------------------------------------------------------------------------------------------------------------------------
-----------------------------------XX------------------------------------------------------------------------------------------------------------------------------------------------------------------------------------------------------------------------------------------------------------------------XX---------------------------------------------------------------------------------------------------------------------------------------------------------------------------------------------------------------------------------------------------------------------------------------------------------------------------------------------------------------------------------------------------------------------------------------------------------------------------------------------------------------------------------------------------------------------------------------------------------------------------------------------------------------------------------------------------------------------------------------------------------------------------------------------------------------------------------------------------------------------------------------------------------------------------------------------------------------------------------------------------------------------------------------------------------------------------------------------------------------------------------------------------------------------------------------------------------------------------------------------------------
---------------------X--oo--SSSSSS-----SSSSSSSSSSSSSSSSS--------------------------------------------------------o-------------------------------------------------------------------------------------------------------------------------------------------SSSSSSSSSSSSSSSSSSSSSSSSSSSSSSSSSSSSSSSSSSSSSSSS-----XSS----------------------------------------------------------------------------------------------------------------------------------oo----------------------------------------------------------------------------------------------------------------------------------------------------SSSSSSSSSS-SSSS-SSSSSSSSSSSS--------------------------------------------------------------------------------------------------------------------------------------------------------------------------------------------------------------------------------------------------------------------------------------------------------------------------------------------------------------------------------------------------------------------------------------------------------------------------------------------------------------------------------------------------------------------------------------------------------------------------------------------------------------------SSSSSSSSSSSSSSSSSSSSS-----------ooo----------------------SSSSo------------SSSSSSSSSS--------------------------------------------------------------------------o-----------------------------------------------------------------SSSSSSSSSSSSSSSSSSSSSS------
---------------------X------SSSS-------------------------------------------------------------------------------------------------------------------o----------------------------------------------------------------------------------------------------?---------------------------------------------------------------------------------------------------------------------------------------------------------------------------------o--------------------------------------------------------------------------------------------------------------------------------------------------------------------SSSS----SS-----------------------------------------------------------------------------------------------------------------------------------------------------------------------------------------------------------------------------------------------------------------------------------------------------------------------------------------------------------------------------------------------------------------------------------------------------------------------------------------------------------------------------------------------------------------------------------------------------------------------------------------------------------------------------------------------------------------------E--E-------------------------E--E-----------------------------------------------------------------------------oo--------------------------------------------------------------------------------------------------------
--E-------------------------SSSS-------------------------------------------------------Eooo---------------------------------------Eooo-------------E--o--------------------------------------------------------------------------------------------------------------------------------------------------------------------------------------------------------------------------------------------------------------------------------------oo----------------------------------------------------------------------------------------oo-----------------------------------------------------------------------SSS----S----------------------------------------------------------------------------------------------------------------------------------------------------------------------------------------------------------------------------------------------------------------------------------------------------------------------------------------------------------------------------------------------------------------------------------------------oooo-o---------------------------E-----------------------------------------------------------------------------------E----------------------------------------------------------------------------------------------------E----------------------------------------------XXX-XXX----------------------XXXX-----------------------------------------------X---------oo--oo--oo------------Eoo--------------------------------------------------------------------------------------------------X---
--E------------------XXX-------S--oQ---ooooo-o--------SS--Q----------------------------XXXXX----------o----------------------------XXXX-------------XXXX------E---------SSS------SS---------?-----------------------------------SSS---?-------o-----?o--------------------------------S-------------------------SSS------------------------------S?S---SS--------------------------SSS-QQQ----------------------------------SSS-----E-------XXXX--------------------Q------SSS--------------SSSSQ-------SSSS-SSSS?SSS---------------------------------------------------SSSSSS--SSSSS-------S---SSSSSQ----------S----SS-------Q---------------------SSSS-----SSSS---------------------------------------------------SSSS----------S----SSS-------SSSS---------------------------------------------------------E---------------------------E-----------------------------QQQ-----------------------------------------------Q-Q-----Q-----------------------------------------SQS-----S--------------------------------o------------------------------------------------XXXX-----------------SSS--------SS----------------SSSSSS--------SQSS--------------SSSS-----------------------------SSQ-------SSSS---------------------------------------------------------S----SSSSSS-------------------SSSSSS------SS-------------------------------------------------SSS---SS----------------------------------------------------------XXXo---------------XXX----------XXXXX-----------------------S-------------------S----SSS---?SS-------------------------------------------
----XXXX-------------XXX-------S--------------------------------------E------------------------------------------------------------------------XX------------<>--------------------------------XXX--------o--------------------------------------E--------------------------------------------------------------SS---------------------------------------------------------------------------------------ooo----------------------------XX---------------------------------------------------------------------------------------------------------------------------------------------------------------------------S---------------------------------------------------------------------------------------------------------------------------------------------------------------------------------------<>--------------------------<>----------------------------------------------------------------------------------------------------------oooo--------------------------------------------oo---------------oo-------------------oo------------------------------------------------------------------------------------------------------------------------------------------------------------------------------------------------------------------------------------------------------------------------------------------------------------oo---------SX------------------------------------------------------------------------------------XXX------------------------------S----------------------------------------------------------------------------
--------------------XXXX------SS---S-SSSSSSSSSS----------------------XXX-------------------------------------------------------------------------------------[]-----------------------------------------XXXX-----------------XXX----------------<>--------------------------------------------------------------SS----------------------------------------------------------XX--oo-------------------------------------------------------------------------------------------------------------------------------------------------------------------------------------E---------------------------------------------SS--------------------------------------------------------------------------------------------------------------------------------------------------------------------------------------[]--------------------------[]--------------------------------o-------------------------------------------------------o---------------------------------E-------------X---------------------XX-----------------------------------------------------------------------------------------------------------------------------E-----------------------------------------------------XX------<>------------------------------------------------------------------------------------------------------------------------------------------------------------S---X-------------<>---------------------------------------------------------------------------------XX--------------------------------E-E----------------------------------------------------------
-------------------XXXXX----ooSS---SoS--SSSSSS-----E--------------------------------------------XX--------------------------------------------SSSSS----------[]------------E--------------------------------------------------------------------[]-------------------------E------------------------------------[]-----------------E---SSSS---------------------------------XX-----------------------------------------E------------Q----------------SS--------------------------------------------------------------------E---------------------------------E--S--E--<>-----------------E--------------------EE-----SS------------------------------------------------------E-------------------S-S----------------------------------------------------Q---SSS----------------------------------------------[]X----E-------E-------E----[]-----E-------ooo-------------------------------------------oo-------------------------------------------E-----E--S--------E------------XXSS---SSSSSSS----E---XXX------------------------------------------------------------------------------------------------------------------------X----------ooo---oo--------------E--S------o-----E--------XXX------[]------------------------------------------------------------------------------E-----E----------------------------------------------------E------------------------------------[]-----------------------------------------XXX----------------------SS-------------XX------------S---------------E-----E---------------------------E------------------------------
X-X---------------XXXXXX----SSSS---SSS---------E--<>-----EE-E------------------------------XX----------------------------------------------------------SS----XX-----------<>------XXXX---------------XX------------XXXX-------------S----S?S-X--XXXX------oo--------------<>-----------S------------------------[]----------------<>----------------Q--SSS--ES---S----X----S-XX----S---S?S-------X-------Q------------<>-----------------------------X--------------Q--------S---------------ESSQ--Q-Q---S----------------<>------S-------------------------<>----<>--[]----------S-S---<>-----QQQ?--QQQ-----E-SS----S---E-E?----Q----------SE-------------------------E----<>-------------------ooo-------X--XX------------------SS-------------------X------------S--------------------------E-------------[]X---<>------<>------<>----[]----<>-----E-----------------ESQS----------------------------------------E-----QQQ-----S--------------E<>----<>-----E----<>------S?---XXX--------------------XXX-----------XXXX-------------------------------SXS------------------------------S------------S--------------------------XX--S?S-----------XXX--SSS----E--<>-----E--------<>--QQQQ?-XXX------XXSSS-------------E------------------------------------------------------------<>----<>--SS--S-S------------------------------------------<>------S-----------SSS----------E--SS[]------------------E-----------------XX-----XXXX----------------------------SS----XX----------------SS-S-------<>----<>-----EQQQ--Q--------------<>--------E----ESSQQ------------
--XX--------------XXXXXX----------------------<>--[]-----XXXXXXXXX-?-------------------------------------------------E-------------------------------E-------XX-SSS-------[]----------------------------------------------------------------------SS----------------------[]-----------------------E------------[]----------------[]-------------------------------E--X-----XXX------------------X-----------XX?------[]----------------------------XXX-XXX--S---------------------------------------------E---E----------[]--------------------X-----------[]----[]--[]-----E----------[]------------------------E-----<>-----------------------------X--------------<>----[]---------------------------XXX--XX--------------------------------------XX--------------------------------------<>-------------[]X---[]------[]------[]----[]----[]----<>-------------------------------------E----------------------<>---------------------------<>[]----[]----<>----[]----------XXXX---------------------XX---X-----------------------------------------------------------------------------------E------------------------------XXX----------------------------E--[]----<>--------[]--------XXX--------------------E---------------XXXX?----------------------X---------------------[]----[]-----------------------------E---------------S-----[]----------------SSE-----E-----<>----[]-----------------<>----------------X---XXXX------------------------------------XXXX-SSS-----------------------[]----[]--------------------------[]-------<>-----------------X---
--XX--------------XXXXXX----------------------[]--[]---------------------------X------------------------------------<>--------------------X--------------E---XX-----------[]----------------------------XXXXX--------------------------------------S----------------------[]--------<>------------<>------------[]----------------[]----------------------------------X-----XXX------------------X--------------------[]-------------------------XXXXXX-XXXXX---------------------X---------------------------------------[]----------<>-------XXX----------[]----[]--[]----<>----------[]------------------------------[]-------------------------X---X--------------[]----[]---------------------------XXX--XXX------------------------------------XXX--------------------------------------[]-------------[]X---[]------[]------[]----[]----[]----[]------------------------------------------------------------[]---------------------------[][]----[]----[]----[]---------XXXXX-----------------EX--XX--------------------------------------------------------------------------------------<>-----------------------------XXXX---------------------------<>--[]----[]--------<>-------XXXX---SS--------------<>---X------<>----------------------------XXXX--XXX---------------[]----[]----------------------------<>---------------------[]----------------SS------------[]----[]-----------------[]----------------X-----------------------------------------EXX-XX---------------------------[]----[]--------------------------[]-------[]-----------------X---
--XX----------E---XXXXXX-------E--------------[]--[]----------------------EEE--X------------------------------------[]---------------------------------------XX-----E-----[]-----------------------------------------------------------ooo---------S---------E-EE-E-------[]--------[]------------[]------------XX-------------E--[]------------------------------EE--X-----XXX----E----E--E-E---X--------------------[]----------------XXXX--X--X-X-XX-XXXX?---------------------X---------------------------------------[]----------[]-------XX----EE-E---[]----[]--[]----[]---E------[]------------------------------[]-------------------------X-E-X--------------[]----[]------------------E------XXXXX--XXXX--------XX---E-------E------------XXXX------------------------E-------EE-E--[]-------------[]X---[]------[]------[]-E--[]----[]-E--[]--------E---------------------------------------------------[]-----------------------E---[][]----[]----[]----[]-E--EEE-XXXXXX---------------------XX-----E----------------------------------------------------------------E---------------[]-----------E--E-E-----------XXXXX--------------------------X[]--[]----[]--------[]-------XXXX-------E-----E-----[]-EXX------[]---------------------------XXXXXE-XXXX-----EE----E--[]----[]-----E-------------E--------[]-------EE-E----E-E---[]----------------SS------------[]-E--[]----EE-E------E--[]----EE----------XXXXX---------------------------o-------------XX-----------E---------------[]-E--[]-----------------------E--[]----E--[]-------------E---X---
XXXX--XX-X-XXXXXXXXXXXXXXXXXXXXXXXXXXXXXXXXXX-XXXXXXXXXX-----------XXXXXXXXXXXXXXXXX----XXX---------------------XXXXXXXXXXXXXXXX------------X----XXXX-XX-XXXXXXXX---XXXX-XXXXXXXXX-----XXXXXXXXXXXXX-------------XX--------XXXXX-------XXX--------XX--XXXXXXXXXXXXXXXXXXXXXXXXXXXXXXXXXXXXXXXXXXXXXXXXXXXXXXXXXXXXXXXXXXXXXXXXXXXXXXXXXXXXXXXX--XXXXXXXXXXXXXXXXXXXXXXXXXXXXXXXXXXXXXXXXXXXXXXXXXXXXXXXXXXXX----XXXXXXXXXXXXXXXXX---XX--------XXXXXXXX--XXXXXXXXXXXXXXXXXXXXXX--XXXXXXXXXXXXXXXXXXXXXXXXXXXXXXXXXXXXXXXXXXXXXXXXXXXXXXXXXXXXXXXX----XXXXXXXXXXXXXXXXX-XXXXXXXXXXXXXXXXXXXXXXXXXXXXXXXXXX----XXXXXXXXXXXXXXXXXXXXXXXXXXXXXXXXXXXXXXXXXXXXXXXXXXXXXXXXXXXXXXXXXXXXXXXXXXXXXXXXXXXXXXXXXXXXXXXXXXXXXXXXXXXXXXXXXXXXXXXXXXXXXXXXX-X-XXXXXXXXXXXXXXXX--XXXXX--XXXXXXXXXXXXXXXXXXXXXXXXXXXXXXXXXXXXXXXXXXXXXXXXXXXXXXXXXXXXXXX-XXXXXXXXXXXXXXXXXXXXXXXXXXXXXXXXXXXXXXXXXXXXXXXXXXXXXX-X--XX----XXXXXXXXXXXXXXXXXXXXX--XX-X--XXXXXXXXXXXXXXXXXXXXXXXXXXXXXXXXXXXXXXXXXXXXX---XXXXXXX-X-X-X-XXXXXXXXXXXXXXXXXXX---XXXX-----------------X---XXXX-X---XXXXXXXXXX------XXXXXXXXXXXXXXXXXXXXXXXXXXXX--X-XXXXXXXXXXXXXXXXXXXXXXXXXXXXXXXXXXXXXXX------XXXX--XX--XXXXXXXXXXXXXXXXXXXXXXXXX-XXX--XXXXXXXXXXXXXXXXXXXXXXXXXXXXXXXXX-----XXXXXXX-XXXXXXXXXXXXXXXXXXXXXXXXXXXXXXXXXXXXXXXXXXXXXXXXXXXXXXXXXXXXXXXXXXXXXXXXXXXXXXXXXXXXXXXXXXXXXXXXXXXXXXXXXXXXXXXX---XXXXXXXXXXXXXXXXXXXXXXXXXXXXXXXXXXXXXXXXXXXXXXXXXXXXX---X-----------------------------X------X-XXXXXXXXXXX---XXXXXXXXXXXXXXXXXXXXXXXXXXXXXXXXXXXXXXXXXXXXXXXXXXXXXXXXXXXXXXXXXXXXXXXXXXXXXXXXXXXXXXXX