------------------------------------------------------------------------------------------------------------------------------------------------------------------------------------------------------------------------------------------------------------------------------------------------------------------------------------------------------------------------------------------------------------------------------------------------------------------------------------------------------------------------------------------------------------------------------------------------------------------------------------------------------------------------------------------------------------------------------------------------------------------------------------------------------------------------------------------------------------------------------------------------------------------------------------------------------------------------------------------------------------------------------------------------------------------------------------------------------------------------------------------------------------------------------------------------------------------------------------------------------------------------------------------------------------------------------------------------------------------------------------------------------------------------------------------------------------------------------------------------------------------------------------------------------------------------
------------------------------------------------------------------------------------------------------------------------------------------------------------------------------------------------------------------------------------------------------------------------------------------------------------------------------------------------------------------------------------------------------------------------------------------------------------------------------------------------------------------------------------------------------------------------------------------------------------------------------------------------------------------------------------------------------------------------------------------------------------------------------------------------------------------------------------------------------------------------------------------------------------------------------------------------------------------------------------------------------------------------------------------------------------------------------------------------------------------------------------------------------------------------------------------------------------------------------------------------------------------------------------------------------------------------------------------------------------------------------------------------------------------------------------------------------------------------------------------------------------------------------------------------------------------------
----------------------------SSSSSSSSSSSSSSSSSSSSSSSSSSSS---------------------------------------------------------SSSSSSSSSSSSSSSSSSSSSSSSSSS-----S-SS-------------------------------------------------------------------------------------------------------------------------------------------------------------------------------------------------------------oo-------------------------------------------------------oo-------------------------------------------------------------------------------------------------------------------------------------------------------------------------------------------------------------------------------------------------------------------------------------o--------------------------------------------------------------------------------------------------------------------------------------------------------------------------------------------------------------------------------------------------------------------------o----------------------------------------------------------------------------------------------------------SS-SSS-----------SSSSSSSSSSS----------------------------------------------------------------------------------------------------------------SSSSSSSSSSSSSSSSSSSSSSSSSSSS--------------------------------------------------------SSSSSSSSSS-----SSSSSSSSSSSSS----------------------------SSSSSSSSSSSSSSSSSSSSSSSSSSSSSSSSSSSSSSSSSSSSSSSSSSSSSSSS------------------------------------------------------------------------------------SSSSSSSSSSSSSSSSSSSSSSSSSSSS
----------------------------SSSSSSSSSSSSSSSSS--------------------------------------------------------------------SSSSSSSSSSSSSSSSSSSSSSSSSSS-----------------------------------------------------------------------------------o-----------------------o--------o---------------------------------------------------------------------------------------------?------------------------------------------------------------XXX------------------------------------------------------------------------------------------------------------------------------------------------------------------------------------------------------------------------------------------------------------------------oo------?------------------------------------------------------------------------------------------------------------------------------------------------------------------------------------------------------------------------------------------------------------------------------------EE-------------------------------------------------------------------------o-------------------------------------------------------------------------------------------------------------------------------------------------------------------------------------------------------------------------------------------------------------------------SSSSSSSSSSSS------------------------------SSSSS--SSSSSSSS------------SSSSS-------S--SS--SSSS------------------------------------------------------------------------------------------SSSS------SS--SSSSSS--SSSS
---Eooo---------------------SSSSSSSSSSSSSSSSS-------------------------------------------------------------------ESSSSSSSSSSSSSSSSSSSSSSSSSSSXX-----------------------------------------------------------------------------------------------X---------------------------------------------------------------------------------------------------------Eooo----------------------------------------------------------------------------------------------------------------------------------------------------------------------------------------o----------------------------------------------------------------------------------------------------------------------------------------------------oo------------------E----E---?------------------------------------------------------oo--oo------------------------------------------------------------------------------------------------------------------------------oo--------ooooooo-----------------------------------------------XX-XXX------------------------o-------------------------------------------------------------------------------------------------------------------------------------------------------------------------------------------------------------------------------------------------------------------------------------------------------------------------SSSSSSSSSSSS------------------------------SSSSS-ES-SSSSSS---------E--SSSS--E-----S--SS--SSSS------------------------------------------------------------------------------------------SSSS--E---SS--SSSSSS--SSSS
----XXXX---XX----ooo--------SSSSSSSSSSSSSSSSS---------------------------SSSS-?-----SSSSSS---?-----oo-----o------SSSSSSS-SSSSSSSSSSSSSSSSSSSS-----SS?---E-----------------SSS-----------------SSS-------------------SSSSS----SSSS-S----SS-?---S-------SSS-------S-------SSSSSSSSS---SS--------------------SSSS-------SSS------------o-----?-------------XXXXX------XXX-----------S----S----------------------------------------------------------------------SSSS-------------------XXXX---------------------------------------------------oo------------------------------------------------------------------------------------------------------------------------SSSS-------SSSSSSSSSS-------E-------XXXX------E---------S---SQS-S??------------SSSSS----------SSS---------------SSS-------------------------------------------------------S---SS??-------------SSSS-----------------S-S------------------------------------SXX--------------------------------------SSSSSSSS-----------S---------------------------ooo-XXXXX----------------S-------E---E--S---------------S---Q------oooo--------SS----------------------------S-------------------------------------QQQS-----------------------------------?-QQ-----S-S---?SS------E--------------S----S------------------SSSS--------------SSSSS------------------------------------SSQ--------SSSSSSSSSSSSSS-------------------------?-----S----SSSSSS-------E----SS--S----SS------------SSS--------oo--XXXXX--------------------------Q------------------QQS--------------SSQSS-------S-----S-----------S----SS
--------------E-----------XX-------------------------------------------------------------------------------XoX------------S---------------SS----------<>------------------------------------------------------------------------------S--------------SS------------------------------------------------------------------------------E-----XXX----XX---------oo---XXX--------------------------------------------------------------------------------X------------------------------------------------------------------------------------------------------------------------------------------------------------------------------------E----------------------------------------------------------------------<>--------------------------------------------------------------------------------------oooo-------------------------------------SS------------------S-----------------------------------Qooo-------------------------------------------------------------------------------------------oo--------------------------------------------<>--<>--------------Q------------------------------------------------------------------------------------------------------------------------------------------------------------<>-------------------------------------------------------------------------------------------------S--------------------------E----------------------------S-----------------S----SS--S----SS------------SSS-------XXX----------------------------E----------------------------------------------------------S-----------SS-----
-------------<>------------------------------------------------------E---------------------------------------------------SS---------------SS----------[]----------------------------------------------------------------------------S-S--------------SS----------------------------------------------------------------------E------<>---------------------------XXXX------------------------------------------------------E-------------------------XX----------------------------------oo---oo-----------------------------------------------------------------------------------------------------------------------------------------------------------------------------------------------------------------[]------------------------------------------------------------------------------------E------------------------------------------SS----------------S-S-----------------------------------------------------------XXX----------o------------------------------------------o-------------------------o----------------------------------[]--[]-----------E-----SS-?-S-S--S-S--SS-----------------------------------------------------------------------------------------------------------------------------------------[]--------------------------<>-------------------------------------------------------------------S-S------------------------------------------------S--o--SS----------------------SS--S-S--SS------------SS-----------------------------------------------------------E-----E-------------------------SS-----S-----------SS-----
-------------[]---------------------E-----------------------------E--------------------------------------------S---------SS------oooooooooSS----?-----[]-E----------E------------------------SQ------------------o--------------?ooooSS--------------SS-----S--------E---------------S------------------------------S-------<>------[]-------SSS----------------XXXXX-------SSSSSSS---------------------SSSSS-------------<>-------------------E-----XX--------------------------------------------------------------XSS--------------------------------------------------------X-----------------S-SQ---------E-------------------E-----S--------------------------------------------------------SS-------------XXX--------E-----------E--E-------SSSSS----------------------------SSSS--------------<>---------------------------------ooo?-ooooSSS---------------SoSS--------------------------------E----------------------X------XXXXX----------o----------------------------------S--------------------------------------------------------------[]--[]---E------<>----------SoS--SoS--S-----------------------------------------------oo---------------------------------------------------------------------------XX------------[]--------------------S-----[]---------o----------------------------SSSSSS-------------E------------E------------------------S-------------------XX--------So?---E---E-?-----So??-SS?-SoS?-SS-------oo??-SS---E---------------------------------------------------E--<>------------oo---o--------------S----------?ooooooSS--ESS
X-------XXX--XXX----XXXXX----------<>------------QQ---Q-------E--<>---SSSSSSQS----------------XXXX--XXXX----XXX-SSSSSSSSSSSSSSS??SSSSSSSSSSS-SSS?-SSSS[--SS-E------<>----ooQS-----------------------Q---------E---S-----------S---SSSSSS-------------S---------E----<>------SQ------------------------------S----------E----[]---E--XXX------------------------XXXXXX-------------------S---------------------------------[]---------------------X--XXX--------X--------------XXXXXXXXXXX---S-----------------------XXX-----------------------------------------------------<>--------------------------------<>---QQ?SQQ---------<>------------------------------XX---------Q--Q--Q---SS-----------------------------------XS--S?S---------XX-------------------S-S--------E-------------------------[]--------------------------------------SSSSSSS-S--S----------SSSS---E------------S?S------------<>-----E----S----------XX-------------------------------------------SQQ?--QQQ----SSS---------------------EX-------XXX----------XX-X--------E--SS[]------<>------[]---X------SSS--SSS-------------S------E-X------SS---------------------------------------------QQ?SQQQ-------------------E---------QQQQ--QQQQ--------Q--Q-------[]------<>---------------E--[]--------E----------------XXXX-----------------Q-XXS-----<>-----------SSS-----XX------SSSSSSSS-------------S----S--XXX--SS-X--SSS-SSSSSSSSS?SS--SSS--SS--SSS--SS-S----------SS-----------XX----XXXX------------X--SS--S------S------<>--[]---S?S------------Q---QQQ------SSSS---X-----?SSSSSSS--SSS
-----------------------------------[]------------------------<>--[]---------------------------------------------SSSSSSSSSSSSSS---SS----------SS---SSSSS----<>------[]-------------XX-------------------------<>---------------------------XX------------------<>----[]---------------------------XX-----------E-------<>----[]--<>----------------------------XXXXXXX---------------------E--X---XSS<>--------------------[]-----E---------------X--XXX--------X---------------------------------------------------XXXX-E------------------------------------------E--------[]--------------------E-----------[]------------------[]-----------------------------XXX--------------------------XX-----------------XX-SSS------------------X--XX---X-----------E------------E<>--------------------E-E--[]-----------E------------------------------------------------------<>------------------<>-------[]----<>-------E------XXX-------------------------------------------------------------------------------XXXXX--XX-------------XXX-XX------<>----[]------[]------[]---X-------------------------------XX<>-XX---------------------------------------------------------------------------------------------------------------------[]------[]--------E-----<>--[]-----------------------------------------------------E--[]----------E-------XXX--XX------------------------------XXXXX----SS--SSSSSSSSSSS--SS------------------------------------E-------------------X--------X--------------------[]--[]-----------------------------------E--XX-------------E---
-----------------------------------[]------------------------[]--[]---------------------------------------------SSSSSSSSSSSSSS---SS----------SS---SSSSS----[]------[]------------XXX-----------E---X---------[]--------------------------XXX---X-----------X--[]----[]-----X---------------------XXX------------------[]----[]--[]---------------------------XXXXXXXX------------------------X------[]----------------<>--[]----<>--------------XXX-XXX--------X----XXXXXX----------------------------------------XXXXX-E-----------------------------------------<>--S-----[]-------------------<>-----------[]------------------[]--------------------------E--XXX--------------------------XX-----------------X-----------------------X-XXX---X----------<>-----------<>[]-------------------<><>--[]------------------------------------------------------------------[]------------------[]-------[]----[]------<>-----XXXX---XXXXX-------------------------------X--------------------------------------XXXXX---XX------------XXXX-XXXX----[]------------[]------[]---X------------------------------XXX[]-XX---------------------------------------------------------------------------------------------------------------------[]------[]--------------[]--[]----------------------------------------------------<>--[]-----------------XXXX--XXX----------------------------X-XXXX----SS-SSSSSSSSSSSS--SS-------------------------------------XXX----------------XX-------X--------------------[]--[]----------------------------------E---XXX----------------
-----oo-------------------------E--[]-----E-------EE-E--E----[]--[]---------------------------------------------SSSSSSSSSSSSSSoooSS--------------oS---Soo--[]--E---[]----E------XXX---------------XX---E-EE--[]-----------E------E------XXXX-E-X---E------XX--XX----[]-E-E-X-----E---------------XXX-E----------------[]----[]--[]-------E----------------------XXXXX------------------------X------[]----------------[]--[]----[]--------------XXE-XXX-----E--X-------------------------------------------------XXXXXX------------------------------------E------[]--------[]-------------------[]-----------[]-----------EE-----[]----------E-EE-E--EE---------XXX------------E------------XXX-----------------X----------E------------XXXXX--------------[]-----------[][]-------------------[][]--[]----------E---------------------------EE---------E----------EE----[]-EE-E------EE-----[]----E--[]----[]------[]----XXXXX---------------------------------------E-E-----E-EE-----E--E------------------XXXX----XX-----------XXXXX-X-XX----[]------------[]------[]---X-EE-E-E-------EE-E-----------XXXX[]-XX-------------------------------------------EE-----EE-E--------------------E-EE--------------E-EE-----------------EE--[]------[]---------X-E--[]--[]----------------------------------------------------[]--[]---------E------XXXXX--XXXX---E-------------EE-E--E--EE-XXXX----S----SSSSSSSSSSSoQS----------EE------------------------X-------------------XX---E---X----E-EE-------E-E--[]--[]--E-------------------------X---------XXX----------E-----
----XXX---------------------XXXXXXXXXXXXXXXXXXXXXXXXXXXXXXXXXXX--XXXXXXXXXXXXXXXXXXXXXXXXXXXXX----------------XXXXXXXXXXXXXXXXXXXXXXXXXXXXXXXXXXXXXXXXXXXXXXXXXXXXXXXXXXXXXXXXXXXXXXXXXX-XXXXXXXXXXXXXXXXXXXXXXXXXXXXXXXXXXXXXXXXXXXXXXXXXXXXXXXXXXXXXXXXXXXXXXXXXXXXXXXXXXXXXXXXXXXXXXXX-X-XXXXXXXXXXXXXXXXXXXXXXXXXXXXXXXXXXXXXXXXXXXXXXXXXXXXXX-X----XXXXXXXXXXXXXXXXXXXXXXXXXXXXXXXXXXXXXXXXXXXXXXXXXXXXXXXXXXXXXXXXXXXXXXXXXXXXXXXXXXXXXXXXXXXXXXXXXXXXXXXX----------------------------XXXXXXXXX-X-XX-XXXXXXXXXXXX-XXXXXXXXXXXXXXX-------------XXXXXXXXXXXXXXXXXXXXXXXXXXXXXXXXXXXXXXXXXXXXXXXX--------XXXXXXXXXXXXXXXXXXXXXXXX--XXXXXXXXXXXXXXXXXXXXXXXXXXXXXX----XXXXXXXXXXXXXXXXXXXXXXXXXXXXXXXXX-X--XXXXXXXX---XXXXXXXXXXXXXXX--XXXXXXXXXXXXXXXXXXXXXXXXXXXXXXXXXXXXXXXXXX-XXXXXXXXXXXXXXXXXXXXX---XXXXXXXXXXXXXXXXX---XXXXXXXX----XXXXXXXXXXXXXXXXXXXXXXXXXXXXXXXXXXXXXXXXXXXXXXXXXXXXXXXXX--XXXXXXXXXXXXXXXXXXXXXXXXX-----------------------XXXX---XXXXXXXXXXXXXXXXXXXXXXX---XXXXXXXXXXXXXXXXX-XXXXXXX----XX-----XXXXXXXXXXXXXXXXXXXXXXXXXXXXXXXXXXXXXXXXXXXXXXXX-XXXXXXXXXXXXXXXXXXXXXXXXXXXXXXXX-XXXXXXXXXXXXXXXXXXXXXXXXXXXXXX----XXXXXXX---XXXXXXXXXXXXXXXXXXXXXXXXXXXXXXXXXXXXXXXXXXXXXXXXXXXXXXXXXXXXXXXXXXXXXXXXXXXXXXXXXXXXXXXXXXXXXXXXXXXXX-XX--XX----XXXXXXXXXXXXXXXXXXXXX-------XXXX-XXXXXXXXXXXXXXXXXXXXXX-XXXX-XXXXXXXXXXXXXX-XXXXXXXXXXXX--XXX-XXXXXXXXXXXXXXXXXXXXXXXXX-XXXXXXXXXXXXXXXXXXXXXXXXXXXXXXXXXXXXXXXXXXXXXXXXXXXX-X--------XXXXX----X---XXXXXXXXXXXXXXXXXXXXXXXXXXXXXXXXXXXXXXXXXXXXXXXXXXXXXX--XXX----XXXXXXXXXXXXXXXXXXXXXXXXXXXX