------------------------------------------------------------------------------------------------------------------------------------------------------------------------------------------------------------------------------------------------------------------------------------------------------------------------------------------------------------------------------------------------------------------------------------------------------------------------------------------------------------------------------------------------------------------------------------------------------------------------------------------------------------------------------------------------------------------------------------------------------------------------------------------------------------------------------------------------------------------------------------------------------------------------------------------------------------------------------------------------------------------------------------------------------------------------------------------------------------------------------------------------------------------------------------------------------------------------------------------------------------------------------------------------------------------------------------------------------------------------------------------------------------------------------------------------------------------------------------------------------------------------------------------------------------------------
------------------------------------------------------------------------------------------------------------------------------------------------------------------------------------------------------------------------------------------------------------------------------------------------------------------------------------------------------------------------------------------------------------------------------------------------------------------------------------------------------------------------------------------------------------------------------------------------------------------------------------------------------------------------------------------------------------------------------------------------------------------------------------------------------------------------------------------------------------------------------------------------------------------------------------------------------------------------------------------------------------------------------------------------------------------------------------------------------------------------------------------------------------------------------------------------------------------------------------------------------------------------------------------------------------------------------------------------------------------------------------------------------------------------------------------------------------------------------------------------------------------------------------------------------------------------
--------------------------------------------------------o--------------------------------------------------------------------------------------------------------------------------------------------------------------------------ooo----------------------------------------------------------------------------------------------------------------------------------------------------------------------------------------------------------------------------------------------------------------------------------------------------------------------------------------------------------------------------------------------------------------------------------------------------------SSSSSSSSSSSSSSSSSSSSSSSSSSSS---------------------------------------------------------------------------------------------------------------------------------------------------------------------------------------------------S---------------------------------------------------------------------------------------------------------------------------------------------------------------oo-----------------------------------------------------------------------------------------------------------------------oo-----------------------------------------------------------------------------------------------------------------------------------------------------------------------------------------------------------------------------------------------------------SSSSSSSSSSSSSSSSSSSSSSSSSSS--------------------------------------------------------
-----------------------------------------------------------------------------------------------------------------------------------------------------------------------------------------------------------------------------------XXXX--------------------------------------------?--------------------------------------------------------------------------?------------------------------------------------------------------------------------------------------------------------------------------------------------S---------------------------------------------------------------------------------------------------------------------------------------------------------o---------------------------------------------oo-----------------------------------------------------------------------------------------------------------------------------------------------------------------------------------------oS--------------------------------------------------------------------------------------------------------------------------------------------------------------XXXX--------------------------------------------------------------------------------------------------------------------------E--E------------------------------------------------------------------------------------------------------------o---------------------------------E--E---------------------------------------------------------------------------------------------------SSSSSSSSSSSSSSSSSSSSSSSSSSS--------------------------------------------------------
-----------------------------------------------------------XX-----------------------------------------------------------------------------------------------------------X----------------------------------------------------------------------------------------------oo-oooooooo---------------------------------------------XX----------------------Eooo-------------------------------------------------------------------------------oo--------------------------------------E-------------------------------------------E--------------------------------------------------------Eooo------------------------------------------------------------------------------------E----------------------------------------------------------------------------------------------------------------------------------------------------------------------------------------------------oo---------------------------------E-------S-------------------------------------------------------------------------------------------------------------------------E---------------------------E------------oooo---------------------------------------------------------------------------------------------------------------------XXXXXX-------------------------------------------------------------------------------------------------------------------------------------------XXXXXXXX------------------------------oooo--------------------------------------------------------------XSSSSSSSSSSSSSSSSSSSSSSSSSSS--------------------------------------------------------
----------------------X-------------------------------------------------------------------------------------Q---------------------------------------------------SSSSS------SSSSS---------------SSSSS-----------------SSSSS----S----------------------------SS?SS----XXX---------------------------------XX---------------------------------------------XXXXX------E------------------------------------------------------------SSSSS----------------------------SSSS---------S--SSQSSSSS--------------QQ-----------SSS--SS----SS---------S?S-SSSSSSS-------Q-------------------X-------XXXXX-----XXX-----------------------------------S--------------------------------------SSS--SSS---------S----------ooooo----------------SS----XXX------E----------------------------------------------------SQSQ--?-------------------------?SSS----------------------SSSSS------SSSS--S---------------SSSS---------------------SS---SSS------------------SSSSS--------S------------------SSS------SSQS------SSS--------S-------------?SSSS-----------------S----SXX--------------------S----XXX-X----------X------------------------SS--------------------------------------------------------------SSSS----------E-----oo-------------------------------------SS-----------------SSSS---------------------------XX-------------------------------SSSS-----------XXX---SSS--XXX-----------------------------------------------------SS-------SSS--------------------------------------Q-Q---S-SSSSSSSSSSSSSSSSSSSSSSSSSS----------------S--------?-----------------SSS---------S
----------------------------------------------o---------oo-------------------------------------------------------------------------------------------------------------------------------------------------------------------------------------------------X--XXX-----------XX--------------------------XX---------------------------------oo--------------------<>-----------------------------------------------------------------------------XXXX--------------------------------------------------------------------ES----SS-----------------------------------------------------------------XXXX---------------------------------------------oo--------------------------------------------S----E--------------------------X------------<>-----------------------------------------------------------------oooo----------------------------------------------------S----------------------------------------------SS---SSS----------------------------------------------SS-------------------------------------------------------------------------------X----------------------------XX--------------------------------------X------------oo--------------------------------------------o----------------------------------------------E----------------------------------------------------------------------------------------------------------XXXX-----------------------------oooo---XXX------------------------------------------------------------oooo----------------------------------------------------------------------S------------------------------
--------------------XXX------------------------------------------------------------------------------------------------------------------------------------------------------------------------------------------------------------------------------------X-----------------------XXXXX--------------XXXX-------------------------------------------------------[]-----------------------------------------------------------------------------------------------------------------------------------------------------SS----S------------------------------E-----------------X----------------XXXXX-------------------------------------------------------------------------------------------S--o------SSSSSS-----------------------------[]---------------------------E-------------------------------------------------------------------------------------------------------------------------------------------?SS---SSS--------------------------------------------X-------------------------------E----------------------------------E-------------------------------------------------------XX-----------------------------------------------o-----------------------------------------XXX-XX--------------EE---------------------<>--------------------------------------------------------------------------------------------------------XXXXXX-------------------------------------------------------------------------------------------------------------------------SSS------------------------------------------------SS-Q----------------------------
o-------------------XXX------------------------E----------------------------------oo--------------------------------------------------------SSSSSSS--------------SS--------?-------E--E-----------------E--S----ooo--------------SQ------------------------X-----------------------------------------XXXXX-----------------------------------------------------X-XX--------------------------------------------------o---------------------------------------------------------------------------------------E-----SSSSSSS----SS----ooo--------------------SoS-----------------X-SSSSS--------XXXXXX-------------------------------------------------------------------------------E--------------------SSSSSSSS---------------SS------------XX-----------------------------------------------------------------------oo------------------------------------------------SS-------------------SSSSSSS-----------------?-SS---[]---------------------------------------------------Q-------------------------E----------------------------------E------------------------------------------------------------------------S----------------------E-------------------------------------------------------------------------XXXX----------------[]-----oS--------------------SSSSSSS---E------------------E----------------E--------------------S-------XXXXXXXX-------------------------------------------o-----------------------------------------------X-----E----------E---S--------E------------??--ooooo-o-------------------------X-SS------------------------------
-------------------XXXX--------------Q-Q------<>---------------------------------o----XXXX-------------XXX--S---------S?S--------------------------------------------------S?S----SSSSSSS-------S------<>-----E---------------E----------------S---------XXX----------XXXXXXX---------------------EXXXXXXX----------------------S-----------<>-----------------X-XX----------------------<>-----E-----------------E-----------------------------------------------SSS------XX---------SSS------E------S-S----E-------------SSSSS--E--------SS---SSSS-------SSS----------------XX-------------XXXXXXX----------------------------------------<>---------------------------E--------<>----------S-SSSS---------------------EE------------------XX-------------------------S?S------E-----------------Q--QQQQ--------------------------------------------Q----XXX---------XSS--S?SS----------------------------------------S---[]-------------XX--X--X-----------oS-----------XX-------------S?S-E--------E---E-----------QQQQ--QQQS--S---------<>------XXXXXX----------------------XXXXXXX------------------------------XXXXXX-----------------<>---------ooo--------------------------------X--XXX-----------XXXX--XXXX-------E-----------E--[]------S--E-----E--------------------<>-----------------<>---------------<>------E------E------S?S----XXXXXXXXX----------------XXXXX----E------------------------XXXX--------------------XXX-------E------X----<>---------<>-----Q-Q----SSSSSSSSSSSSS??SSSSSSSSSSS------------------S--XXX--SSS-------------E--S---------S-
----XXXXX----------XXXX-----------------------[]-----E---------------E---------------------------------------------------------E-----S-----------------------------------S----SS-ooooSSSS--------------[]----<>--------------<>-------------------------EXXX--------------------------------E----<>XXXXXXX--------EX---------------E<>------[]----------------XX-XX--------------E-------[]---E<>----------------<>------------------------------------------------------XXXX--X---E--E-------<>------------<>-------------------<>--------E---------------------------------XXX-------------XXXXXXX------------------------------E---------[]------E-----------------------------[]--E-----------------E--------------XXXXX-------------X---XX-SSS-----------------------------<>-------------------------------------------------------------E----------------------XX-----------------------------------------------EE-E---------------XXX--XX-X---------------------XXXXX-----o-------------------<>--<>--------------------------E---E--[]----------------------S-----------------------------------------------XXXXXXX-----------------[]-----------E---------------------X---------XX--------------------------------<>----------<>--[]--------<>----<>--------------------[]-----------------[]--<>-----------[]------E-----<>------------XXXXXXXXXX-----------------------E<>-----------------------------------------E---------------<>---E--X----[]--------E[]-----------ESSSSS-SSSSSS-----------------------------------XXXX-SSS------------<>--------------
-----------XXXXX---XXXX-----------------------[]----<>--------------<>--------------------------------------------------------<>----------------------------------------SS----S---SSSSSSS--------------[]----[]--------------[]-----------------------EXXXXX------------------XXXXX--------<>----[]XXXXXXX-------XXX--------------<>[]------[]---------------XXX-XX-------------<>-------[]--<>[]----------------[]-----------------------------------------------------XXXXX--XX----------X--[]------------[]-------------------[]-----------------X-----------------------XXXX-----------XXXXXXXXX-----------------------------<>---------[]-----<>-----------------------------[]-<>-------------------------------------------------EX---XX---------------------------------[]------------------------------------------------------------<>---------------------XXX-----------------------------------------------------------------XXXX--XX-XX-------------------EXXXXX-------------------------[]--[]--------E----------------<>--<>--[]----------------------S------------------------XXX-----------------XXXXXXXXXX------oo---------[]--------------------------------XXX-------XXX--------------------------------[]----------[]--[]--------[]----[]--------------------[]-----------------[]--[]-----------[]-----<>-----[]-----------XXXXXXXXXXX----------------------<>[]----------------------------------------<>---------------[]--<>--X----[]-------<>[]-----------oSSSSSSSSSSSS---------------------------------X-XXXX-SSS------------[]--------------
-----------X-XX----XXXX-----------------------[]----[]--------------[]--------------------------------------------------------[]----SS-----------------E--------------------------SSS-ESS--------------[]----[]--------EE----[]----E--E-EE-E--EE-E----XXXXXX-------------------------------[]-E--[]XXXXXXX---EE-XXXX--------------[][]------[]-E-------------XX--XX-------------[]-------[]--[][]-E-----E--E-EE--[]----------EE-E-E------------------------------E-----XXXXXXE-X-----------X--[]------------[]----------E-EE-----[]-----------------X-----EE---------------XXXXX-----------XXXXXXXXX-------X---EE-E--------------[]---------[]---E-[]----------------E-EE---------[]-[]--EE----------------------------------------------X---XX-----E---------E-EE-E--E------E--[]-------E----------E-----------------------------------------[]--------------------XXXXE----------E------------------E-EE-E-----E---------------------XXXXXXE-X--X--------X--E---------XXXXXS-SSSS------E------------[]--[]--------S-----E--E-------[]--[]--[]---oo-----------------S------SSSo----------------------------------XXXXX----X----E-X-E-EE-----[]----------------X---E----EE-E---XXX------XXXX-------------ooo----------------[]----EE-E--[]--[]--------[]----[]--------------------[]----E-----E-EE---[]--[]-------E-E-[]-----[]--EE-[]--E-------XXXXXXXXXXXX-------X-----XX-------[][]----------------------------------------[]---------------[]--[]--X---E[]-------[][]--------------SSSSSSSSSSSo-------E-----------E-EE----E-----XXXX-SSS--E---------[]--------------
---XS--------------XXX------XXXXXXXXXXXXXXXXXXXXXXXXXXXX-----XXXXXXXXXXXXXX-X-XXX--X-------------------------XXXXXXXXXXXXXXXXXXXXX-X-X--XXXXXXXXXXXXXXXXXXXXXXXXXXXXXX-XXXXXXXXXXXXXXXXXXXXXXXXXXXXXXXXXXXXXXXXXXXXXXXXXXXXXXXXXXXXXXXXXXXXXXXXXXXXXXXXXXXXX--XX------------------------XXXXXXXXXXXXXXXXXXXXXXXXXXXXXX-------XXXXXXXXXXXXXXXXXXXXXXXXXXXXXXXXXXXXXXXXX--XXXXXXXXXXXXXXXXXXXXXXXXXXXXXXXXXXXXXXXXXXXXXXXXXXXXXXXXXXXXXXXXXXXXXXX---XXXXX---X-----XXXXXXXXXXXXXXXXXXXXXXXXXXXXXXXXXXXXXXXXXXXXXXXXXXXXXXXXXXXXXXXXXXXXXXXXXXXXXXXXXXXX-XXXXXXXXXXXXXXXXXXXXXXXXXXXXXXXXXXXXXXXXXXXXXXXXXXXXXXXXXXXXXXXXXXXXXXXXXXXXXXXXXXXXXXXXXXXXXXXXXXXXXXXXXXXXXXXXXXXXXXXXXXXXXXXXXXXXXXXXXXXXXXXXXXXXXXXXXXXXXXXXXX----XXX---XXXXXXX-XXXXXXXX---XXXXXXXXXXXXXXXXXXXXXXXXXXXXXXXXXXXXXXXXXXXXXXXXXXXXXXXXXXXXXXXX-----XXXXX--XXXXXXXXXXXXXXXXXXXXXXXXXXX-XXXXXXXXXXXXXXXXXXXXXXXXXXXXX-XXXXXXXXXXXXXXXXXXXXXXXXXXXXXXXXXXXXXX--XXXXXXXXXXXXXXXXXXXXXXXXXXXXXXXXXXXXXXXXXXXXXX-X--XXXXXXXXXXXXXXXXXXXXXXXXXXXXXX-XX-XXXXXXXXXXXXXXXXXXXXXX-XXX-XXX-------XXXXXXX---X--XXXX-XXX------------------------XXXXXXXXXXXXXX---XXX-XX-X-XXXXXXXXXXXXXXXXXXXXXXXXXXXXXXX-XXXXXXXXXXXXXXXXXXXXXXXXXXXXXXXXXXXX---XXX------------XXXXXXXXXXXXXXXXXX--XXXXXXX-XXXXXXXXXXXXXXXXXXXXXXXXXXXXXXXXXXXXXXXXXXXXXXXXXXXXXXXXXXXXXXXXXXXXXXXXXXXXXXXXXXXXXXXXXXXXXXXXXXXXXXXXXXXXXXXXXX-------XXXXXXXXXX----XXXXXXXXXXX----XXXXX----XXXXXXXXXXXXXXXXXXXXX----XXXXXXXXXXXXXXXXXXXXXXXXXXXXXXXXXXXXXX--X-XXXXXXXXXXXXXXXXXXXXXXXXXXXXXXXXXXXXXXXXXXXXXXXXX---XXXXXXXXXXXXXXXXXXXXXXXXXXXXXX