------------------------------------------------------------------------------------------------------------------------------------------------------------------------------------------------------------------------------------------------------------------------------------------------------------------------------------------------------------------------------------------------------------------------------------------------------------------------------------------------------------------------------------------------------------------------------------------------------------------------------------------------------------------------------------------------------------------------------------------------------------------------------------------------------------------------------------------------------------------------------------------------------------------------------------------------------------------------------------------------------------------------------------------------------------------------------------------------------------------------------------------------------------------------------------------------------------------------------------------------------------------------------------------------------------------------------------------------------------------------------------------------------------------------------------------------------------------------------------------------------------------------------------------------------------------------
---------------------------------------------------------------------------------------------------------------------------------------------------------------------------------------------------------------------------------------------------------------------------------------------------------------------------------------------------------------------------------------------------------------------------------------------------------------------------------------------------------------------------------------------XX-------------------------------------------------------------------------------------------------------------------------------------------------------------------------------------------------------------------------------------------------------------------------------------------------------------------------------------------------------------------------------------------------------------------------------------------------------------------------------------------------------------------------------------------------------------------------------------------------------------------------------------------------------------------------------------------------------------------------------------------------------------------------------------------------------------------------------------------------------------------------------------------------------------------------------------------------------------------------------------------------------------------------
SSSSSSSSSSSSSSSSSSSSSSSSSSSS---------------------------------------------oo-----------------------------------------------------------------oo--------------------------------------------------------------------------------------------------------------------------------------------------------------------------------------------------------------------------------------------------------------------------------------------------------------------------------------------------------------------------SSSSSSSSSSSSSSSSSSSS---S-SSS-S--------------------------------------------------------------------------------------------------------------------------------------------------------------------------------------------------SSSSSSSSSSSSSSSSSSSSSSSSSSSS-----------------------------------------------------------------------------------------------------------------------------------------------------------------------------------------------------------o---------------------------------------------------------------------------------------------------------------------------------------------------------------------------------------------------------------------------------------------------------------------------------------------------------------------------------------------------------------------------------------------------S--SS-SSSESSSSS---------S--------------------------------------------------------------------------------------------------------------------------------------------
-------------SSSS--------------------------------------------------------XXX--------------------------------------------------------------------E--E-------------------------------------------------------------------------------------------------------------------------------------------------------------------------------------------------------------------------------------------------------------------------------------------------------------------------------------------------------------------------------------S-XS--SSoS---oS-----------------------------------------------------------------------------------------------------------------------------o------------------------------------------------------------------------------------------------------------------------------------------------------------------------------------------------------------------------------------------------------------?------------------------------------------XXXX-------------------------------------------------------------------------------------------------------------------------------------------------------------------------------------------------------------------------------------------------------------------------------------------------------------------------------------------------o------------------------------------------------SSS-----?-S--SS--------oS---------------------------o----------------------------------------------------------------------------------------------------------------
-------------SSSS-----------------------------------------------------------------------------------------------------------------------------------oo--oo------------oo-----------------------------------------E----------------------------------------------------------------------------------------------------------------------------------------------------------------------------E-----------------------------------------------------o--------------------------------------------------------------------------------------ES--XSSS---ES-----------------------------------------------------------------------------------------------------------------------E-----------------------------------------------------------------------------------------------------------------------------------------------------------------E--??------------E--o-----------------------------------------------------------------------------------------------------------------E---------X----------------------------------------------------------------------------------------------------------------------------------------------------------------------------------------------------------------------E------------o----------E------------------------------------------------------------------------------------------------------------------o-------------------------------SSS-------S--SS--E-----ES--------------------------------------------------------E-----------------------------------------------------------------------------------
-------------SSSSSS--------S----------------------------------SSSQS--------------------?----------------------------------------SSSS--------oo----------------------XXXX------------------------SSQQ-----------SSSSSSSSSSS------SSSSS--------SQQSSSSS-----------------------------------SSS-S-?-------------?-----------------------------QQQQQ----?----------------SSSSS----SSS--------S---SS?SSSSS--------------------------------SSSSS------------------------------------------------S------SS-----SSS----E----------------------------SS-----X---SS---SS---Q-Q-------------------------------------------------------------XXX-------------------------------SS----------SSS--SSS---------SSS--------------------------------SSSQ----------------------------------------------SSSS--------XXo---EE-------------------SS--SQS--------SS----SQS-S??-----------XXXXX-------SQ-Q--------SSSSS-----S----------------------SSSSS-S----SS---------S---SS----S---------------SSS-------SSS--S-Q---------------------S---------------------------------------------------------S?SSS--SSSS----------------------S-----SSS------------SS--SSS---SSSQQ----------SSS-------------------------XXX------------QQQQ--------------SS--SQ----------------SSSS-------------------------------------------------------------------SSQ----------------??SSS------XXX-----o-------o--------SSSQ----------X--------S---SS?----------SS---------oo-----------E-----------------------------SSSSSS----SS--SQS---------------SSSSSS---S----------------------------------------------------
---------------------------------------------oo-------------------------------------------------------------------E----------------------------------------------------------------------------------------------------------XXX--------------------------------------------------------------------------------------------------------------------------------------------------------------------------------------------------------------------------------------------------------ES-------------------<>----------------------------SS---------SS---SS------------------------------------------------------------o-----XXXX---------------------------------------------------------------------------------------------------------------------------------------------------XXXX-----------------XXXX-----------------------------------------------------------------------------------------------------------------E--------------------S------------------------------------S--E-------------E------------------------------------------------------------------------------------------------------------------------------------------------------------------------------------------------------------------------------------------------------------------------------------------------------------------------------XXX---------------------XX-----------------------------------SS-----------SS------------------o-------------------------------------------SS------------------------------------------XSSSS-----------------------------------
-----XS--o------------------XX-XXX---S-------------------------------o--------------------------------oo-------------------------------------------------------------------------------------------------------------------o-oo---------------------------------------------------------------------------------------------------------------------------------------------------------------------------------------o--------------------------------------------------------------------------------------[]----------------------------SS---------SS---SS---S-S----------------------------------------------------------XSXXXX----Q------------------------------------------------------------------------------------XX--------------------------------------------------XX-------------------------o--------------------------------------------------------------------------------------------------------------------------------------------------------------E---------------S-S-------------<>--------------------------------------------------------------------------------------------------------------------------------------------------------------------------------XX-------------------------------------------------------------------------------------------E-----------------------------------------------------------------------oo-------------o----------------------SS-----------SS--S-S----------XXXXX------XX----------------------------------SS------------------S----------------------XXX--------------------------------------
----XX-------?---------------------------------------------------------------------S-----o-----------------------SQ-Q----------------------XXXX------------------------------------------------------------------------------------------------------------------------E---------------------------------E-----------ooo-------oo---------------SS-SQS---------E-------------------------------------------------------------------------------------------------S----------------------SS-----------------------------------------E-------SS---Q---X-SS---SS---SoS---o----------------------------------ooo----------------XXXXXXX----------------E------------------------------------------------E------------------o----S---------------------------------------------------------------------------------------------------------------------------------------------------------------------o--------------------------S-S-S-------------------------X-------------<>-------E-------SoS----------E--[]-------------------------------------------------------------------------------------------------------------------oo-------------------------SSSSSS----------------------------XX----------------o------E--E--------------E----SSSSSSS------E----------------------S--E----<>-----------------S-----------------E----------SSSSSS--------------------------------------------------X--ooooSS-----------SS--QoS---------------------XX---------------------------------XSS------------------S---E---XX--oo--------XXXX--SQ-------S--------------------------
---XXX--SS--SS?SQ--------E-S-------S?S------------------Q---S?SQ-SSSSS--------------oo-------------XX-------------------------------------XX--------------------------------<>--------------E-----------Q-Q--------XXX-SSSS------E--X----Q--QQQQ---SQ-----------------<>------E------------E---------E--<><>-----------------------------S?SQSQ---------------<>--------------SS-------XX--X------------------------S------------E------------------XXX--------------------------X--X---SS------Q-Q--------S----------------------<>--------S---SSSSX--SS--SS---SSS--S-------------------------E---------------------------XXXXXXXX---------------<>--------E--S-------------Q-Q--------------SSS--<>-----------------------X-----QSSSSQS----------------SS-------ooo------------------------------XXX---SS----X----------------Q---------SS----S?S---------------------QQQQ---SSS------------------QS--S?S--------------------------SSS--------S--------XXX-------------[]------<>---SS--S?S---------<>--[]------S----------Q--Q--------------X--------------------------------XXXX-SSSS------------------QQQQ---<>---S------------Q---S?Q-?SSQQ-------------------------------------------XX------Q--SSS----------<>--SS--S?S-------<>----------------<>--------------E---------<>----[]-------E-----------------QQ-------<>------------------------XXXXX----------X--------S?S------------------SSSSSS-----------S---SSS------XXX--S-------XXXX----------------------SS--------XXSS--SSS----XX--X-------SSSS----o--o------XXXXX---------X----------------------------
--XXXXX--S-S----S-----------------------------------XXXX-----------------XX-----------------------XXX------------------------------------XXX-----E-E------------------------[]-------------<>----------------------------------X-E--X---------------------------------[]------E-----------<>--------<>--[][]------------------E-E------------------------E----[]----------------------XXX--XX----------X---------------E--------<>-----------------------------------------------X--X------------------E------E-------------------[]----------E-----X---------------------------------XX-?----<>--------------------------XXXXXXXXX---------------[]-------<>--------------------------------------[]-----------------------X----------------------------------o----E------------------------------------------X-----------------------------------------<>-----E----------------------------------X----------------------------------------------------EXXX-------------[]------[]-------------------[]--[]----------------------------------XX-----------------------X------------------------E-----------------[]-------------------------------------------------E------E---------------XX----------------------[]----------------[]----------------[]------E-E----<>---------[]----[]------<>----------------E---------[]-------E------------------------------XX---------------E--------E-----------XX------------------XXXXX-----------XXXX------------------------------EXXX---------XXXX--XX-----EE----------------XXXXXX--------XX----------------------------
-XXXXX--SSSS----S--------------------------------------------------------XX----------------------XXXXX-------------------------X--------XXXX----<><>------------------------[]-------------[]---------------------------------XX----X---------------------------------[]------------------[]--------[]--[][]-----------------<><>-----------------------<>----[]----<>---------------XXXX--XXX---------X--------------<>--------[]-----------------------------------------------X--X-----------------<>--------------------------[]----------------------------------------------------------[]----------------------<>-XXXXXXXXXX---------------[]-------[]------X-------------------------------[]-----------------------X---------------------------------XXXXXXXX-----------------------------------------X-----------------------------------------[]-----------------------------------<>---X---------------------<>---------------------------EXXXXX-------------[]------[]-------------------[]--[]---------------------------------XXX-----------------------X-----------------------<>-----------------[]------------------------------------------------<>-----<>---------------XX----------------------[]----------------[]----------------[]-----<>[>----[]---------[]----[]------[]---------------<>---------[]------<>--------------------X-------ooXXX-------------<>-------<>----------XXXX--X--------------XX------------X-XXXX----------------------------EXX-XX--------XXXXX--XXXX--------------------XXXXXXX-------XXX----------------------------
XXXXXXX-----ooo-----EE-EE-EE---------------------------------------------X----------------------XXXXXX-------------E----EE-E-E-X-------XXXXX----[][]------------------------[]-------------[]--------------------------------XXXE---X----E--------E-----E----------E--[]------------------[]--------[]-E[][]-----------------[][]-----------------------[]-E--[]----[]-------E-E----XXXXX--XXXXE-------X--------------[]--------[]--------------------------------------E--E-EE--X--X-----------------[]-----X--------E-----EE-E--[]------------------EE---E--------E-E-----------------------[]-----------S--E-------[]XXXXXXXXXXX--------EE-E---[]-------[]-E----X----------------------------E--[]---------E-------------X-----EE-------------------------XXX----------------EE-----------------------------X---EE-E--------------EE------------------[]-------------------EE-------E------[]---SE-E------------EE----[]--------E-------E-----E----XXXXXX---E-E-------[]------[]------EE-----------[]--[]-------------------------------XXXXX-----E-E--E-EE-----E---X-----------------------[]----------EE-----[]----------E-E-----------------------------------[]-----[]---------------XX---E-EE--E---------E--[]--EE------------[]----------------[]-----[][]----[]---------[]----[]------[]---------------[]-----E---[]----E-[]-------------XXXX-------------XXX-------------[]-------[]---------XXXXXE-X------EE-E--SXX---------------XXXX--EE-----------E-E--E--E----XXXXXXE-E----XXXXXX--XXXX-------------------XXXXXXXX------XXXX--------EE-----E------------
XXXXXX------XXXXXXXXXXXXXXXX--XXXXXXXXXXXXXXX-XXXXX-----XXXXXXSSXXXXXX---X-XXXXXXXXXXXXXXXXXXXXXXXXXX---XXXXXX-X----XXXXXXXXXXXXXXXXXXXXXXXXXXXXXXXXXXXXXXX---XXXXXXX-S-XXXXXXXXXXXXXXXXXXXXXXXXXXXXX---XXXXXXXXX----XXXXXXXXXXXXXXXXXXXXXXXXXXXXXXXXXXXXXXXXXXXXXXXXXXXXXXXXXXXXXXXXXX--XXXXXXXXXXXXXXXXXXXXXXXXXXXXXXXXXXXXXXXXXXXXXX-XXXXXXX-XXXXXXXXXXXXXXXXXXXXXXXX----XXXXXXXXXXXXXXXXXXXXXXXXXX-XXXXXXXXXXXXXXXXXXXXXXXXXXXXXXXXXXXXXXXXXXXX-------XXXXXXXXXXXXXXXXX--XXX-XXXXXXXXXXXXXXXXXXXXXXXXXXXXXXXXXXXXXXXXXXXXXXXXXXXXXXXXXXXXXXXXXXX--XXXXXXXXXXXXXXXXXXXXXXXXXXXXXX-----XXXXXXXXXXXXXXX-----XXXXXXXXXXXXXXXXXXXXXXXXXXXXXXXXXXXXXXXXXXXXXXXXXXXXXXXXXXXXXXXXXXXXXXXXXXXXXXXXXXXXXXXXXXXXXXXXXXX-XXXXXXXXXXXXXXXXXXXXXXXXXXXXXXXXXXXXXXXXXXXXXXS-----------X-XXXXXXXXXXXXXXXXXX------XXXXXXXXXXXXXXXXXXXXXXXXXXXXXXXXXXXXXXXXXXXXXXXXXXXXXXX-XXXXXXXXXXXXXXXXXXXXXXXXXXXXXXXXXXXX--XXXXXXXXXXXXXXXXXXXXXXXXXXXXXXXXXXXXXXXXXXXXXXXXXXXXXXXXXXXXXXXXXXXXXXXXXXXXXXXXXXXXXXXXXXXXXXXXXXXXXXXXXXXXXXXXXX-XXXX-XXXXXXX--XXXXXXXXXXXXXXXXXXXXXXXXXXXXXXXXXXXXXXXXXXXX----XXXX-----XXXXXXXXXXXXXXXXXXXXXXXXXXXXXXXXXXXXXX-XXXXXXXXXXXXXX-------XXXXXXX--XXXXXXXXXXXXXXXXXXXXXXX---XXXXXXXXXXXXXXXXXXXXXXXXXXXXXXXXXXXXXXXXXXXXXXXXXXXXXXXXXXXXXXXXXXXXXXXXXXXXXXXXXXXXXX[]XXXXXXXXXXXXXXXXXXXXXXXX--XXXXXXXXXXXXXXXXXXXXXXXXXXXXXXXXXXXX-X----------------XX---X-XXXXXXXXXXXXXXXXXXXXXXXXXXXXXXXXXXXXXXXXXXXXXXXXXXXX--------XX-XXXXXXXXXXXXXXX-XXXXXXXXXXXXXXXXXXXXXXXXXXXXXXXXXXXXXXX-XXXXXXXXXXXXX-XXXXXXXXXXXXXXXXXX----XXXXXX----XXXXXXXXXXXXXXXXXXXXXXXX