-----------------------------------------XX--S-X------------------------------------------------------------------------------------------------------------------------------------------------------------------------------------------------------------------------------------------------------------------------------------------------------------------------------------------------------------------------------------------------------------------------------------------------------------------------------------------------------------------------------------------------------------------------------------------------------------------------------------------------------------------------------------------------------------------------------------------------------------------------------------------------------------------------------------------------------------------------------------------------------------------------------------------------------------------------------------------------------------------------------------------------------------------------------------------------------------------------------------------------------------------------------------------------------------------------------------------------------------------------------------------------------------------------------------------------------------------------------------------------------------------------------------------------------------------------------------------------------------------------
-----------------------------------------S-XX--S-E----------------------------------------------------------------------------------------------------------------------------------------------------------------------------------------------------------------------------------------------------------------------------------------------------------------------------------------------------------------------------------------------------------------------------------------------------------------------------------------------------------------------------------------------------------------------------------------------------------------------------------------------------------------------------------------------------------------------------------------------------------------------------------------------------------------------------------------------------------------------------------------------------------------------------------------------------------------------------------------------------------------------------------------------------------------------------------------------------------------------------------------------------------------------------------------------------------------------------------------------------------------------------------------------------------------------------------------------------------------------------------------------------------------------------------------------------------------------------------------------------------------------
---------------------------------------------S----------SSSSSSSSSSSSSSSSSSSSSSSSSSSS----------------------------o-------------------------------------------------------SSSSS--SSSSSSSSSS------SS------------------------------------------------------------------------------------------------------------------------------------------------------------------------------------------------------S--------------------------------------------------------------------------------------------------------------------------------------------------------------------------------------------------------------------------------------------------------------------------------------------------------------------SSSSS----SSSESSSS--------------------------------------------------------------------------------------------------------------------------------------------oo-----------------------------------------------------------------------------------------------------------------------------------------------------------------------------------------------------------------------------------------------------------------------------------------------------------------------------------------------------------------------------------------------------------------SSSSSSSSSSSSSSSSSSSS------------------------------------SSSSSSSSSSSSSSSSSSSSSSSSSSSS------------------------------------------------------------------------------------SSSSSSSSSSSSSSSSS--SSSSSSSSS--------------------------------------------------------
---------------------------------------XXXXX-------XXXX------------------------------------------------------------------------------------------------------------------SSSS----Q--------------------------------------------------------------------------------------------------------------------------------------------------------------------------------------------------------------------oS-------------------------o-------------------------------------------------------------------------------------------------------------------------------------------------------------------------------------------------------------------------------------------------------------------------------------------SSS-----Q-?----SS?-------oS-------------------------------------------------------------------------------------------------------------------------------XXXXX-----------------------------?-----------------------------------------------------------------------------------------------------------------------------------------------------------------------------------------------------------------------------------------------------------------------------------------------------------------------------------------------------------------------------------------------------X-------------------------------------S--------------------------------------------------------------------------------------------------------------------------------------------------------------------------------------------------
--------------------------------------XX--------XX---------------------------------------------------------------------------------------------------------EE------------SSSS-E-----------------------------------------------------------------------------------------------------------------------------------oo-----------------------------------------------------------------------------------SE-----------------------------------------------------------------------------------------------------------o------------------------------------------------------------------------------------------------------------------------------E------------------------------------------------------------------------ESSS--E------X---S---------S-----------------------------------------------------------------------------------------------------------------------Eooo--------------------------------------------------------------------------------------------------------------------------------------------------------------------------------------------------------------------o--------------------------------------------------------------------------------------------------------------------------------------------------------------------------------------------------------------------------XXX--------------oo----------------SS-------------------------------------------------------------------------------------------------------------------------------------------------------------------------------------------------
---------------------------------X-------------------SS?--------------------------------------------------XXX---------------------------------------------SSSS---?------------SS-------------SS--------S-Q-------------------------SSQS-?--------------SSSS--------------------------SSS----S---?S--------------------------------------------------------------SSSSS--------------------------SS-----ESSS---SSS-------------SSSSS-S----------------------------------------SSQSSSSSS---SS--SS---------------------XXXX-SSSS--------SSSSSSSSSSSS--------------------------------------------------------------------------------------------------SQS--SQS---------S----------------------------QSSS--------------S?SSS------S----SS------------SSS---XS------SSSS----------------------------------------------------------------------------------------------------Q----S---XXXX-------XX----------------XXX----------XXX---------------------SS------SSS------------------------------------------------------------------SSSS--------------------------------SSS----SSQSSSSS----SS---o----??-------S?SSS-------------oo-------------S---------------Q-QQ--------------SSSSSSSSSSS------------------------------Q---------------------SSSS------------------------------SSS-----------?SSS---S------------------------------------E--------E--------------------------------------------------QQQ------------SSSSSSS-------------------------------------------------SSSS-----------------------------------SSS---SS-----------------S--SSSSS----------QQ-Q---------
-------------------------------o---o-----E---E------------------------------------------------------------XXX-----------------------------------------------------------------SS-------------SS-----------------------------------------------------------------------------------------------------------------------------------------------------------------------------------------o------SS----<>-SS------------------------------------------------------------------------------------------------------------------------------------------------------------------------E------------------------------------------------------------------------------------------------------------------------------------------S----SS------------SSS-----------------------------------------------------------------------------XSSS---------------ooo------------------------------------XXSSS-------------------------XXXX----------------------------------------------------------------------------------------------------------------------------------------------------------------<>-----XXX----XXX------------------------------------------------------------------------------------------------------------------------------------------------------------------------------------------------------------------------<>-------<>----------------------------------------------------------------------------------------------------------------------------------------------------------------S-----------------------E-------------------------------
------------------------------XXX-XXX--XXXXXXXX-XX---------------------------------------------XXX------XXXXX------------------------E-------------------E--------------------SS-------------SS------------------------------------------------------------------------------------------------------------------------------------------------------------------------------------------------SS----[]-SS----S----------------------------------------------XXX------------------------------------------------------o-------------------------------------------------------------------------------X----Q----------------------------------------------------------------------------------------------------------------------SS-------------SS----------------------------------------------------------------------------XXX-------------------------------------------------------XXXX--------------------------XXXXS------------------E-------------------------------E-------------------------------------------------------------------------------------------------------------[]------------------------------------------------------------------XX----------------------------------------------------------------------------o--------------------------------------------------------------------------------SS----[]-------[]----------------------------------------------------E-----------------------------------------------------------------------------------------------------------S-------------------------------------------------------
---------o---------------------------------------o------------------------------------------------------XXXXX-----------------------<>----------------------------------?-oo--SS-------E--S-SSS----------------------------------------------------------S------------------------E-----------------------XXXX------------------------------------------------------------------------E------?-SS----[]-SS---oSS----------------SS--------------------------XXXX-------------------S-----?----------------E------------------------------------E---------------------------------S-SQ-----------------X--o----------------------------------------------------------QS-------------------------X---------oooo-----------------ooo-SS--E--o---??-SSS--EEX----------------------------------S-----------------------------------XXXSS-SQ--------------------------------------------------XXXXX--------o----o-----------XXXXX---------E--------<>------------X------------------------------------------E-----S------X--------------------------EX-----------E--------E-----------------------[------------------------E------------------------------------------X--------------------------X--XXX------------E-----------------------E------------------E------------------------------------------------E--------E-----oooooooSS----[--------XXX------------o----------------S-S-------------oo--------------------------------------E--ooo--------------------------------------o-----------------------------S------------------------S----EE-------------E----------
-------E--o------------------------------------------------------------SSQ-----------------------------XXXXXX--E-----------------E--[]-------------E------SSSSSSQS--------SS--SSS-S---<>-----------S-----S-----------E--------Q----SSS-------------------------QQQQ--------------<>---S----E-Q--Q--X----------------------------------------------------------XXXX-SS------X---------<>---------S----XX-SS--SSSS--S------SS-----SSSS-QQQ-------------------XXXX--------------S-----SS-SS-----S-----------<>-----E---S?---?QSQ--------------SSSSS-----EE-E-----------------------------------S----X--XXX--S-----------------------------X---------E-----QQQQ-----------------------------------XXQQ--------------XXXX-SSSS-----SSSSS--<>------S---S--oSSSQ---QQQ----------------------S------------------<>----S-o----S-------XXXXX---------------E---------------S?S----X----XX--------XXXXXX------------------------XXXXXX--------<>-----E--[]-----E-----XX---E------------S?S----------------------<>-----------XX----QQQ--QQQ-------------<>X----------<>-------<>----E?S----------XXXXX--------------------------XXXXX--SSS-------------Q---Q--Q--Q--QQQQ---X---QQQ------------S------XX----------------<>---Q--Q-----------------XXXXX------------<>-----E----------S---------QQQQ--Q--------------<>-------<>-----?SSSSSSSS----S?S------------XX--------------------------------------------S?S-----------SQ?--QQQ-------------<>------------------------oo------------------------SS-------------------------S?SSS----------------S---SSSS---SS---Q--<>---Q------
------<>---------XXX--------XXXXXX--------------------------------------------------------------------XXXXXXX--------E----------<>--[]----------X-<>----------------------------------[]-----------X----------------<>-------E------------------------------------------------E--[]-------------------------------------------XXXXX?---------------E------E--------E------XX---------[]-----------E---E---------------------------E------XXX-----XX-?-----XXXXX-----------------------E------------------[]----<>-----------------XX-------EE--------XXXXXXXXXX?------------------------------E--X--XX-------------------------------XXX-------------------------------E-----------E---------XXX-------------------------------------[]-----E------EE-E-----------------------------E---E---------E-----[]------------------XXXXXX--------------<>------------------------------------XXXXXXX--SSS------------------XXXXXXX--------[]----<>--[]----<>----XXX--<>---------E---------------------------[]-----E-E--XXX-------------------------[]X----E-----[]-------[]-------------------------------E-----------------------------------------------------------X------------------------XXX----------------[]----------------------------X------------[]----<>---------------XX------------------E-----[]-------[]--------------------------------------E---------------------------------------------------------------------------[]------------------------------------------XXX----------------E---------------------------------------ES----E---------[]----------
------[]--------------------XXX-------------------------------------------------------------------E--XXXXXXXX-------<>----------[]--[]----------X-[]--X-------------------------------[]-----------X----------------[]---<>-<>-----------------------------------------------<>--[]---------------------------------------------------------------<>---------------------XXX---------[]------------------------------------------------------------------XXXXXX-----X------------------------------------[]----[]----------------XXX---X-------EE--X---------------------------------------------XX-XXX-----------------------------XXXX---------------------------X--------------<>-----<>-XXXX-------------------------------------[]------------------------------------E-------<>--<>--------<>-----[]------------------XXXXXX--------------[]-------------<>-----------------<>-XXXXXXXX----------------------XXXXXXXX--------[]----[]--[]----[]----XXX--[]--------<>---------------------------[]----<><>-XXXX-------------------------[]X---<>-----[]-------[]------------------------------<>-----------------------------XX----X-----------------------X-----------------------XXXX----------------[]----------------------------XX--------X--[]----[]--------------XXX------------------------[]-------[]-------------------------------------<>-------------------------------------------------X-------------------------[]--------------------------------------------o----ESSS-------<>---------------------------------X---------------------[]----------
------[]---------------------------------------------------------------------------------------------XXXXXXXX-------[]----E-EE--[]--[]----------X-[]--X-------------------------------[]---E-----X-X-E--------E-EE--[]---[]-[]---E-E-----------------EE---XX------E----E-----[]--[]---------------------------------------------------------------[]--------------------XXXX--EE-E-E-[]----E----------X-E-EE-------E-----E------------------------------XXXXXXX-----X-------EE---------------------------[]----[]---------------XXXX-E-X-----------X-------------------------------E-----E-E-E---XX-XXX---SS-----------------------XXXXX---------------------------X--------EE----[]-----[]XXXXX----------------------------E----E---[]-----------------------------------------E--[]--[]--------[]-----[]-----------------XXXXXXX--------------[]-------------[]---------ooo-----[]XXXXXXXXX---------------------XXXXXXXXX-----E--[]----[]--[]----[]-----XX--[]--------[]-----------------EE-E--E---[]----[][]XXXXX-----------------------XX[]X---[]-E---[]-------[]--------------ooo-------------[]--X---X---------------------XXX----X----------------EE-----X--------E--E----------XXXXX----------E-E---[]----------------------------XXX-----XXX--[]----[]-------------XXXX-E-E-------E---------E--[]----E--[]-------------EE----------------------[]---------------------------------------E---------X-E-------------------EE--[]------------------------------------------------------------[]-----------E-EE------------------X---------------E-----[]-------EE-
XXXXXXXXXXX-XXXX------XXXXXX--------------XXXXXX---XXXX-XXXXXXXXXX--XXXXXXXXXXXXXXXXXX----X--X-X--XXXXXXXXXXXXXXXXXXXXXXXXXXXXXXXXXXXXXXXXXXXXXXXXXXXXXXXXXXXXXXXXXXXXXXXXXXXXXXXXXXXXXXXXXXXXXXXXXXXXXXXXXXXXXXXXXXXXXXXXXXXXXXXXXXXXXXXXXXXX---XXXXXXXXXXXXXXXXXXXXXXXXXXXXXXXXXXXXXXXXXXXXXXXXXX-----------------XXXX--XXXX------XXXXXXXXXXXXXXXXXXXX-XXXXXX---XXXXXXXXXX-XXXXXXXXXXXXXXXXXXXXXXXXXXXXXXXXXXXXXXXXXXXXXXXXXXXXXXXXXXXX----XX-----XXXXXXXXXX--XXXXXXXXXXXXXXXXXXXXXXXXXXXXXXXXXXXXXXXXXXXXXXXXXXXXXXXXXXXXXXXXXXXXXXXXXXXXXXXXX--X-----------XXXXXXXXXXXXXXXXXX-XXXXXXXXXXXXXXXXXXXXXXXXXXX-X-XX-X-XXXX--XXXXXXXXXXXXXXXXXXXXXXXXXXXXXXXXXXXXXXXXXX-X-XX-XXXXXXXXXXXXXXXXXXXXXXXXXXXXXXX-XXXX------XXXX---XXXXXXXXXXXXXXXXXXXXXXXXXXXXXXXX--XXXXXXXX---XXX-XXXXXXXXXXXXXXXXXXXXXXXXXXXXXXXXXXXXXXXXXXXXXXXXXXXXX-X----XXXXXXXXXXXXXXXXXXXXXXXXXXXXXXXX-XXXX-----XXXXXXXXXXXXX---XX-XXXX---XXX-XXXXXXXXXXXXXXXXXXXXXXXXXXXXXXXXXXXXXXXXXXXXXXXXXXXXXXXXXXXXXXX-XXXX---XXXXXXXXXXXXXXXXXXXXXXXXXXXXXX-XXXXXXXXXX------XXXXXXXXXXXXXXXXXXXXXXXXXXXXXXXXXXXXX--------XXX----------XXXXXXXXXXXX-XXXXXXXX------XXXXXXXXXXXXXXXXXXXXXXXQXXXXXXXXXXXXX----XXXXXXXXX--XXXXXXXXXXXXX---XXXXXXXXXXXXXXXXXXXXXXXXXXXXXXXXXXX---X----XXXXXXXXXXX--XXXXXXXXXXXX--XXXXXXXXXXXXXXXXXXXXXXXXXXXXXXXXXXXXXX-XXXXXXXXXXXXXXXXXXXXXXXXXXXX--------------XXXXXX-X-XXX-------XXXXXXXX-XXX-XXXXXXXXXXXXXXXXXXXXXXXXXXXXXXXXXX---XXXXXXXXXXXXXXXXXXXXXXXXXXXXX----XXXXXXXXXXXXXXXXXXXX----XX-----------XXXXXXXXXXXXXXXXXXXXXXXXXXXXX-XXXXXXXXXXXXXXXXXXXXXXXXXXXXXXXXXXXXXXXXX