-------------------------------------------------------------------------------------------------------------------------------------------------------------------------------------------------------------------------------------------------------------------------------------------------------------------------------------------------------------------------------------------------------------------------------------------------------------------------------------------------------------------------------------------------------------------------------------------------------------XX---------------------------------------------------------------------------------------------------------------------------------------------------------------------------------------------------------------------------------------------------------------------------------------------------------------------------------------------------------------------------------------------------------------------------------------------------------------------------------------------------------------------------------------------------------------------------------------------------------------------------------------------------------------------------------------------------------------------------------------------------------------------------------------------------------------------------------------------------------------------------------------------------------------------------------------------------------
-----------------------------------------------------------------------------------------------------S------------------------------------------------------------------------------------------------------------------------------------------------------------------------------------------------------------------------------------------------------------------------------------------------------------------------------------------------------------------------------------------------------------------------------------------------------------------------------------------------------------------------------------------------------------------------------------------------------------------------------------------------------------------------------------------------------------------------------------------------------------------------------------------------------------------------------------------------------------------------------------------------------------------------------------------------------------------------------------------------------------------------------------------------------------------------------------------------------------------------------------------------------------------------------------------------------------------------------------------------------------------------------------------------------------------------------------------------------------------------------------------------------------------------------------------------------------------
-------------------------------------------------------------oo---------------------------------------------o---SSSSSSSSSSSS-SSSSSSSSSSSSSSS----------------------------------------------------------------------------------------------------------------------------------------------------------------------------------------------------------------------------------------------------------------------------------------------------------------------------------------------------------------------------------------------------------------------------------------------------------------SSSSSS-----------?SSSSSSSSSS---------------------------------------------------------------------------------------------------------------------------------------------------------------------------------------------------------------------------------------------------o------------------------------------------------------------------------------------------------------------------------------SSSSSSSSSSSS-SS-------------------------------------------------------------------------------------------------------------------------------------------------------------------------------SSSSSSSSSSSSSSSSSSSSSSSSSSSS--------------------------------------------------------------------------------------------------------------------------------------------------------------------------------------------------------------------------------------------------------------------------------------------------------------------
-----------------------------------------------------------------E--E--------------------------------------------SSSS--------------------------------------------------------------------------------------------------------------------------------------------------------------------------------------X-------------------------------------------o---------------------------------------------------------------------------------------------------------------------------------------------------------------------------------------------------------------------------SS-----------------------SSSS----------------------------------------------------------------------------------------------------------------------------------------------------------------------------------------------------------------------------------------------------------------------------X---------------------------------------------------------------------------------------------------------------------------------------------------------oo------?--------------------------------------------------------------------------------------------------------------------------------o------------------------SSSSSSSSSSSSSSSSSSS-----------------------------------------------------------------------------------------------------------------------------------------------------------------------------------------------------------------------------------------------------------------------------------------------------------------------------
----------------------------------------------------------------XXXX----------------------oo----------XXX--------SSSS--EE-------------------------------------------------------oo--oo----------------------------------------------E---------------------------------------------------------------------o--oo------------------------------------------oo--------------Eoo----------------E----------------------------------------------Eooo-------------------------------------------------------------------------------------------------------------------------------------S---E-------------------SSSS-----------------------------------------------------------------------------------------------------------------------------------------------------------------------------------------oooo---------------------------o------------------oo--------------------------------------------------------------XXX-------------------------------------------------------------------------------------------------------------XXX---------Eooo-------------------------------------------------------------------------------------------------------------------------------------------------------------SSSSSSSSSSSSSSSSSSS----------------Eooo--------------------------------------------------------------------------------------------------------------------------------------------------------------------------------------------------------------------------------------------------------------------------------------------oooooooo-----
----------------------QQ-QQQ-----------------------------------------------------SS--------------------------XXX--SS---SS------------------------------------------------------------------------------oo---------------------------QSSS---SS-----------QQQ---------------------------------------XXXX-----o-------o---------?SSS----------------------XXXXX-------------XXX---------------SQS-------SSS-------------------------------oo--XXXXX--------XXX-----SSSSS-------XXo-----oo---------------------SSSSS----SSSS-------------------?SSS----------------SS------------------S---SS-----------SS--------SS--------ooo--o---------------------Q-------------------S------------------------------------SS---SS------------------------------X----------SSQSSS--------------------------------------XXXXX-----------SQQQ-----------XXX---------------XX-----------------S----------------------------S------------------------QQQ-----------SSS------------------X------------------------------------------SSQQ-----------------------------------XXXXX---------------------------SS-----------SSSS-----------SSS------------------------------------------E-----oo---XXXoo-------------SQS-----------------SSS----SSSSSSSSSSSSSSSSSSS--QQ------------XXXXX----------------SSSSS-------XXo-----oo----------------------------------------------------------SSSSSSS--------E------S?------------------------SSS-------E??SSS-------SSSS---SSSS-------?SSSS---?SSS----------------------------SSS--XX------------SSS--??SSS-------------S-----------XXXX-------X-----
-----------------------------------------------------------E--------------o----------------------o-------o--------SS---ES---------------------------------------------------------------XSSS-----------------------XXX--------------------------------------------------------------------------------------------XX------------------------------XXXX--------------------------------------------------------------------------------------------------XXXX---------------------------------------------------------------------------------------------------------------------------SS?----------SS--------SS---------------------------------------------------------------------------------------------------------------------------------XX---------------------------------------------------------------------------------------------------------------oo---------------------------------------------------------------------------------------------------------------------------------------------------------------------E------------------------------------------------------------------------------------XX--------------------------------XX---XX-------------------XX-------------------------------------------------------------------------XX-------------------------------------------------------------------------------------------------------<>---------XXXXXX--------------------------<>---------------------------------------------------------------------------XXX----E----------------------------------------------------------
-------------------------------XSS--o-------------------XXXXXXXXX-------------------------------XXX--XX-XXX-------SS----S--------------------------------------------------------------XX----------X----------------------------------------------------------------E--------------------------------------------EoX-------------------------------------------------------------------------------------------------------------XXS-------------------XXXX-------------------------------o--------------------------------------------------------------------------------------------SS-----------SS--------SS------S-S-SS-S-----------------------------------------S-------------------------------------------------------------------------XX-------------------------------------------------------------------------------------------------------------------------------------------------------------------------------S-E---------------------------------------------------------------------------------------------------<>------------------------------------------------------------------------------------XX---------------------------------------------------------oo-------------------------------------------------------------------------XXX----------------------------------------------------------------------------------------E--------------[]-----------------------------------------[]-------------------------------------------------------------XXX-----------XXX---XXX---------------------------------------------------------
-----S------------------------XXX----------------oo---------------------------XX-oo------------XXX--------------?-SS----SS----------------------------------------------X---oo---------XXSS-S-----X-----------------------------------------------------------------------------------------------------------------S------------------E-----E--Q-------------------------------------------------------------------------------XXX-------------------XXXXX-----------------------------------------------E-----------------------------------------SSSSSS---------E----S----------ooooSS----ooooo--SS---EE-ooSS---SoS--So??-S------------oo--------------o-----E------So--------------------E----------------------------EX------oo------------XXXX------E-------------------------o--------------X--------------------------------------------------------XXXXX--------------------------------S----------E------------E----------------------------------------------------E-----------E--S-----E------------------------------------[]----------------------------------------------------------SSSS----------------S---XXXX-----------------------------------------------------------------------o--------------------?--------E--E--------------------------XXX-----------------------------------------------------XXX------------------------------------------------[]-----------------------------------------[]--------------E----------------------------------------SS----XX--oo-E-EE---XX---------------------------------E------------------------------
---------------------SSSSSSS-XXXX-S-----XX-----------------------------------XX---------SS----------------------??SSS---SSS--E-QS--------------E-------------------X---E---o--o-------XXXX--------XX-----XXXXX------------------------S----S--------E---QQ?Q------S?S---S----------------------XX----XXXXXX-XXXXX------Q--Q-QSSQ-----E<>----<>-------------SS----XX-----------------------S?QQQ--QQ----------------<>----------XXXX------XXXX--------XXXXXX---------------------XXXX--SXX-------------E--<>----------------------------------------X--------------<>----------S----SSSSSS-S-------------SSS?SSS----SSS--SSS--S---------------------S----E------<>------SSS-------E---E-E----<>---------------------------<>X-------------------XXXX------<>---S------------------------------XXX----------XX----Q---Q----QQQQ-----------XXX----------XXXXX-------------------------------------------------<>-----------<>--------S?S-----------QQ?--QQS---------------------<>------E---<>-------<>--------E---S--------------------E--[]----S-------------------X------------E--------------------------------------------XXXX-------------------S--------------------X-XXXXXXXXXXXXXXX---?SSSS------------------------SSSS?SSSSSSSSSSSSS--EQ-QQ-Q---------------XXXX-----------XXX-----------XXXX--XXXX-----------EE-E------------------------------------S?S--------------XXX---XXXX--------------E-------S----------[]--------------S-XX-XX-----------------QQQQ--Q--------------XXXX----------X-XX-----------QQQ---Q-----S--------<>-----------------XX-----------
----------------------------XXXXX------------E------------------------------XXX---------------------------------------E-----E------------E----<>---------E---------X-----------------XXXXX------XXXX--------------------------o---------E----------<>----------------------E-----------X-------------------------------------------E<>[]----[]-----------E-------XX-SSX-------------------------------------E------[]---------XXXXX-----------------XXXXXXX------------------------------------------<>--[]--------------------------------------XXX--------------[]------E----------------------------E------------------------------E----------------<>------[]-------------------<><>----[]---------------------------[]X------------------XXXXX------[]-----E---Xo--X----------------XXXX---------------XXXX-----------------------XXXX----------------------------------------------------------------[]-----------[]--E------------------------------------------------[]-----<>---[]-------[]-------<>---------------------E-<>--[]-----------------------XX-----------<>------------------------------------------XXXXXX------------------------------------------------------------------------------------XXX--SSSS-SSSSSSSSSSSSS----------------------XXXXXX-------------------------------------X---------XXXXXXX------------------------------------------------------------------------<>------------------[]----X-----------E--XX-------------------------------------XXXXX----E----EX-XX-------------------E------E-----[]--------------------E------XXX
-<>---------X---------------XXXXX--SS-------<>-----------------------------XXXX----------SSSS-------------------------------------------------[]--------<>---------X----------------XXXXXX-----XXXXX-----------XXXX----XXX-------------------------[]------X--------------<>-----------X------------------------------------------<>[][]----[]--------------EE--XXX----------------------------------------<>------[]--------XXXXXX----------------XXXXXXXX------------------------------------------[]--[]----<>------X------------------------XXXX--------------[]-----<>----------------------------------------------------------------------------[]------[]-------------------[][]----[]---------------------------[]X-----------------XXXXXX------[]---------XX--X----------X--------------------------------------------------XXXXX---------------o------------------------------------------------[]-----------[]-<>------------------------------------------------[]-----[]---[]-------[]X---X--[]-----------------------[]--[]-------------------XX--XX-----------[]--------------------------------------E---XXXXXX----X-----------------------------------------------------o-----------------------------SSSSS-SSSSSSSSSSSSS--------------------XXXXXXXXX------------------------------------X-----------------------------------------------------------X----------------------------[]------------------[]----X--------------XXX-----------------------------------XXXXXX------------XXX-----------------<>-----<>-----[]--------------------XXXX------
-[]----E------E-------------XXXXX-----------[]----------------------------XXXXX------X------------------------------------------E-E-----------[]--------[]--E--E---X---------------XXXXXXX----SXXXXX--ooo------------------------------------------[]------X--------------[]-----------XXXXXXXXX--XXXX-------------X------------E-[][][]----[]-E---------------XXXX----X?----E-EE-E------------E-EE----X---[]-E-E--[]-E-E---XXXXXXX---ooo---------XXXXXXXXX------------------ooo---------------EE-E--[]--[]----[]------X-----------E-----------XXXXX--------------[]-----[]----------E-------------------------------------------------------------E---[]--E---[]---------------E---[][]----[]--------EE----EE-----------[]X---------------E-X-XXXX------[]---------XX--X------E--XX---------------------------------E--------E-E----XXXXXX-----XXXooo---XXX-----------------------------------------E--E--[]------X----[]-[]----E----------------------------------E-----E--[]-----[]---[]-------[]X---X--[]-----------------EE-E--[]--[]-E--E------------------XX-----------[]-----E-----------EE-E-E-S---------E-------XXXXXX----X----EE-EE--------------------XXXXXX-----------------XXX----------------------------SSSSSSSSSSSSSSSSSSS---------------XXXXXXXXXXXXX--SSSSS---------------ooo------------X------------------------------EE-E--------------------E-E--X-------------------------E--[]-----E------------[]----X--------------XXX--E--XX------------------------E-E-XXXXXX---------X--XXX--E-E-----E------[]---E-[]--E--[]-------X----XXX---------------
XXXXXXXXXXXXXXXXXXX-XXXXXXXXXXXX-----XXXXXXXXXXXX---XXXXXX-XXXXX-X-XX-XXXXXXXX-----XXX-----------------------XXXXXXXXXXXXXXXXXXXXXXXXXXXXXXX--XXXXXX-XXXXXXXXXXXXXXX----XXXXXXXXXXXXXXXXX---QXXXXXX---XXX-----------------------XXXXXXXXXXXXXXXXXXXXXXXXXXXX--XXXXXXXXXXXXXXXXXXXXXXXX-X----------------------------XXXXXXXXXXXXXXXXXXXXXXXXXXXXXXXX-X--X-XXXXXXXXXXX--XXXXXXXXXXXXXXXXXXXXXXXXXXXXXXXXXXXXXXXXXXXXXXXXXXXXXXXXXXX-X--XXX---X-XXXXXXXXXXXXXXXXXXXXXXXXXXXX---XXX--------X---XXXXXXXXXXXXXXXXXXXXXXXXXXXXXXXXXXXXXXXXXXX--XXXXXXXXXXXXXXXXXXXXXXXXXXXXXXXXXXXXXXXXXXXXXXXXXXXXXXXXXXXXXXXXXXX--XXXXXXXXXXXXXXXXXXXXXXXXXXX---XXXXXXXXXXXXXXXXXXXXXXXXXXXXXXXXXXXXXXXXXXXXXXXXXXXX---XXXXXXXXXXXXXXXXXXXXXXXXXXXXXXX---XXXXXXXXXXXXXXXXXXXXXXXXXXXXXXXXXXXXXXXXXXXXXXXXXXX------------------------XXXXXXXXXXXXXXXXXXXXXXXXXX---------XXX------------------XXXXXXXXXX---X-----XXXXXXXXXXXXXXXXXXXXXXXXXXXXXXXXXXXXXXXXXXXXXXXXXXXXXXXXXXXXX----XXXXXXXXXXXXXXXXXXXXXXXXXXXXXXXXXXXXXXXXXXXXXXXXXXXXXXX-XXXXXXXXXXXXXXXXXXXXXXXXXXXXXXXXXXXXXXXXXXX--XXXX---XXX-XXXXXXXXXXXXXX--XXXXXXXXXXXXXX-XX-XXXX-XX-XXXXXXXXXXXXXXXXXXXXXXXXXXXXXXXXXXXXXXXXXX----------------------------XXXXXXXXXXXXXXXXXXXXXXX-----XXXXXXXXXXXXXXXXXXXXXXXXXXXXXXXX----XXXXXXXXXXX-----XXXX------XXXX---XXX------------XXXXX----------------XX--XXXXXXXXXXXXXXXXXXXXXXXXXXXXXXXXXXXXXXXXXXXXXX-------XXXXXXXXXXXXXXXXXXXXXXXXXXXXXXXXXXXXXXXXXXXXXXX-----XXXXXXXXXXXXXXXXXXXXXXXXQ--XXXXXXXXXXXXXXXX--XXX-XXXXX--XXXXXXXXXXXXXXXXXXXXXXXXXXXXXXXXXXXXXXXX--------------------------