------------------------------------------------------------------------------------------------------------------------------------------------------------------------------------------------------------------------------------------------------------------------------------------------------------------------------------------------------------------------------------------------------------------------------------------------------------------------------------------------------------------------------------------------------------------------------------------------------------------------------------------------------------------------------------------------------------------------------------------------------------------------------------------------------------------------------------------------------------------------------------------------------------------------------------------------------------------------------------------------------------------------------------------------------------------------------------------------------------------------------------------------------------------------------------------------------------------------------------------------------------------------------------------------------------------------------------------------------------------------------------------------------------------------------------------------------------------------------------------------------------------------------------------------------------------------
---------------------------------------------------------------------------------------------------------------------------------------------------------------------------------------------------------------------------------------------------------------------------------------------------------------------------------------------------------------------------------------------------------------------------------------------------------------------------------------------------------------------------------------------------------------------------------------------------------------------------------------------------------------------------------------------------------------------------------------------------------------------------------------------------------------------------------------------------------------------------------------------------------------------------------------------------------------------------------------------------------------------------------------------------------------------------------------------------------------------------------------------------------------------------------------------------------------------------------------------------------------------------------------------------------------------------------------------------------------------------------------------------S--------------------------------------------------------------------------------------------------------------------------------------------------------------------
-----------------------------------------------------------------------------------------------------------------------------------------------------------------------------------------------------------------------oo-------------------------oo--------------------------------------------------------------------------------------------------------------------------------------------------------------------------------------------------------------------------------------------------------------------------------------------------------------------------------------------------------------------------------------------------------------------------------------------SSSSSSSSSSSSSSSSSSSSSS-------------------------------------ooo------------------------------------------------------------------------------------------------oo------------------------------------SSSSSSSSSSSSSS----SSSSSSSSSSSSSSSSSSSSSSSSSSSSSSSSSSS----------------------------------------------------------------------------------------------------------------------S---X--------------------------------------oo-----------------------------------------oo---------------------------------------------------------------------------------------------------------------------------------------------------------------------------------------------SSSSSSSSSSSSSSSSSSSSSSSSSSSS-------------------------------------------------------------------------------------------------------------------------------------------------oo---------------------
---------------------------------o--------------------------------------------------------------------------------------------------------------o---------------------------------------------------------------------XXXX------------------------------------------------------------------------------------------------------------------------------------------------------------------------------------------------------------------------------------------------------------------------------------------------------------------------------------------------------------------------------------------------------------------------------------------------Q--------------------------------------------------------------------------------XXXX---------------------------------------------------------------------------------Q--o------?------------------------------------?------------------------------------SS---S-SSSSSSSSS---SSSS-------oo----------------------------------------------------------------------------------------------------------SS------------------------------oo-----------XX--------------------------------------------E--E---------------------------------------------------------------------------------------------------------------------------------------------------------------------------------------SSSSSSSSSSSSSSSSSSSSSSSSSSSS---S----------------------oS----------------------------------------------------------------------------------------------oo---------------------XXX--------------------
----------------------------X---E------------------------------------------------------------------------------------------------------------------------------------------------------------------------E-------------------------------oo--------------------------------------------------------------------------------------------------------------------------------------------E----E----------------------------------------------------------------------------------------------------------------------------------------------------------------------------------------------------------------------------------------------------------------------------------------------------------------------------------------------------------------------------------------------------------------------------------------oo--------------o---------------------------------oooooooo-------------------------------------SS--E--SSSSSSSSS---SSSS-------------------------------------oo--oo------------------------------------------------------------------------SS-------------------------------------------------XXX------------------------------------XXXXXXX-------------------------------------------------------------------------------------------------------------------------------------------------------------------------------------SSSSSSSSSSSSSSSSSSSSSSSSSSSS--SS-----------------------S---------------------------------------------------------------------------------------------------------oo---------------------------------
-------------------------------SQS-----------------------------SSS------------------SSS-------------SSSSSS-----------------S------------------SSS------SSS----------SSSS----------------SQS-------------SQS---?---------------------o---XXXX-----------------------------------SSSS---------------------SSS---------SSSS-------SSS--SSSSSS--------SQS-------S----------QQ--------SS---SQS--SQS---?---------?--------------------------Q----------------------------------------------------------SS--------------XX----------o--XXX-------XX----------SSS---?--------------------SS---SS-------------------S----------------E--------oo-------------------------Q-QQSS---------------E--------------------------------------------------------------------------------------------------------------------------------------E---------X-------------XXXX------E--------------o--XXX-XX--------------------------------------------------S--SSSSSSS-S-----S----------XXXX-----------------o-----------------------------------SSQQ---------------------------SS-------SSS----------SS------------------SS--------XXXX-----ooo--------S?SSS---------------?----------------------------------S-----------------------------S-?----------------SSS------SSQQ------------------------------------SSQQSS------------SQQS-------------SSSSS---------------XXX-------------SSSSSSSSSSSSSSSSSSSSSSSSSSSS-S----SS---------S------SS------------------------------------------------EE-------------------SSSS--SSS----------------------E-----XXX-----------SS-------------------S
------------------------------------------------------------------------------------------------------------------------------------------Eo-------------------------------------------------------------------------SS-----------XXXX----------------------------------------------------------------------------------------------------------------------------------------------------------------------------------SSS?--------------------------oo---------------------------------------------------------XX-------XXX------------XXX-------------------------------------------------------------------E--------------------------------------------------------------------<>----------------------------------------------------------------------------------------------------------------------------------------XXSSS-----------XXX------------<>----------------------------------------------------------------------<>-----------------------XXXX-------------------------------------X--------------------------------------------------------------------------SS-----------E-----------X-------------E-------------------------------------------------------ooo------------------------------------------------------------------------------------------------------------------------------------------------------------------------------------------------------------E-----------------------SS------------------------------------------------------------------------------------------------o--------------------------------------------S
----------------X--------X---------------------------------------------------------------------------------------------------------------<>S-----------------------o-----------------------------------------------XX-----------------------------------XXX------------------------------------------------------------------------------------------------------------------------------------------------------------XX-o------------o-----------------------------------------------------------------------XXXXS---o----------------XXXX------------------------------------------------------------------XXXXXXX-----------XX--------------------------------------------------[]-----------------------------------------------------------------------------------------------------------------------------------------------------------------------[]-------------------------------XXXXXX---------------------------------[]------------------------------------------------X-------------------------------E----------------------------------------------------------SS----------<>------------------------------------------------------------------------------------------------------------------------------------------------------S-E--------------E---------------------------------------------------------------------------------------XXXXX----------------------------------------------S-----SS--------------------------XXSS-----------------------o-------------------------------------XXX-XXX-------------Eo-----------------------------
------------------------XXX--------------------------------------------------------------------------------------------------------------[]S---------E-EE----------------------------------------E------------------XSS-SQ------------------------------------------------------S--------------------------------------------------------------------------oo-----------------------------------------------oo---------XXS---------------------------------------oo---------------------------------------------XXXX--------------------XXXX---------------------------------E---------------------------------------------------X--oo-------------E--------E--------SSSS-----------[]--S------------------oo-------------oo-oo-------------------------SS----------S-----------------------------------------X----------------XXSS--------------------------[]-------------------------------------------S-SQS----------------------[]------oooooooS-------QQ-------------------Q------XX----------------------------<>---------------S--------------------XS----------------ooo-SS-------E--[]-SQ------------------------XXXXX----SSSSS--------------------SSS-o---------------E-------------------------------------------------------------oo---?-S---------------<>--------------------------------------------------------------------------------------------------S-SS----?--------E----------S----------SS-----SS-------------------------XXX----o-------------------------------------------------------------------------------------------------------------
-EE-E------------------XXXX---SSSS-QQ----E-----------------------------------------------------QQQ-Q-S----X--------------QQQ--------E----[]S----QQQ------XX-XX--SSS---------------SQ----SSS-----<>------S?SS-------XXX--------------------------------------------------XX-XXX---------X---------------------------X-?-QQ-QQ-Q--Q-----------------ESSS----------QQQ--QQQ-------------Q--Q--Q--Q--Q-------oooo-o-------XXXX---------XSSS----E----------------XX-----------------------------------QS----------XX-XXXX-SS----------------XXXXX-----------Q-Q--Q---------------<>---SQS--SS-------E------XX--XX---------oo----------X----------------<>----E--<>---QQ??----------XS----XX-----------------------------------oE---------E----------------------E-----E-------X--X-------QQQ----------------------XXX---------------XX-----------------X---SSS----XX-----------------X-----XXXXX------------------------------------------[]-----?SSSSSSSSS--SSSS---------XX----------------------XXXXXXX------------------[]---QQ?SSS----E------------SSS------XXX-XX-------------SS-SSS--S---<>--[]--------------XX--XXXXXX-----------------------------------------SSS---S-----E--<>->------SS------Q--Q-Q----------------oS-------------X------o-------S?S-----------SS[]-----------------Q--QSSS---SQS---------SSS-----XX--X-----SS---------------------XXX--SS--------XXXX--S---S?SSSSSSSSSSS-------SSS--S------SS-----SSSS----------------------XXXX-------------S---XX----------X---------Q--Q--Q-----------X-XXX------------XXXXXXXXX---------SS----------S---------
XXXXXXXXXX-?----------XXXXX-------------<>---------------X---------------------------------------------E--X------------------------<>----[]S-------------XX-XX---------X------------------------[]----------------XXXX---------------------------X---------------------XXXXXXX--------XX--------------------------XX---------------E---E-------------------------------------E------E-------------------------------XXXXXX--------XX------<>-----E---------XXX-------------E--------------E------------------XXXXXXX-----------------XXXXXXX-----------------------E--------[]----------------<>-----EXX--XX----------E----------X-------<>-------[]---<>--[]-----------------------[]---------------------------------------------<>---------------------<>----<>-------?--XX------------------------------XXXX-------------XXXXX--------XX---------------XXXX-SSS-----------------------E------------XXX---------------------------[]-----------------------------------------S----------------------E--------------[]------------<>--------------------XXX--XX-------------------------[]--[]----------------------------------------------------------------------E-----<>--[][]------SS-------------------------------------------X------------------------------[]----------------------------------------------XXX--XX--------------------------------------X--XXXXX-X-----------------------------E-----------E---SS---------------------XXXXX-----------------------------X--------------------------XX-------------------------XXX-------------------------XX-
---------------------XXXXXX-------------[]----<>---------X-----------------------------X------------------X------------------------[]----[]S------------EXX-XXX-------XX------------------------[]---------------XXXXX-----------------------E---XX--------------------EXXXXXX-------XXX-------------------------XXX------------------------E----------------------------------------------------------------------EXXXXXX-------XXX------[]--------------XXXX------------<>-------------<>------------------XXXXXXX--S-------------XXXXXXXX----------------------<>--------[]----------------[]----XXXX--XX---X----------E------X-------[]-------[]---[]--[]-----------------------[]---------------------------------------------[]--<>-----------------[]----[]----------XXX----------------------------XXXXX------------XXXXX--------XXX-------------EXXXXX---------------------------XXXX--ooo---XXXXXX-------------------------[]-----------------------------------------------o---------------<>--------------[]------------[]------------------XXXXXX-XXX---------X------------X-[]--[]-------------------------o-------------------------------------X------------[]--[][]------SS---------------------------------------X---X-X----------------------------[]---------------------------------------------XXXXX-XXX---------X--------------------------XXXXXXXXX---X--------------------------<>--------------SSS--------------------XXXXXX-----------------------------X-------------------------XXX--------------------------o-E------------------------XXX
--------------------XXXXXXX-------------[]----[]---------X------E---E-EE--------E-E-EE-X------------E-E---X----------E-EE-----E-E--[]----[]S-------------X--XXX--EE---XX-----EE-E------EE-------[]--------------XXXXXX---S-------XX----X---------X-----EE-----------EE-XXXXXXX---E--XXXX---E----EE-----E--------XXXX-----------------------------E-----------------E-EE--------------E-----------------X-----------XXXXXXX----S-XXXX------[]-------------XXXXX------------[]-------------[]----------E---E---XXXXXXX--SS-----------XXXXXXXXX---------E----------E-[]------E-[]--E-------------[]---XX-XX--XX---X-----------------X-------[]-------[]---[]--[]-----------------------[]---------------------------------------------[]--[]-----------------[]----[]-E--E--X--XXXX---E----E-EE--------------XXXXXX-----------XXXXXX--SS?SSS----SSS-------------XX-----E--------o----XX----------------XXXXX-------------------------E--[]----------------------------------------SSS-------oo-----------[]--------------[]----E-------[]--------E--------XXXXXX--XXXX-------XX-EE---------X-[]--[]--------SSSS------------XXX------------------------------------X---E-----E--[]--[][]--------------E-EE----E----------XXXE-------EE-EE--X-------------EE---------------[]-----------------E--E----------------E-E----XXXXX--XXXX--E----XX-------------------------XXXXXXXXXX---------------------E-EE-----[]------E-------E-------E--E-E---E-EE-XXXXXXX-----------------------------X-----------------------XXXXX-------------ooo-----------------EE-E------E-E-------XXX
-----------XXX---XXXXXXXXX--XXXXXXXXXXXXXXXXXXXXXXXXXXXXXX--XXXXXXXXXXXXXXXXXXXXXXXXXXXXXXXXXXXXXXXXXXXXXXXXXXXXXXXXXXXXXXXXXXXXXXXXXXXX-XXXXXXXXXXXXXX--X--XXXXXXXXXXXXXXXXXXXXXXXXXXXXXXXXXXXXXXXXXXXXXXXXXXXXXXXXX-------XXXX-X------XXXXXX---XXXXXXXXXXXXXXXXXXXXXXXXXXXXXXXXXXXXXXXX-X-XXXXXXXXXXXXXXXXXXXXXXXXXXXXXXXXXXXXXX--XXXXXXXXXX--XXXXXXXXXXXXX-XXXXX-XXXXX---XXXXXXXXXXXXXXXXXXXXXXXXXXXXXXXXXXXXXXXXXXXXX----XXXXXXXXXXXXXXXXXXXXXXXXXXXXXXXX--X----XX-XXXXXXXX--XXXXXXXXXXX--X-XXXXXXX-XXXXXXXXXXX-XXXX-X-X----XXXXXXXXXXXXXXX-XXXXXXXXXXXXXXXXXXXXXXXXXXXXXXXXXXXXXXXXXXXXXXXXXXXXX-XX--XXXX-X---XXX-XX-X-XX--XX-XXXXXXXXXXXXXXXXXXXXXXXXXXXXXXXX-X-XXXXXXXXXXXXXXXXXXXXXXX---XXXXXXXXXXXX--XXXXXXXXXXXX--XXXXXXXXXXXXXXXXXXXXXXXXXXXXXXXXXXXXXXXXXXXXXXXXXXXXXXXXXXXXXXXXXXXXX--XXXXXXXXXX-X-XXXX----XXXXXXXX----Q-ESSSS--X-X------XXXXXXXXXXX---XXXX--XXXX----------------------XXXXX-------XXXXXXX----XXXXXXXXXXXXXXXXXXXXXXXXXXXXXXXXXXXXXXX------XXXXX--SS--SSXXXXXX---------XXXXXX-------X-XXXXXXXXXXXXXXXXXXXXXXXXXXXXXXXXXXXXXXXXXX--XXXXXXXXXXXXXXXXXXXXXXXXXXXXXXXXXXXXXXXXX-XXX------------------------XXXXXXXXXXXXXXXX---XXXXXXXXXXXXXXXXXXXXXXXXXXXXXXXXXXXXXXXXXXXXXXXXXXXXXXXXXXXXXXXXXXXXXXXXXXXXXXXXXXXXXXXXXXXX-XXXXXXXXXXXXXXXXXXXXXXXXXXXX--XXXXXXXXXXXXXXXXXXXXXXXXXXXXXXXXXXXXXXX--XXXXXXXXXXXXXXXXXXXXXXXXX-X------XXXXXXXXXXXXXX------XXXXXXXXXXXXXX-XXXXXXXXXXXXXXXXXXXXXXXXXXXXXXXXXXXXXXXXXXXXXXXXXXXXXX--XX----XXXXXXXXX---XXXXXXXXXXXXXXXXXXXXXXXXXXXXXXXXXXXXXXX-------------XXX------------XXXXXXXXXXXXXXXXXXXXXXXXXXXX