------------------------------------------------------------------------------------------------------------------------------------------------------------------------------------------------------------------------------------------------------------------------------------------------------------------------------------------------------------------------------------------------------------------------------------------------------------------------------------------------------------------------------------------------------------------------------------------------------------------------------------------------------------------------------------------------------------------------------------------------------------------------------------------------------------------------------------------------------------------------------------------------------------------------------------------------------------------------------------------------------------------------------------------------------------------------------------------------------------------------------------------------------------------------------------------------------------------------------------------------------------------------------------------------------------------------------------------------------------------------------------------------------------------------------------------------------------------------------------------------------------------------------------------------------------------------
------------------------------------------------------------------------------------------------------------------------------------------------------------------------------------------------------------------------------------------------------------------------------------------------------------------------------------------------------------------------------------------------------------------------------------------------------------------------------------------------------------------------------------------------------------------------------------------------------------------------------------------------------------------------------------------------------------------------------------------------------------------------------------------------------------------------------------------------------------------------------------------------------------------------------------------------------------------------------------------------------------------------------------------------------------------------------------------------------------------------------------------------------------------------------------------------------------------------------------------------------------------------------------------------------------------------------------------------------------------------------------------------------------------------------------------------------------------------------------------------------------------------------------------------------------------------
SSS--SSSSSSSSSSSSS--SS-SSS----------------------------------------------------------SSSSSSSSSSSSSSSSSSSSS-------------------------------------------------------------------------------------------------------------------------------------------------------------------------------------------------------------------------------------------------------------------------------------------------------------------------------oo----------------------SSSSSSSSSS---------------------------------------------------------------------------SSS-----SS-ESS-SSS------S------------------------------SSSSSSSSSS-------SSSSSSSSSSS----------------------------------------------------------------------------------------------------------------------------------------------------------------------------------------------------------------------------------------------------------------------------------------------------------------------------------------------------------------------------------------------------------------------------------------------------------------------------------------------------------------------------------------------------------------------------------------------------------------------------------------------------------------------------------------------------------------------------------------------------------------------------------------------------------------------------------ooo-------SSSSSSS--SS-------------------------------------------------------------------------
--------SS---------------------------------------------------------------------------------------------------------------------------------------------------------------------------------------------------------------------------------------------------------------------------------------oo------------------------------------------------------------------------------------------------------------------------------------XXXX-----------------------------------------------oS----------------------------------------------------------SSS----Q-?-S--SS----?-SooS--------------------------------------------------------------------------------------------------------------o--------------------------------------------------------------------------------------------------------------------------------------------------------------------------------------------------------------------------------------------------------------------------------------------------------------------o----------------------------------------------------------------------------------------------------------------------------------------------------------------------------------------------------------------------------------------------------------------------------------------------------------------------------------------------------------------------------------------------------------------------------------------o-------------XXXX--------SSS-------------------------------------------------------------------------------
------S-SS-------------------------------------------------------------------XX------------------------------X------------------------------------------------------------------------------------------------------------------------------------------------------------------------------------------------------E-------------------------------------------------------------------------------------------------------------------------------------------------------------E--------S----------------------------------------------------------SSS--E---?SS--SS--S---SSSS------------------------------------------------------------------------------------------------------------------------------------------------------------------------------------------------------------------------------------------------------------------------------------------------------------------------------------------------E-----------------------------------------------------------------------E-----------------------------------------------------------------------------------------------------------------------------------------------------------------------------------------------------------------------------------------------------------------------------------------------------------------------------------------------E---------------------------------------------------------------------------------------------------------------------------X-SSS-------------------------------------------------------------------------------
-------SS------------------------------------------------------------------------------------------------------------------------------SSSSS--------------------SSSSS---SSS------SSS-----E------------------------------SSSSS------S-Q-----------S----------------S----------S---------------------XXXX------------oSS--SSS---------SSSS-SSSSSSSSSSSS---XXX-----------------Q?SSS-------------XXS--------SS---S----------SS-------SS---------------------------S----------------SSQ--SSS--------------------XX-----------SSS-------SSSSSS-----------------SSS---X-Q-----SS--SSS-------------------------SSSS--SSQ--------------------------------------------S-----------------------S------SS-S-----------SS---SSSSSSSS--------------------------XX------------------------------SSQ----------------X------SSS---S----------------------------------------------SSS---S--------------------------------------------------------SS--SSS-------------------------------------SSSSSS-----------------XS--SQS-S-----SSS--QQS---------------oo-------------------------XX----------S------SQ-------------------------------------------------------SS----------------------------------------------------------------------S-------------------------------------------SQSSSSS---SSS-----------------------------------------------------SSS--------------SSSSSSSS--------SSS-----------------------------------------XXX---------------------------oo-------?SSS-------XX----------------S----SS?----------------S-----------------S----SSSS--------------QS---------------
----------------------------------------------------------------------------------------------------------------------------------------------------------------------------------------<>-----------------------------------------------------------------------------------oo-----------X-----------------------XX------------------------------X-----------------------------------------XXXXX-------------------------------------E----------------------------------------------SS---------------------XXSS------------------------------------------SSS----------SSS--SSS-------------------------------------------------------------------------------------------------------------SS-----------------------------------------o-------------------E-----------------------------------------XX--------------------------oo--------------------------o---------------------------------------------oo------------------------------------------------------------------------------------------------------------------------------------------------------XX----------------------------------------------------------------------------------------------------------------------------------------------------------------------------------------------------------------------------------------------------------------------------------------------------------------------------------------------XX--------------------------------XXX------------------------------S----SS?---------E------S---------------------------------------------------------
-----------------------------------------------------------o----------------------------------------------------------------------------------------------------------------------------[]-------------------------------------------------------------------------------------E----------------------------------o-----------------------------------------------------------------------EXXXXX-------------------------------------------------------------------------------------SS-------------------EXXX--------------------------------------------SSS---S-S----SSS--SSS-------------------------------S-----------------------------------------------------------------------------SS----------------------------------------------------------XXXXXXXXX--------------XX--------------------XX----------------------------E---------------------------E------------------------------------------------------------------------------------------------------------------------------------------------------------------------------------------------XX-XX------------------------------E-----------------------------------------E-------------------------------------------------------------------------------------------------------------------------------------------------------------------------------------------------------E----------------------------------------------------------XX-XX--------------------------------oo-------------------------------S-S--SS---------<>------S----------------------------------------------------E----
----?-----------------------XX----------------------------------------------------oo-ooo----E------------E------XXX-----------E-------------------------------------------XXX-----------[]------------SSSS---------E-----SSS-S---------------------------------------------E--<>-----------------------S--------------------------------------------------------------------S-----------XXXXXXXX-----------------------------------X-SQ------------E----------XX------------------?--SS-----X-------------XXXX---------------------------------------oooooSS----So---?oSS---SSS-----------------o-------------------------------------------------------------------------------------S-----SS-----------------------------X--------------------------------------------------XXXS----------------E--XX----------------------------------------------E--S-----<>---------------------------------------------------------------------------------------ooS------------------------------S--E---E------E----------------------oooo----------------SSS-----------XXX-XX-------S------------------E--<>--------------oo----------------S-------<>---------------E-----------------------------X-S--------------------------------------------------oS---------------------------------------------E--S-SQ---------------------------------------------------------------------------------------------------------XXX-XX----------o------oo----------------SSSSSS----------------------?-SoS?--S---------[]------S----------E-------------------------------------E--<>----
-X----SSSSSSSS--E-------E---S-----<>---------XX----------EEEE------------------------------<>-----------<>-----------E-------<>------SSS--------------------QQ?----Q-------------S?S----XXS----------Q------------<>-----------------S----------QQQ--QQQ----------S-------<>--[]----------------------XXXXX---------Q---SSS-------------------XX-----XXX--S------------------ooS-------XXXXXXXXX---------S---SSS------------------XX--------------<>---------XXX--SS------------SSS--SS----X-------------XXXXX---------X---QQ--Q-Q--Q--Q-----------X--SSSSSS----SSS--S--S---SSS?--------------E----------E---?SSS--------Q-Q-------------Q-----------------------XXX-----------------SS-----SSSS---------------S----------XX------------------------XXXX---------------------XXXX----------------<>-------------------E--------E---E----------------<>-----E--[]----------------------------E-----------------------------E-XX--QS--SSS--------S------o-----S--------------SSSSSSS--------<>--<>-----<>-----------------S-----------XXXX--SXX-----------------XXX-XXX--------------QQSSQS----E<>--[]-E-----------------------S?--------E----[]---------E----<>----------------------------XX---------------E--S--------S---------------S---------------E------------SQSSSS-------QQ---E-------<>--------------------------S-----Q-----------X---------SSSSSSSSSS--------SS----------------------oooo----------XXX--XX--------XX-------------XXXX--SXX------------------XXXX-----------SSS---S-S-----QS[]------SS--------<>---E--Q-------------QQ--QQQQ--Q-----<>--[]----
-X-----SSS-----<>------<>---------[]----------------XXXX-XXXXXXX-X-------------------------[]-----E-----[]----------<>----E--[]--------------------E-E------------------------------------------------------------[]------------------------------------------------------[]--[]-----E-------------------XX-------------------XX-------------XXX----------E-------X-------------------XXXXXXXXXX---------------------------------XXX--------------[]--------XXXX----------XX------------E--X------------XXXXXX-------EXX--------------------------XX---------XX-----------EE-----------------<>---------<>------------------------------------------------------XXXX--------------------------SS-----------XX--XX--------XXX------------------------XX-----E----------------XXXXX-XX-----E-----E-[]--X--E---------------------<>--------------------[]----<>--[]-------S----E------E-------<>----------------------------<>-XX--------------------E---E-----------------E-----------------[]--[]-----[]------------------------------------------------------XXXX-XXX----------------------E<>[]--[]<>--------------------------------<>----[]--------<>----[]--------------------E------XXX--------------<>----------SS--------------------XX--------<>--------------------------------------[]------------------E----------------------E--X--------------------------------------------------------------E-XXXX--XX---------------------------------------------------------------------------------[]----------------[]--<>-----------------------------E--[]--[]----
-X----SSSS-----[]------[]---------[]-------------------------------------------------------[]----<>-----[]----------[]---<>--[]-------------------<><>------------------------------------------------------------[]------------------------------------------------------[]--[]----<>--------------X----XXX----ooXX---------X-XX--X-X------XXXX--------------E---X------------------XXXXXXXXXXX-------o------------------------XXXX--------------[]-------XXXXX---------XXX---X-----------X-----------XXXXXXX-------XXX------------------------XXXX--------XXX------------------------------[]---------[]------------------------------------------------------XXXX---------------X----------SS---------------XXX------XXXX------------------------X----------------------XXXXXX--X----<>-------[]----<>---------------------[]--------------------[]----[]--[]-------S---<>-----<>-<>----[]------X---------------------[]-XX-------------------<>--------------------<>-----------------[]---------[]------------X----------------------------------------XXXXX-XXX---------------------<>[][]--SS[]--------------------------------[]----[]--------[]----[]-------------------<>-----XXXX--------------[]----------SS--------------------X---------[]--------------------------------------[]-----------------<>-------------------------X------------------------------------------------------------EXXXXXXX--XX----------------------------------X--------------------X-----EX------------------[]----<>----------[]--[]----------------------------<>--[]--[]----
-X---------oo--[]------[]--E-E----[]-------------------------------------------------------[]--E-[]-----[]-------E--[]---[]E-[]-------------------[][]-------------------------ooo---------------E-------------E--[]-------------E-EE--------E-----E-EE--------E-------E--[]--[]----[]-------o-XXXXXXXX---------EXXX-E-E----XX-XX--X-XX----XXXXX------------------X-----E-EE--------XXXXXXXXXXXX---E--XXE--E-------------------XXXXX----E-E--E-E--[]------XXXXXX-E------XXXX-E---E-E-------X----------XXXXXXXX------XXXX-----------------------XXXXX--EE---XXXXE-E------------------E-E-X----[]-------E-[]------------------------EE-E-------------------------XXXX----E-------E-EEX-E-------SSS---EE-E---XXXE-XXXX----XXXXX-----------------E--E---X---------E-E------EE-XXXXXXX--X----[]-------[]----[]---------------------[]-------------EE-E---[]----[]--[]-------S---[]-----[]-[]----[]-E----X------E-EE----EE-----[]-XXX----E-------E-----[]---------E----------[]-----E-----------[]---------[]------------X--------------------------XX------------XXXXX-XXX-----XX-----------E--[][][]----[]-E------------------------------[]----[]--------[]----[]-E-----------E-----[]----XXXXX-E-E-------E--[]-E--------SS---E----EE-E--------X---------[]-------E---------------------------E--[]---------------E-[]---------------------E---X----EE-E---------------E---------------------EE-E--E--------XXXXXXXX--XX------X-------------ooo----------XX--------------------S-----XX-EE---------------[]--E-[]---EE-E---[]--[]----------------------------[]--[]--[]----
-XXXXXXXXXXXXXXXXXXXXXXXXXXXXXXXXXXXXXXXXXXX---XXX---------------X--XXXX-XXXXXXX---XXXXXXXXXXXXXXXXXXXXXXXXXXXXXXXXXXXXXXXXXXXXXXXXXXXXXXXXXXXXXXXXXXXXXXXXXXXXXXXXX-------X---XXXX-------XXXXXXXXXXXXXXXXXXXXXXXXXXXXXXXXXXXX-XXXXXXXXXXXXXXXXXXXXXXXXXXXXXXXXXXXXXXXXXXXXXX-XXXXXXXXXXXX-XXX--XX---------------XXXXXXXXXXXXXXXXXXXXXXXXXXXXXXXXXXXXXXXXXXXXX--XXX-XXXXXXXXXXXXXXXXXXXXXXXXXXXXXXXXXXXXXXXXXXXXXXXXXXXXXXXXXXXXXXXXXXXXXXXXXXXXXXXXXXXXXXXXXXXXXXXXXXXXXXXXXXXXXXXXXXXXXXXXXXXXXXXXXXXXXXXXXX---XXXXXXX--XXXXXXXXXXXXXXXXXXXXXXXXXXXXXXXXXXXXXXXXXXXXXXXXXXXXXXXXXXXXXXXXXXXXXXXXXXXXXXXXXXXXXXXXXXXXXXXXXXXXXXXXXXXXXXXXXXXXXXXXXXXX--XXXXXXXXXXX-XXXXXXXXXXXXXXXXXXXXXXXXXXXXXXXXXXXXXXXXXXXXXXXXXXXXXXXX----XXX---XXXXXXXXXXXXXXX---XXXXXXXXXXXXXXXXXXXXXXXX--XXXXXXXXXXXXXXXXX--XXXXXXXXXXXXXXXXXXXXXXXXXXXXXXXXX--EXXXXXXXXXXXXXXXXXXXXXXXXXXXX-XXXXXXXXXXXXXXXXXXXXXXXXXXXXXXXXXXXXXXXXXXXXXXXXXXXXXXXXXXXXXXXXXXXXXXXXXXXXXXXXXXXXXXXXXXXXXXXXXXXXXXXXXXXXXXXXXXXXXXXXXXXXXXXXXXXXXXXXXXXXXXXXXXXXXXXX-XXXXX-----XXXX------XXXXXXXXXXXXXXXXXXXXXXXXXXXXXXXXXXXXXXXXXXXXXXXXXXXXX----XXXXX----XXXXXXXXXXXXX--XXXXXXXXXXXXXXXXXXXXXXXXXXXXXXXXXXXXXXXXXXXXXXXXXXXXXXXXXXXXXXXXXXXXXXXXXXXXXXXXXSSXXXXXXXXXXXXXXXXXXXXXXXXXXXXXXXXXXXXXXXXXXXXXXXXXXXXXXXXXXXXXXXXXXXXXXXXXXXXXXX-XXXXXXXXXXXXXXXXXXXXXXXXXXXXXXXXXXXXXXXXXXXXXXXXXXXXXXXXXXXXXXXXXXXXXXXXXXXX--XXXXXXXXXXXXXXXXXXXXXXXXXXXXXXXXXXXXXXX------X------XXX-------XXXXXXXXXXXXXXXXXXXXX------ESXXXXXXXXXXXXXXXXXXXXXXXXXXXXXXXXXXXXXXXXXXXXXXXXXXXXXXXX---XXXXXXXXXXXXXXXXXX-XXX-XXXXXX