---------------------------------------------------------------------------------------------------------------------------------------------------------------------------------------------------------------E--------------------------------------------------------------------------------------------------------------------------------------------------------------------------------------------------------------------------------------------------------------------------------------------------------------------------------------------------------------------------------------------------------------------------------------------------------------------------------------------------------------------------------------------------------------------------------------------------------------------------------------------------------------------------------------------------------------------------------------------------------------------------------------------------------------------------------------------------------------------------------------------------------------------------------------------------------------------------------------------------------------------------------------------------------------------------------------------------------------------------------------------------------------------------------------------------------------------------------------------------------------------------------------------------------------------------------------------------------
---------------------------------------------------------------------------------------------------------------------------------------------------------------------------------------------------------------------------------------------------------------------------------------------------------------------------------------------------------------------------------------------------------------------------------------------------------------------------------------------------------------------------------------------------------------------------------------------------------------------------------------------------------------------------------------------------------------------------------------------------------------------------------------------------------------------------------------------------------------------------------------------------------------------------------?-S------------------------------------------------------------------------------------------------------------------------------------------------------------------------------------------------------------------------------------------------------------------------------------------------------------------------------------------------------------------------------------------------------------------------------------------------------------------------------------------------------------------------------------------------------------------------------------------------------------------------------------
--------------------------------------------------------SSSSSSSSSSSSSSSSSSSSS----------------------------------------------------------------------------------------------------------------------------------------oo-------------------------------------------------------------------------------------------------------------------------------------------------------------------------------------------------------------------------------------------------------------------------------------------------------------------------------------------------------------------------------------------------------------------------------------------------------------------------------------------------------------------------------------------------------------SS----------------------------------------------------------------------------------------------------oo------------------------------------SSSS--------------------------------------------------------------------------------SSSSSSSSSSSSSSSSSSSSSSSSSSSS--------------------------------------------------------SSSSSSSSSSSSSSSSSSSSSSSSSSSS--------------------------------------------------------oo------------------------------oo---------------------------o----------------------------------------------------------------------------------oo--------------------------------------------------------------------------------------------------------------------------------------------------------------------------------------------------------------------------
---------------------------------------------------------------------------------------------------------------------------------------------------------------------------o---------------------------------------------------------------------------------------------------------------------------------------------------------------------------------------------------S--------------?--------------------------------?Q-------------------------------------------------------------------------------------------------------------------------------------------------------------------------------------------------------------------------------------------o--------------------------------------------oo-----------------------------------------------------------------------------------------------------------------------------------------------------------------------------------------------------SSSS-----Q--------------------------------------------------------------------------------------------------------------------------------------------------------------------------------------------------E--E---------------------------------------?--------E----------o---------------XXXX-----------------------------------------------------------------------------------------------------------------E--E--------------------------------------------------------------------------------------------------------------------------------------------------------------------------------------------------------------------
--------------------------------------------------------------------------------X----------------------------------------------------------------------------------------------------------------------------o--------------------------------------------------------------------------------------------------------------------------------------------------------------------E-----------------------------------ooooo-oo----oo----------------------------------------------------------------------------------------------------------------------------------------------------oo---o-------------------------------------------------------------------------------oo---------------------------------------------X------------------------------------------------------------------------XX------------------------------------------------------------------------oooo---------------------------------------------SSSS---E----------------------------------------------------------------------------------------------------------------------------------------------------------------------------------------------------XXXXXX-------------------------ooooooo-ooo---------XXX-------------------ooo------------------------------------oo---------------------------------------------------------------------------------XXXXXXX---------------------------------------------------------------------------------------------------------------------------------------------------------------------------------------------------E--------------
------------------------SSSS-------------------------------------------------------------------------------E---------------XX-------------------------------------------SSSS---------------------------S--S-XXX----------XX---------------SSS-------------------S-----------SQS------------SSSS--------------------------------SSS----E------------SS------S------------SSSS------SS---------S---SS----S----oo--XXXXX------o-------oSSSSS---?------------------------------SS---SSS--------S------SS-----------------S----------------------------------------------XX----------o---------------------------SS---Q---------------SSSSSSS-------------------------------------XXX-------X-------------------------S---SSS---S---SSS------SSSSSSS--?-S---------------SS---SS------------------------------------------------------------------o----------------------------------XXXXX-------S--------------------------------------SS---S---oooo-oo--------SS----------------SSSSSSS------------------------------------SS--------------------------S--SSSSS--------------------SSSQS--------------------S------oooooo------------------S------------------------------------XX--------------E------------XXSoo----XX-------------------------------S---?-------------------------S---SS----------------------------------------------------------------------------S------------------------------------------------------------------------SS-----SS--------------SSS-------------------------------------------------------------SS--SSSSS-SSS-------SSSSSSSSS--------
----------------------------------------------------------------------------------------------------------<>-------------------------------------------o---------------------------------oo----------------------------XXXX----------------------------------------------------------------------------------------------------------<>-------------------------------------------SS-------------S---------XX---------------------XX--------------------------------------------------------------------------------SS----------------------------------------------XX---------------------------oo-----------------------------------------------------------------------------------SS----------------------------------------------------------------------------------------------oo----E-o---o-------------------oooo----------------------------------------------------------------ESSS------------------------------------SS---S-------------------------------------------------------<>----XX-----------------------S------------------------------------XX-----------------------------------S--------------------------------------------oo----------------------------------E---------------------------------------------------------------------------oooo--------------------------------------------------------------------------------oo-------------------------------------------------------------------------------------o----------------------------------------------------------------------------------SS-----------------------------------
--------------------------------------------------------------------------------------------------o-------[]-------------------------------------------------------------------------------E---------------------------XXXX------------------------E-----------------------------------------E---------------------------------------[]-------------------------------------------SS-------------S-------------------------------XXX--------------------------------------------------------------------------------SS-Q-------------------E----------------------XXXX---------------------------------------------------------------------------------------------------------------XS----------------------------------------S---------------------------------E---------E--------------XXXXXX-XXX--------------------------------------E----------------------------------------------XXS------------------------------XSSS-o--SS---S-S--S-SSSSS--------------------------------------------[]-----------------------------S------------------------------o----XXX-------------------o---------------S------SSSSS-------------------------------------------------------------------XXXXX-------------------------------------------------------------------------------------------------------------------------------------------------------------------E-------------------------------------------------------------------------------------------------------------------------------------------------------------------SS-----------------------------------
----E--------------------------------------------------------------------------------------------------E--[]------o----------E---------------------------------------------------------E--<>--------------------------XXXXX-----------------------<>----------S------E-----------------------------E-EE------------------------------XX--------------------E------------------ooo-SS-----oo------SS--E---------------------XXX--------------------E--o--------------------------------------------------------------[]-----------------E---SSS--------------------XXXX----------XX-So?---------E------------E-------------------SSSSSS----------------E--o--------------o-----------XXS-SQ----------------------------XS--------------------------------S-------<>--S-----<>----------------------------------------E------<>------------<>--SSSS----------E----SS------------o---------XXXSS----------------------------XXX----?oSS---SoS--SoSSS------E-----SQ------------------------X-------[]---------------E------E-----------------------------------E------XXX----------??------E-EE--------------E------SSSSS--------------------------------------E------------------------------------------------XXXX-----------------------E------------X---oo---------E--------------------------------S--oo----------------------------E---S----------S----------E-----SSSSSSS-------E--SSSQ------QS-SQSS-------------?-------S------E-----------------S---------------------------E---S--------------X----------------------------?-SS---Q--------------E----------------
---<>------------------------o--------------------------E-------E-------------------------------S----E<>--[]-----------------XXXXXX---------------------------------E---------E?------<>--[]------------XXSS---SS----XXXXXX-------QQ---QQQ-Q------[]-----E------S---<>----EQQQQ--QQQ-------S?S------X--XX-XX----S-------QQQ----------XX---------Q------------X-----------------SSSSS--S---------------SS-------XX---XXXX-------------------------<>-----E------------------E---S------------------SS---------S------[]-S--QQ----------<>---E----------------------XXXX-------------o--o-------<>------------QS--S?S----------------------------------<>----------------------------XXX---------------------------SS---XX---S--SSSS---------QQQ?--QQQQ------E----[]-----E--[]---------S--------------------XX-------<>------[]------------[]---------------<>---------------------------XXXXX----------------------------XXXX-SS-?SSS---SSS--SSS-------<>--------------------S---------XX-------XXS-------------<>-----SSSS---S----------------------XXXX-SSSSS----XXX-------SSS???SSSSSSSSSSS-----------SSS--------------------------?QQQ--QQS---------E--<>----S------------------------------------XXXX----------XXXX--Q-Q----------<>--<>-----------o--o-------<>------------Q---S?SQS-------------------------------------------<>-----------------E------<>-X----------------<>---------------------------------------X---E--<>-----E--S--------------Q-----------S--------<>-----------------XXX------------------------S----------SS-----------EXX-XX-----------X
---[]---------------E--------------------------X--------E------<>--------XXX-----------------------E<>[]--[]--------------------------------------------------------------------------[]--[]------------------------XXXXXXX--------------------E--[]----<>----------[]-----------------------------XXX--XXXX-------------------E-----<>----------------------X---X--E-----------------------E-------EEEX-----------------------------------------[]----<>-----------------<>--------E---------------------------XXX-[]----------------[]--<>--------------------XXXXXX--------EX--------------[]-----------------------------------------------------[]----------E----------------XXXX--------------------XX----X---X-X-----------------------------------<>----[]----<>--[]----<>---------------------------XX?---[]------[]------------[]---------------[]--E-----------------------XXXXXX-SSo-----------------------XXXXX--------------------------[]-----------------------------XXX--E--E-----------------[]---------------E-----------------XX-----EE------XXXX-------SSS---SSSSSSSSSSS---------------------------------------------------------<>--[]-------E------------------------------------------------------------------[]--[]----------------------[]----------------------------------------------------------E-----[]----------------<>------[]-XXX--------------[]------E------------------X---X--------XX--<>--[]----<>-------------------------E------------[]-------------E--XXXX--XX----------------<>----------E--------------XXX--XXX---------XX
---[]----<>--------<>-----------------EXXX-----X---------------[]---------------------------------<>[][]--[]---------------------XXX--------------------------------------------------[]--[]-----------------------XXXXXXXX-----S-------------<>--[]----[]----------------------------------------XXX---XXXXX-----------------<>-----[]----------------------X---XX<>----------------------------------------------------XXX---------------------[]----[]-----------------[]-------<>---------------------------XXX-[]-S--------------[]--[]-------------------XXXXXXX--------XX--------------[]-----------------------------------------------------[]---------<>------------<>-XXXXXX------------------XXX--XX----X-X---S------------X------------------[]----[]----[]--[]----[]---------X-----------------------[]------[]------<>-X--[]---------------[]-<>-------------------<>-XXXXXXX--------------------------XXXXXX--S-----------------------[]----------------------------XXXX-<>-<>-----------------[]---S---SS------------------------XX------------XXXXX-------SS---SSSSSSSSSSSS-------------------------------------E-------------------[]--[]------<>--------------XXXXX-------------------o---------------------------[]--[]----------------------[]----------o----------------------------------------------<>-----[]----------------[]---XX-[]-XXX--------------[]-----<>------------------X-X-X-------XXX--[]--[]----[]------------------------<>------------[]------------<>-XXXXX--X-----------------[]------------------------XXXX--XXX--------XXX
---[]----[]--------[]------XE------------------X--X-----o------[]--------------E-EE---------EE----[][][]--[]------------------------------------------------EE---------------------E--[]--[]---------------------EXXXXXXXXX-----------------E-[]--[]----[]---------------------E-EE--------------XXXX---X-XX---E-E------------[]-----XX--------X----------X--X---XX[]-E-E------E-----------------------XXXXXXX-----XX----------------------------[]----[]-E-E-E-----E-E---[]-------[]-E-------------------E---E-XXX-[]?S--E--------E--[]--[]------------------XXXXXXXX-------XXX-----------E--[]-------------E-E-------E---------------X--------EE---[]---------[]------------[]XXXXXXX--S-------E------XXXX--XX-E----X---S--E---------X-E-----E-EE-------[]----[]--E-[]--[]----[]------------------------------E--[]------[]------[]XX--[]---------------[]-[]-------------------[]XXXXXXXXXXSSSS----EE-E-E-----E---XXXXXXX--S---EE-----------EE-E---[]------------EE-E--E--------XXXXX-[]-[]-----------EE----[]-------------E-------------EEE---XX------------XXXXX---E--E---oooSSSSSSSSSSS----------X-------------------------------------------E--[]--[]------[]------------------------------ooo----XXX------------E----------E--[]--[]-------S--------------[]------------E--------------------------------------------[]--E--[]--------E--E-E--[]--XXX-[]-XXX--------------[]-----[]--------------E---XXX-X------XXXX--[]--[]----[]-----------------E----E-[]---------E--[]----------E-[]-XXXXX--X--X-------E-EE---[]------------E-E--------XXXXX--XXX-------XXXX
XXXXXXXXXXXXXXXX-XXXXXXXXXXXXXXXXXXXXXX--------XXXX-X---XXXXXXXXXXXXXXXX-----XXXXXXXXXXXXXXXXXXXXXXXXXXX--XXXXXXXX---X--XXXXXX------XXXXXXX----XXXXXXXXXXXXXXXXXXXXXXXXXXXXXXXXXXXXXXXXXXXXXXXXXXXXXXXXXXXXXXXXXXXXXXXXXXXXXXXXX-XXXXXXXXXXXXXXXXXXXXXXXXXXX-XXXXXXXXXXXXXXXXXXXXXXXXXXXXXXXXXXXXXXXXEXXXXXXXXXXXXXXXXXXXXXXXXXXXXX--XXXXXXXXXXXXXXXXXXXXXXXXX---XXXXXXXXXXXXXXXXXXXXXXXXXXXXXXXXXXXXXXX---XX-----------------------XXXXXXXXXXXXXXXXXXXXXXXXXXXXXXXXXXXXXXXXXXXXXXXXXXXXXXXXXXXXXXXXXXXXXXXXXXXXXXX-[]SXXXXXXXXXXXXXXXXXXXXXXXXXXX--XXXXXXXXXXXXXXXXXXX--XXXXXXXXXXXXXXXXXXXXXXXXXXXXXXXXX-XXXXXXXXXXXXXXXX---XXXXXXXXXXX-XXXXXXXXXXXXXXXXXXXXXXXXXXXXXX----XXXXXXXXXX------XXXXXXXXXXXXXXXXXXXXXXXXXXX--XXXXXXXXXXXXXXXXXXXXXXXXXXXXXXXXXXXXXXXXXXXXXXXXXXXXXXXXXXXXXXX--XX------XX------------XXXXXXXXXXXXXXXXXXXXXXXX-XXXXXXXXXXXXXXXXXXXXXXXXXXXXXXXXXXX----XXXXXXXXXXXXXXX--XXXXXXXXXXXXXXXXXXXXXXXXXX--XXXXXXXXXXXXXXXXXXXXXXXXXXXXXXXXXXXXXXXXXXXXXXXXXXXXXXXXXXXXXXXXXXXXXXXXXXXXXXXXXXXXXXXXXXXXXXXXXXXXXXXXXXXXXXXXXXXXXX---XXXXXXXXXXXXXXXXXXXXXXXXXXXXXXXXXXXXXXXXX-XXXXXXXXXXXXXXXXXXXXXXXX-----XX-X-XXXXXXXXXXXXXXXXXXX-XXXXXXXXXXXXXXXXXXX-------------------------XXX-------------------XXXXXXXXXXXXXXXXX-XX--XXXXXXXXXXXXXXXXXXXXXXXXXXXXX-----XXXXXXXXXXXXXXX---XXXXXXXX--XXXXXXXXXXXXXXXXXXXXXXXXXXX--XXXXXXXXXXXXXXXXXXX--XXX-XXXXXXXXXXXXXXXXXXXXXXXXXXX---XXXXXXXXXXXXXXXXX---XXXXXXXXX-XXXXXXXXXXXXXXXXXXXXX-----X-XXXXXXXXXXXXXXXXXXXXXXXXXXXXXXXXXXXXXXXXXXXXXXXXXXXXXXXXXXXXXXXXXXXXXXXXXXXXXXXXXXXXXXXXXXXXXX--XXXXXXXXXXXXXX