-------------------------------------------------------------------------------------------------------------------------------------------------------------------------------------------------------------------------------------------------------------------------------------------------------------------------------------------------------------------------------------------------------------------------------------------------------------------------------------------------------------------------------------------------------------------------------------------------------------------------------------------------------------------------------------------------------------------------------------------------------------------------------------------------------------------------------------------------------------------------------------------------------------------------------------------------------------------------------------------------------------------------------------------------------------------------------------------------------------------------S----------------------------------------------------------------------------------------------------------------------------------------------------------------------------------------------------------------------------------------------------------------------------------------------------------------------------------------------------------------------------------------------------------------------------------------------
------------------------------------------------------------------------------------------------------------------------------------------------------------------------------------------------------------------------------------------------------------------------------------------------------------------------------------------------------------------------------------------------------------------------------------------------------------------------------------------------------------------------------------------------------------------------------------------------------------------------------------------------------------------------------------------------------------------------------------------------------------------------------------------------------------------------------------------------------------------------------------------------------------------------------------------------------------------------------------------------------------------------------------------------------------------------------------------------------------------------------------------------------------------------------------------------------------------------------------------------------------------------------------------------------------------------------------------------------------------------------------------------------------------------------------------------------------------------------------------------------------------------------------------------------------------------
------------------------------------------------------------------------------------------------------------------------------------------------------------------------SSSSSSSSSSSSSSSSSS---S-SSSS-------------------------------------------------------------------------------------------------------oo--------------------------------------------------------------------------------------------SSSSSSSSSSSSSSS---------SS--------------------------------------------------------------------------------------------------------------------------------------------------------------------------------------------------------------------------------------------------------------------------------------------------------------------------------------------------------------------------------------------------------------------------------------------------------------------------------------------------------------------------SSSSSSSSSSS----SSSSSSSSSSSSS------------------------------------------------------------------------------------SSSSSSSSSSSSSSSSSSSSSSSSSSSS---------X-------S--------oo--------------------------------------------------------------------------------------------------------------------------------------------SSSSSSSSSSSSSS------------------------------------------------------------------------------------------------------------------------------------------------------------------------------------------------------------------------------------------------------------------SSSSSSSS
----------------------------------------------------------------------------------------------------------------------------------------------------------------------------------------------------------------------------------------------------------------------------------------------------------------------------------------------------------------------------------------------------------------------------------------o---------------------------------------------------------------------------------------------------------------------------------------------------------------------------o------------------------------------------------------------------------------------------------------------------------------------------oo-------------------------------------------------------------------------------------------------------------------------------------------------------------------o-o-----------------------SSSS----------SSSSSSSSS-SS----o---------------------------------------------------------o------------------------------------------------------------XX-----------------------------------------------------------------------------------------------------------------------------------------------------------------------------------------------------------------------------------------------------------------------------------------------------------oo-----------------------------------------------------------------------------------------------------------------------------SSSS----S
---------------------------------------------------oo------------------------------------------------------------------------------------------------------------------------------------------------------------------------------------------------------------------------------------------oooo----------------------------------------------------------------------------------------------------------------------------------------------------------------------------------Eooo------------------------------------------------------------------------------------------------------------------------------------------------------------------------------------------------------------------------------------------------------------------------------oooo-------oo---------------------------------------E----------------E-----------------------------------------------------------------------------------------------------------------SSSS----------SSSSSSSS---S--------------------------oo----------------------------E----E-------------------------------------------------------------X------X-XXX-------------------------------------------------------------------------------------------------------------------------------------------------------------------------------------------------------------------------------------------------------------------------------------------------------------------------------------------------------------------------------------------------------------------------------oSSSSS----
--------------------------------------------------XXXX------------------------------------------------------XX--SSSS-----------o----XXX---------------------------------Q--------------------------------------------------------?SSS------------------S---------------------------------------XXXX--------S-----------------------------------------------------SSSSS-------------E----------------------------------------SSS-------SS---------------------------------------------XXXXX----------------------------------------------------------------------QSQQS---------------SQ---SSSSS----------------------XXXXX-----------------SSSS------------------------S----QSQ----------------------SSS--??SSS------------------------------SS---------S---------XXXX-------------------E------SSS------------------------SQS----SS---------S-SSSSS---?--------------------------------------------------SS-----------------SSSS--SSS-----X-------XX---------S-QQ------------S---SSS---S-?SSS-------XX----oo-------o----------------------------S---SQS---?-------------SS--------------------------------------------------------S------E--S-----------------------SQSSSS------------------SS-------------------------E----S----------------SSSS---E----------XXX----------------------------------S?------SSSSS---------------oo------------------------SSSS----S-----------QQ-------------------------------------------S--SSS---XXX--------------------Xoo--XXX---------------------------SSS--SSSS----SS---?SSS-------SSS--SSSSSS-----------------------SSSSSSSSSSS
----------------XSSS----------------------------------------------------------------------------------------X----------------------------------------------------------------------------------------------------------------X-----------------------------------------------------------------------------SSS-------------------------------------------------------------------------------------------------------------------------------------------------------------------------------ooo-------------------oo--------------------------------------------------------------------------------------E---XXX---------------------------------------------------------S------------------------------------------------------------------------------XXXX----------------------------------------------------------------------------------------------XSS---------------------------SSS----------------------------------------------------XXXX-----------------------------S-------------------------------XX-------------------------------------------------------E------------------------------------------o-----------------XXXXX---oooo-------------------------------------------------------------------X--------------------------------X-------------------XX------------------------------------------------------------------------------------------------------------------------------------------------------------------------------------------------------------------------------------------------------------------------------------------
---------------XXX-----------------------------------------------------------------------------------------XXX----------------------------------------------------------S--o------------------------------------------------XX---------------------------------------------------------------------------XXSX----------------------------------------------------------------------------------------------------------------------------------------------------------------------------XXX-------------------------------------------------------------------------------------------------------------------------------------------------------------------------------S------------------------------------------------------------------------------------------------------XX-XX----------------------------E---------------------------------------XX---------------------------XXX----------------------------------------------------XXXXXX------------------------S----S---------------------------------------------------------E----------------------------------------o-----------------------XXXXXX--XXX----------------oo--------------XXX-----------------------------------------------------------XX---------------------------------------------------------------------------------------------------------------------------------------------------------------------------------------------------------------------------------------------------------------------E--------------------------------------------------------------------------
--------------X-XX----------------------E-------------E-------------------------------------o--------------XXX-S-----------------------------S-----------------------oo------------------------------------oo-------------o-XX----------------------------------------------------E---------------------XXXXX------------------------------------------------------------------E--XXX----------------------------------------------------S---------E----SS-------------------------------XXX---------------XX-------XX-----------------------------------------?-oo------------------------------------SSSSS-----------------------------------------------------------oo?-So--------------------------------------------------------------------------XQ------------------XXXX------XX---------------------------<>-------------------E----SS------------XXXSS-SQ------oo--oo----------XXS----------------------------------------------------SXXXX--------?----------------SS---So??--SSSS---------------XXX--------------------------E-------E-----------E----------ooSSS--------------------------oo--------------------ooo---------------------S---XXX--------------------------E-------------------------------XXX---------E----------SSSS-S--SSSSSS--------------XX-----------------oo--ooo-----------------------------------------------------------------------------------------E--o-----------------------------SSSSSSS--------------Q---------X--------------------------------<>---------------------------------------------------------------------E----
--------------XXXX---------X----<>-----<>-------E----<>------XXX-XX---------------------------------------XXXX-X----XXX---XXXXXX--XXX--XXXX-------------S---------------SSS-----X----------------X-------------------SSS----XX---E--------SQ-Q--------------------------S--S-----<>---Q----------------XXXXXX----------------E------------------------------------------------<>------XXX----------------------------------------X-X------E-------<>------------------------------------XXXX---XXXX--------------------------------XX--X-----------------------??SQS----------------S?S--QQQS-------------------------SSS-------------------Q-QQQQ--Q-------------------S--SSS----------------------SQS--Q-Q------------------------------E-----------XX-------------XXXX------------XXX-------SSS----------------[]------QQQ---S?S---<>---Q----S?S------XXXXX-------------------------XXX---------X----S-S--------S--------------------------XXXXXX----------SSS-------ES---SSS--SSS----------------XXXX----------------E---S-----<>---E-------XS--S?S----------X----o---------SS-------------------oo-------------------------------------------------XoX-------------------------<>-------S----------------------XXXX--------<>---E--Q-------------------------XXXX----------QQ------------------------------S--o--------XXXX--XXXX-------------XX--XX--------------------SSQS---------<>-------------------S----------SS----------------------------o-XX-XXX-------------------X---E----[]-----EQQS--------------------------S----X------------------------SSSSSSS--
------------XXXXXX-------EXX----[]-----[]------<>----[]-----XXXX-XX--------------------------------------XXXXX---------------------------------E-----------E-------------------XX---------------XXX-------------------------XX---------------------------------------------------[]--E----------------XXXXXXXX---S----------<>-----E------------------------------------------[]------------------------------------------------XX-X--------------[]------------E-----XX---------------XXXXX--------------------------------------XXX--X--------------------------------------------------------------------------------------------------------------------------------------------------------------------------E-------XX-------------<>----------XXX-----------------------------XXX--------------------------[]------------------[]----------------XXXXXX---------------------E-XXXXXX------EXX-------------------------E-------------EXXXXXXXX-----------------XX-------------------------------------------------<>---------[]--<>------------------------X--------------------------------------X------XXXXX----------------------------------X-XXX-------------------------[]--------------------E---------XXXX--------[]--<>----------E-------------------------------------------------------------------------------------------------XXX--XX-----------------------------<>--[]-------------------------------------------------------------XXX-------------E------E--X--<>----[]-----------------X-------------------E--E----X---------XX-----------------
------------XXXXXX-------XXX----[]-----[]------[]----[]----XXXXX-XX-------------------------------------XXXXXX--------------------------------------------<>------------------XXX--------------XXXX-----------------------X-XXX--------------------------------------------------[]-<>------------<>-XXXXXXXX---------------[]----<>---------------X-------X------------------[]-----------------------------------------------XXX-X--------------[]------------E---------------------XXXXX-------------XXX----------------------XXXX--XXX----------------------------------------------------------------------------------------------------------E------------------------------------------------------------<>--------XE------------[]------<>-XXXX-----------------------------XXX---------------<>---------[]------------------[]---------------XXXXXXX---------X----------<>-XXXXXX------XXX---------------------<>-<>-----------EXXXXXXXXXXX---------------XXX-------------------------------------------------[]-------<>[]--[]--------------------E---X---------------S--------------------------------------------------------------------XXXXX-------------------------[]-------------------<>-------EXXXXX--------[]--[]------------------------------------------------------------------------------------------------------------XXX--XXX---------X------------------[]--[]--------------------------X----------------------------------XXX------------<>-----<>--X--[]----[]-----------------X----------------------X---XX--------XXX-----------------
------------XXXXXX------XXXX----[]-----[]------[]----[]---XXXXXX-XX-----------EE-E------------------E--XXXXXXX--------------------------------------------[]-----------S-----XXXX-------------XXXXX---------------------E---XXX----------------------------E------E-EE----EE-EE--[]-[]------------[]XXXXXXXXX-----------E-E-[]----[]-E----------X--X-------X-E-X--------------[]--oo--------------------------E---------------XXXX-X--------------[]---------------------------------XXXXXX-ooo---------------------------------XXXXX--XXXX----------------E----E-----E-EE-----E------------------------------------------------------------------------------EE-E-----E-------------------E-E---E-E-----------E-[]-------XX---E--E--E-E-[]------[]XXXXX----------------------------XXXX--------E------[]---------[]------------------[]---------------XXXXXXX--SSSS--XX----------[]XXXXXXX-----XXXX---E-------E---------[]-[]-----------XXXXXXXXXXXX---E----------XXXX-E-----------------------------------------------[]-------[][]--[]-------E----------------X---------X----------E-----------------------------------------------EE-E-E-----E-E----X-X----------------------E--[]----E-----E--------[]-------XXXXXX-EE-E---[]--[]-------------------------------------------------------------E-E-------------------ooo---------------EE-E-E-XXX--XXXX--EE-E-XX------------------[]--[]-------E-------E----------X-------------------------SS-------XXX------------[]---E-[]--X--[]----[]-----------------X-------------E--------X---XX-------XXXX-----------------
XXXXXXXXXXXXXXXXXX--XXXXXXXX-XXXXXXXXXXXXXXXXXXXXXXXXXXXXXXXX-X--XXXXXXXXXXXXXXXXXXXXXXXX-----X-XX-XXXXXXXXXX--X---------X------------------XXXXXX---XXXXXXXXXXXXXXX----XXXXXXXXXX-----XXXXXXXXXXX--XXXXXX----XX----XXXXXXX-XXXXXXXXXXXXXXXXXXXXXXXXXXXXXXXXXXXXXXXXXXXXXXXXXXXXXXXXXXXXXXXX----X-XXXXXXXXXXXXXXXXXXXXXXXXXXXXXXXXXXXXXXXXXXXXXXXXXXX-XXXXXXXXXXXXXXXXXXXXX---XXXXXXXXXXXXXXXXXXXXXXXXX-XXXX--XXXXXXXXXXXXXXXXXXX---XXXXXXXXXXXXXXXXXXXXXXX-X--XXXXX-----XXXX--XXXXXXXXXXXX-XXX-------------------------XXXXXXXXXXXXXXXXXXXXXXXXXXXXXXXXXXXXXXXXXXXXXXXXXXXXXXXXXXXXXXXXXXXX-----XXXXXXXXXXXXXXXXXXXXXXXX---XXXXXXXXXXXXXXXXXXXXXXXXXX---XXXXXXXXXXXXXXXXXXXXXXXXXXXXXXXXXXXXXXXXXXXXXXXXXXXXXXXXXXXXXXXXXXXXXXXXXXXXXXXXXXXXXXXXXXXXXXX------------------------S---XXX--XXXXXXXXXXXXXXXXXXXXXX-XXXXXXXXXXXXXXXXXXXXXXXXXXXXXXXXXXXXXXXXXXXXX-------XXXXXXXXXX--XXXXXXXXXX---XXXXXXXXXXXXXXXXXXXXXXXXXXXXXXXXXXXXXXX-XXXXXXXXXXXXXXXXX--XXXXXXXXXXXXXXXXXXXXXXXXXXXXXXXXXXXXXXXXXXXX----------------XXXXXXXXXXXXXXXXXX-XXXXXXX--XXXXXXXXXXX--XX--XXXXXXXXXXX-----XXXXXXXXXXXXXXX--XXXXXX------------------------XXXX-XXXXXXXXXXXXXXXXXXXXXXXXXXXXXXXXXXXXXXXXXXXXXXXXXXXXXXXXXXXXXXXXXXXXXXXXXXXXXXXXXXXXXXXXXXXXXXXXXXXXXXXXXXXXXXXXXXXXXXXXXXXXX--------XXXX-XXXXXXXXXXXXXXXXXXXXXXXXXXXXXXXXXXXXXXX-X-XXX------------XXXXXXXXXXXXX-XXXXXXXXXXXXXXXXXXXXXXXXXXXX--XXXXXXXXXXXXX-XXXXXXXXXXXXXXXXXXXXXXXXXXXXXXXXXXXXXXXXXXX-------XXXX-XX------XXXXXXXXXXXXXXXXXXXXXXXXXXXXXXXXXXXXXXXXXXXX---XXXXXXXXXXXXXXXXXXXXXXXXXXXXXXXXXXXXXXX-XXXXXXXXXXXXXXXX