------------------------------------------------------------------------------------------------------------------------------------------------------------------------------------------------------------------------------------------------------------------------------------------------------------------------------------------------------------------------------------------------------------------------------------------------------------------------------------------------------------------------------------------------------------------------------------------------------------------------------------------------------------------------------------------------------------------------------------------------------------------------------------------------------------------------------------------------------------------------------------------------------------------------------------------------------------------------------------------------------------------------------------------------------------------------------------------------------------------------------------------------------------------------------------------------------------------------------------------------------------------------------------------------------------------------------------------------------------------------------------------------------------------------------------------------------------------------------------------------------------------------------------------------------------------------
------------------------------------------------------------------------------------------------------------------------------------------------------------------------------------------------------------------------------------------------------------------------------------------------------------------------------------------------------------------------------------------------------------------------------------------------------------------------------------------------------------------------------------------------------------------------------------------------------------------------------------------------------------------------------------------------------------------------------------------------------------------------------------------------------------------------------------------------------------------------------------------------------------------------------------------------------------------------------------------------------------------------------------------------------------------------------------------------------------------------------------------------------------------------------------------------------------------------------------------------------------------------------------------------------------------------------------------------------------------------------------------------------------------------------------------------------------------------------------------------------------------------------------------------------------------------
----------------------------SSSSSSSSSSSSSSSSSSSSSSSSSSS------------------------------------------------------------------------------------------------------------------------------------oo-------oo----------------------------------------------------------------------------------------------------------------------------------------------------------------------------------------o-------------------------------------SSSSS----SSSSSSSSSS--------------------------------------------------------------------------------------------------------------------------------------------------------------------------------------------------ooo----------------------------------------------------------------------------------------------------------------------------------------------------------------------------------------------------------------------------------------------------------------------------------------------------------------------------------------------------------------------------------------oo--------------------------------------------------SSSSSSSSSSSS?SSSSSSSSSSSSSSS------------------------------------------------------------------------------------------------------------------------------------------------------------------------------------------------------------------------------------------------------------------------------------------------------------------------------------------------------------------------------------------------------------------------------------
----------------------------------------------------------------------------------------------------------------------------------------------------------------------------o-------------XXXX----------E--E----------------------------------------------------------------------------------------------------------------------------------------------------------------------o---------------------------------------------------SSS----Q------SS------------------------------------------------------------------------------------------------------------------------------------------------------------------------------------------?---------XXX-------------------------------------------------------------------------------------------------------------------------------------------------------------------------------------------------------------------------------------------o------------------------------------------------------------------------------------------------------------------------------------------XXXX-------------------------------------------------SSSSS---------------------oS----------------------------------------------------?-------------------------------------------------------------------------------------------------------------------------------------------------------------------------------------------------------------------------------------------------------------------------------------------------------------------------------------------------------------------------------
-------------------------------------------------------------------------------------------------------------------------------------------------------oo--oo------------------------------------------XXXXXX------------------------------------------------------------------------------------------oo---------------------------------------------------------------------------oo----------------oo----E-------------------------SSS-------S----S----XXX--S------------------------------------------------------------------------------------------------------------------------------------------------------------------------E----E---?-----------------------------------------------------------------------------------------------oooo-------------------------oooo-------------------------------------------------------------------------oo-----------E-------------------------------------------------------------------------------------------------------------------------------------------------------------------------------------------------------------------------------SSSSS--E------------------SS------------------------------------------------------oo----------------------------------------------------------------------------------------------------------------------------------------------------------------------------------------------------------------------------------------------------------------------------------------------------------------------------------------------------------------------------
--S---SS----------------------------------------------------------------------------SSS-----?SSS-----E----------S----------------SSSSSS-----S-S-------------------------S?SSS---------------------------------------------------SSSSS-------SSS--SSSSS-----------------------------------------------------------------------------------------X----QSS----------------------------XXXX-----XXoo----X------SSS-S--------------Q------------SS-----Q-----SS-----S--Q----------------------------------SSSS-------------------------QQQQQ-------------------------------------------------------------------SQ--------------------------X-S---SQS-S??-----------------SSSSQ------SSSSQ--SSSS----------SS---------------?-----------oo------------XXXXXX------------------------XXXXX--SSS-----E-----------------------SSQSSSS------------SSSSS----------------------------SS--SQS--------------SSSSS----SSS------SSS-------------------------SSS---SSSSSS---------------------------------------------------------------QS-------------------E--SS----------------------------------------------------------SS---SS-----oo--------SSSS---SSS------SSSSQS-S-------SSSSSS----SSS-----E--?-------------S-----------SSSSSS---------------------S------------------------------------------------------------------------------------------SSSS----SS--------SSS-S-----SSSS-SSSS------------------------------------------------------------------SSSS---------SSSS--------XXoo----ooo---------ESSSSSSSSS----E---------SSSSS------------SSS?S----------------------SSS-------SS
E-------------------------------------------------------ooo-----------------------------------------<>-----------------------------------------------------------ooo---------------------oo-----------------------------ooo-------------------------------XX-----------------------------------------------XXXXX-----------------------------XXX----------------------------E-----------XXX------------------------------------------------SS-----------SS----------------------------------------------------------------------------------ooo---------------------------------------oooo----------------------------------------------------------------------------------------------------------------------------------o--------------------------------------------------------------<>----E-------------o-----------------------------------------------ooo------SS--------------XS-------------------------------------------------------------------------------------------------E----------------------------------------------<>--------------------------------------------------------------SS---SS---------------SSS---------------------------------------------<>------XX----------------------------------------------------------------------------SS----------------ooo-----------------------------------------------------------------------------------------XSSX----------------------------------------------------------------XXX----------------------X-------------------<>----------------------------------X------------------------------
----------------------------------------------------------------------------------------------------[]-------------------------------------------------------------------------------------E--------------------------------------------------------------o----------------------------------------------------------------------------------XXX----------------------------E--------------------------------------------------------------SS-----S-----SS---------------------------------------------------------------------------------------------------------------------------------------------------------------------------------------------------------------------------------------------------------------------------------------------------------------------------------[]---<>-----------------------------------------------------------------------S------------XXXX----------------------------------------------------------------------------------------------XXXXXXXXX-----------------S-----------------------[]--------------------------------------------------------------SS---SS---S-SSSSS-----SSS---------------------------------------------[]-------------------------------------------------------------------------------------------------------------------------------------------------------------------------------------------------XXX----------------------------------------------------------------------------------------------XX---------------[]--------------------------------o--------------------------------
---------------------E-----------------------E-----------------------------------------E------------[]-------------------------------------------------------E-------o-----------------E-------------------E----------------------SSS-----------------------o----oo-----------------------------------------------------------------------E-XXXX-----------------------------------------------XXX----------------------------------X--ooooSS---SoS-----SS-----------------------------------------------------------E-------------------E-------E----------------------------------E---------------E-----------------------------------E-------------------SQ---------------------------------------------------------------------------XXX----------------E----------------------X-------[]---[]----------E-----------------E---------SSSSX------E--------------------SS---o------X----X----------SSSSSS-----------------------S-SQ------------------------S-SQS------S------------------------o---------------XSS----------------------[]--o----------------E-------------------------------E-----E--?-So---So??-So??-So-----SSSS------------------------------SQ------------<----------------------------------------------E------------------------------------XSS-SQ------------------------ES--------------------ooo-------------------------------------------------------XXXX-X--------------------------------------------------------------------------------------------S----------------[]----oo-----SS---------E-------------------------E----------------
Q-----SSS-----------<>----S-----------------<>----------------------------------------<>-----S?S----[]----------SSS-------o-E-------SSSSS---------QQQ-------<>----------------E-------<>---E--------S-----<>-------------E----------S--oo------XXXX--SS--------------------------------------------XXXX----------------------------------<>--XXX----SSS------------------E------------------------------S--S?S--QQ--Q--Q--Q--QQ-Q--QX--SSSSSS---SSS-----------SS??QQQ----------------------------E--Q---------------<>------------SSQQ--<>------<>---------------------------------<>--------------<>---QQ------XXXX--------------------SS--S?SQS-----<>------------E?QQQ--QQQ--QQQQ-----QQQQ--------S----------------------XX------XX---------XXXXXX---E--<>---------------------EX--E----XXX--XXX--------<>----------------<>-------------S--E--<>--------------------SS--S?S----XXX-XXX-----------------------XX-XX---------X-----------------X--X----------------------E--S---------------------------------XXX--SQQ---------------E--[]---E--------------<>------------S--QQ--QQQ-------E<>----<>----SSS--SSS--SSS--SS-----SSSS--------------SSQ-------------------SS?S------XXX-------QQQ-----------<>------------------<>-----E-Q-QQQQQ------------S?S------XXX---------------------------<>-----XXXX----------E------------SSSSS-----------------------SSS----------------XXX-XX-----------------------------------X-------E---------SQQQS----------------XXXX--XXXXX--XXX--S--QQQQ----SS----[]------------------------XXX-SSSS---------------<>----Q-----------
--------------------[]-------XXX?-----------[]----------------------------------------[]------------[]----------------------E--E-E--E-----------------------[]------------------------[]--<>----------<>--[]------------<>----------------------------------------------------------o--E-------------------------------------------------[]--XXX------------------------<>----------------------------S-S--------------------------------------------------E--------------------------------------------------------[]--------E---------[]------[]---------------------------------[]-------E------[]-------XXXXX-XXXXXXXX----------------------------[]-----------------------------------------------------------------------XXXXX-----------------------[]-----E---E----------XXX-<>--------------E-----[]----------------[]---------------<>--[]------------------------------XXXX-XXX-----------------------X--XX--------XX-----------------X--X---------------------<>-----------------------------------XXXX-------------------<>--[]------------------[]---------E------------------<>[]----[]-----------XX---------------SS----------------------------------------------------------------------[]------------------[]----<>----------------------------XXXX--SS-----------------------[]-----XX-----------<>------------E--------------o-X---X----------X-----------EXXXXXXXX-----------------------E---------XXX------<>-----------------------------------------------------------------[]------------------------------------X----------[]----------------
--------------------[]----------------------[]----------------------------------------[]------------[]---------------------------------EE-------------------[]------------------------[]--[]----------[]--[]------------[]-----------------------------E---X-----------XXXXX-------XXXXX----------------------------E-------------------XXXX-XXX-----------XX--X--------[]---------------XXXXX----------S---------------------------E-------------------------------------------------------------------------------[]-------<>---------[]------[]---------------------------------[]------<>------[]-------XXX---------------------------------------[]--------------------------------------------------------------------------------------------XXX-E--[]----<>--<>---------XXXX-[]-------------<>-----[]-X--------------[]---------------[]--<>-----------------------------XXXXX-XXX-----------------------XX--X-------XXX---------------X-X------------------------[]----------------------------------XXXXX-------------------[]--[]--X---------<>----[]--------<>--S---------------[][]----[]-----------XX---------------SS-----------X---------------X---------------<>-------------------------[]------------------[]----[]---------------------------XXXXXX--------------------------[]-----X------------[]-----------------------------X---X----------X---------EXXXXXXXXXX----------------------<>--------XXXX------[]-----------------------------------------------------------------[]------------------------------------X----------[]----------------
E-------------------[]----------------------[]---------E---------------------S--------[]------------[]------------------------------------------------------[]-----------E------------[]--[]----------[]--[]------------[]--------------------------------XX----------XX-------------------------------------------------EE-EE-----E---XXXXX-XXX-E-E-------XXE-X-X------[]-------XXXX-XXXX-------SSSSS---------------------E--E-----X----E-E------------------------------------E-E----------E-E--------E--------E--[]-------[]---------[]----E-[]----EE-E-----------------E-E-----[]----E-[]------[]-------XX-------------------------E--------------[]------------------------------E-------------------------------E----X-------------------------------[]----[]--[]--------XXXXX-[]-------------[]---E-[]-X--------------[]--E-----E--E---[]--[]-----------------X--E-E-----XXXXXX-XXX--------XX-------------X---X---EE-XXXX------------E--X-X-----X------------------[]----X-XX--------------------E----XXXXXX-E--------------E--XXX-[]--E-----E-E-[]----[]--------[]--S---------------[][]-E--[]-E--EE----XXXXE-----------EE-------------X-E------------XX---------------[]-----------E----------E--[]-E---------X--E---[]----[]-----E-EE-----------------XXXXXXX--SSSSS----------E-----E--[]-----X------E-EE--[]-------------------E----E----X-E-X-----E----X---------XXXXXXXXXXX---------------E------[]-------XXXXX------[]---------------------------ooo---------------XXX-----------------[]---------------------------------E--X---EE-E---[]---------EE-----
XXXXXXXXXXXXXXXXXXXXXXXXXXXX-----XXXXXXXX-XXXXX---XXXXXXXXXX----XXXXXXXXXX---X--XXXXXXXXXXXXXXXXXXXXXXXXXXXXXXXXXXXXXXXXXXXXXXXXXXXXXXXXX-XXXXXXXXXXXXXXXXXXXXX-XXXX-XXXXXXXXXXXXXXXXXXXXXXXXXXXXXXXXXXXXXXXXXXXXXXXXXXXXXXXXXXXXXXXXXXXXXXXXX-------XXXXXXXXXXXX---XXX---------------------------------------------XXXXXXXXXXXXXXXXXXXXXXXX-XXXXXXXXXXXXXXXXXXXXXXXXXXXXXXXXXX---------------------------XXXXXXXXXXXXX-XXXXXXXXXXXXXXXXXXXXXXXXXXXXXXXXXXXXXXXXXXXXXXXXXXXXXXXXXXXXXXXXXXXXXXXXXXXXXXXXXXXXXXXXXXXXXXXXXXXXXXXXXXXXXXXXXXXXXXXXXXXXXXXXXXXXXXXXXXXXXXXXXXXXXXXXXXXXXXXXXXXXXXXXXXXXXXXXXXX-----------------XXX--X-XXXXXXXXXXXXXXXXXXXXXXXX-----XXXXXXXXXXXXXXXXXXXXXXXXXXXXXXX-XXXXXXXXXXXXXXXXXXXXXXXXXXXX----------------------------XXXXXXXXXXXXXXXXXXXXXXXXXXXXXXXXXXX-X----XX-XXXXXXXXXXXXXXXXXXXXXXXXXXXXXXXXXXXXXXXXXXXXXXXXXXXXXXXXXXXXXXXXX---XXXXXXXXXXXXX-XXXXXXXXXXXXXXXXXXXXXXXXX--X---XXXXXXXXXXXXXXXXXXXXXXXXXXXX-XXXXXXXXXXXXXXXXXXXXXXXXXXXXXXXXXXXXXXXXXXXXXX----XX-XXXXXXXXXXX--XXXXXXXXXXXXX--XXXXXX-XX--XXXXXXXXXXXXXXXXXXXXXXXXXXXXXXXXXXXXXXXXXXXXXXXXXXXXXXXXXXXXXXXXXXXXXXXXXXXXXXXXXXXXXX--XXXXXXXXXXXXXXXXXXXXXXXXXXXXXX-XXXXX-------------XX---XXXXXXXXXXXXXXXXXXXXXXXXX--XXXXXXXXXXXXXXXXXXXXXXXXXXXXX--XXXX--X-XXXXXXXX------XXXXXXXXXXXXX-XXXXXXXXXXXXXXXXXXXXXXXXXXXXXXXXXXXXXXXXXXXXXXXXXXXXXXXXXXXXXXXXXXXXXXXXXXXXXXXXXXXXXXXXXXXXXXXXXXXXXX---XXXXXXXXXXXXXXXXXXXXXXXX-XXXXXXXXXXXXXXXXXXXXXXXXXXXX-------XXX------------------XXXXXXXXXXXXXXXXXXXXXXXXXXX-XXXXXXXXXXXXXXX--X-XXXXXXXXXXXXXXXXXXXXXXXXXXXXXXXXXXXXX