------------------------------------------------------------------------------------------------------------------------------------------------------------------------------------------------------------------------------------------------------------------------------------------------------------------------------------------------------------------------------------------------------------------------------------------------------------------------------------------------------------------------------------------------------------------------------------------------------------------------------------------------------------------------------------------------------------------------------------------------------------------------------------------------------------------------------------------------------------------------------------------------------------------------------------------------------------------------------------------------------------------------------------------------------------------------------------------------------------------------------------------------------------------------------------------------------------------------------------------------------------------------------------------------------------------------------------------------------------------------------------------------------------------------------------------------------------------------------------------------------------------------------------------------------------------------
------------------------------------------------------------------------------------------------------------------------------------------------------------------------------------------------------------------------------------------------------------------------------------------------------------------------------------------------------------------------------------------------------------------------------------------------------------------------------------------------------------------------------------------------------------------------------------------------------------------------------------------------------------------------------------------------------------------------------------------------------------------------------------------------------------------------------------------------------------------------------------------------------------------------------------------------------------------------------------------------------------------------------------------------------------------------------------------------------------------------------------------------------------------------------------------------------------------------------------------------------------------------------------------------------------------------------------------------------------------------------------------------------------------------------------------------------------------------------------------------------------------------------------------------------------------------
SSSSSSSSSS---SSSSSSSSSSSSSSS--------------------------------------------------------oo------------------------------------------------------SSSSSSSSSSSSSSSSSSSSSSSSSSSS--------------------------------------------------------SSSSSSS--S-------------------------------------------------S----------------------------------------------------------------------------------------------------------------------------------------SSSSSSSSSSSSSSSSSSSSSSSSSSS--SSSSSSSSSSSSSSSSSSSSSSSSSSS-------------------------------------------------------------------------------------------------------------------------------------------------------------------------------------------------------------------------------------------------------------------------------------------------------------------------------------------------------------------------------------------oo-------------------------------------------------------------------------------------------------------------------------------------------------------SSSSSSSSSSSSSSSSSSS-S--------------------------------------------------------------------------------------------------------------oo------------------------------------SSS----------------------------------------------------------------------------------------------------------------------------------------------------------------------------------------------------------------------------------------------------------------------------------------------------------------------------------------SSSS
----------------------------------------------------------------------------------------E--E---------------------------------------------------------------------------------------------------------------------------------------SSS---------------------S------------------------------SS----------------------------------------------------------------------------------------------------------------------------------------------------------------------SSSS?--S-SSSSSSS---SSS------------------------------------o----------------------------------------------------------------------------------------------------------------------------------------------------------------------------------------------------------------------------------------------------------------------------------------------------------------------------------------------------------XXX----?----------------------------------------------------------o------------------------------------------------------------------------------------------------------------------------------------------------------------------------------------------------------------------------XXXX-----------S----------------------oooS--------------------------------------------X-----------------------------------------------------------------------------------------------------------------------------------------------------------------------------------------------------------------------------------------------------------------------------------------------
--------------------------------------------------------ooo----E-----------------------XXXXXXo----------------------------------------------------------------------------------------------------------------------E--------------SSS--E------------------S------------------------------SS--E-----------E-------------------------------------------------------------------------------------------------------------------------------------------------------SSSS--E--SSSSSSS---SSS--E---------------E--------------------------------------------------------------------------------------------------------------------------------------------------------------------------------------------------------------------------------------------------------------------------------------------------------------------------------------------------------------------------------------------------------------------------E----------------------------------------------------------------------------------------------------------------------------------------------------------------------------------------------------------------------------------------------------------E------------------------SSS---------------------------------?--------------------------------------------------------------------------------------------------------------oo---o---o---oo-----------------------------------------------------------------------------------------------------------------------------------------------------------------------------
----S----------------?----------------------SSSSSS------XXX----E--o----XXX-----oo------------------------------------------QQQ--------------o----------------S---?------------------------SSS----------SSS--------SSQSSS-----------S----S--------S---S---------------SSSS-------?---------S---SS----S---SSQ---SS-----SQQ--------------SSSSSS----SSQS------------------------SSSSS-----------SQSS----------------------------SSS------------------------------------S----S----S-------S----SS--SS--------SSSSSSSSSSSSS-----SSS------SSS----S?SS------------------------------SSSS--S---SS-------------------------S-----SSSSSSSSS-SSS---------------SSS---S--SSSS-------------------SSQS---------SSS---?-------oo----ooo--------------------------------------------------------SSSS----SQQ-------------------------------------------------X----------------XX----------------------------------------------------------------------SQS---?------------SSS----------------------------------S-----?SSS----------------------------------------------------------------------SS--SQS--------------SSSSS------------S---------------------------------XX----------Q?SSS---?--SSS-----------------SQS-S----S-----------------SS---Q---oQ-----------------------S??-----------------SS---SS----------SSS---SSSSSSSSSQ-------SSSQSS---?SSS-----S-QQS--------------S-----Soo------------XXX----------------------S----SSS-----------------------------------------------------------------------------------------SSSS-----------S----SS-----SS--S----------------------------
-----------------------------------------------------------------XXX-----------------------------------------------------------------------------------------------------------XX--------------------------------------------------S----S------------------------------------------XXX----S---SS---------------------------------------------------------------------------------------------------------------------------------------------------------E--------SS----SS-----------S----SS------------------------------------------------------XX---------------------------------------------------------------------------------------------------------------------------------------------XX---------------------------------------------------------------------------------------------------------------------------------------------------------XX-S-------------------------------X-------------------------------------------------SSS-----------------------------o--o---------------------------------------------------------------------------------------------------------------------------------------------------------------XX---------------------------------------------S----------------------SS-----------------------------------------------------------------------------------------------------------------------------------------------------------------------------------------------------------------oo---------------------oooo------------------------------------------------------------------------------------------------
---------------------------------------------------------------------------------------------------------------------------------------------------------------------------------------------------------------------------------S-S-----------------------------------------------------------S-----------------------------------------------------------------------------------------------------------------------------------------------------------------SSS----SS-----------S----SS---------------------------------------------------oooo---------------E------------------------------------------------------------------------------------------------X--------------------------------------------------------------------------------------------------------------------------------------------------------------------------------------XXXX---------------------------------XX-------------------------------------------------------------------------------------------------------------------------------------------------------------------------------------------------------------------------------------------------XXXX--------------------------------------------------------------------SS-?-S-S--S-S------------------------------------------------------------------------------------------------------------------------------------------------------------------------------------------------------------------------------------X--X-----------------------------------------------------------------------------------------
---------S-------------------------------------------------------------XXX----------XXXX-------------------------------------------------------------------------------------------------------------------------------------------So---------o--o?o--------------------------------------SS---S-----o-----------------------------------E-E-------------SS--------------------------------------------------------o-------------------------------------E----SoX--So??-SS-----oo-S-oSo?ooSS-----------------------E??-----------------S----------------------E--<>-------------?------S-------------------------------------------------SQSQS--------------------XX----------------------------------------------------------E-----E--------------------XXXX----------------------------------oo--------E--------------------------------------E--------XXXXX----------------------------------------------------E--o--------E-----------------XSS-SQ-SSSSSSSSSSSSS-----------E-----------------E---------------------------------------------------------oo---------------E-------------------SSSSSS--------------------------------------------XXXX----------SSSSSS-------------------------So-----------------------ooSS---SoS--SoS--------------------------------------E--------------------------------E---------------------------ooo-----------------------XX-------------XXXXXX----------------------------------------------------------E--------------E---------XXX---------------------------E--------------------E----------------------------------------
----SE----------QQQ--QQ------------------S----X------------XXXX-------------<>---XX-----------------------X------------------S----------------------------?SSSQQQQ--------------------------------------S----Q--Q-SSSSSSSS---------SSS----------SS-------------------QQQ---------------X--SS---SS---SS-SSS---------X-ooS------EXX-X-----SSSSS---S?SSS--------Q-Q----------------S----------Q--Q--Q-------QQ--------------o-------XXX----------------E---<>----S-X--SSS--SS-ESSSSS-SSSSSSS-SS--SSS------XX--X--XX--SSS-------S-------XXXXXX---SS--------------<>--[]-----S-----S---S----SSS---S----S------------QQ----Q-------------------------------------------XXX-------E-------SSSS-----------X---------XXX-XXXXX--XXX---<>----<>-----------E--------------------------------------SSS--Q-----------<>-------------XX-------------------o--<>-------XXXXXX----------E-----------------XXXX-------------------<>-----E----<>-----S?S--------XXX-------------------------E--<>-----E-----QQQQ--Q--S-------------------------------------E--S------------------------QQQ---QS--SSS-------------------------------QS--------E--?--------Q--------XXXXX---------X-------------------------------SSS----------Q-----------SSSS---SSS--SSS-------------Q--E?QQQQ---------------<>------SSS---E---------------SS-ESSS--------Q-Q--Q-----------SSSSS-------------------S---------XXXX-------------------E-----Q-----QQQ--------XX---------------E------<>-------------<>---------XXX------------------<>------<>---SS---------E----<>-----------X----------XX--X-------------
--------------------------------X----------E--X----------X-----XXXXXX-------[]----------------E---E-------------XX---------------------------E-------X-----------------------------------------------E--------------------------------------------------------X------------------------X----------------E----------X---------XXXX-XX----E-----------------------------------------E---------------------------------------------XXXX---------------<>---[]------S-----------------------------E------XXXX--XX-XX-------------------XXXX----------------------[]--]--------E-------------------------------------------------------------------------------------XXXX------<>-------------------------------------------------[]----[]----------<>--------------E----------------------------------------[]------------XXXXX------XXX--------E--[]------EXXXXXX---------------------------XXXXX-------------------[]----<>----[]---------------XXXX---X--------------------<>--[]----<>-------------------X---------X---------------------<>--------------------------------------------------------------XXX---------------<>-------------------XXXXXX--------XX-----------------------------------------------------XXX-------------------------------------------E--------[]-----------<>---------------E-E--------------------------------------XX--X------------------------------------------<>---------------------XXX--------------<>------[]-------------[]--------XXXX------------------[]------[]-------------<>----[]----------XX---------XXX--XX------------
--------------------------------X-------------X---------XX------------------[]---------------<>--<>--------------X-----------------------------------X-------------------------------------------------------------------------X------------------------------X------------------------X---------------------------X--------XXXXXXXX------EEoooo-------------------------------------------------------------------------------XXXXX---------------[]---[]------S-----------------------------------XXXXX--XX-XXX-----------------XXXXX------------X---------[]------------------------------------------------------------X---------------------------X-------XXXXX------[]-------------------------XXX---------------------[]----[]----------[]-------------<>-----<>---------------------------------[]-----------XXXXXX--------------------[]-----XXXXXXXX---------XX---------------XXXXXX-------------------[]----[]----[]--------------XXXXX------------------------[]--[]----[]---------------E---X--------XX---------------------[]--------------------------------------------------------------XX----------------[]------X-------------XXXXX-------XXX----------------------------------------------------XXXX------------------------------------------<>--------[]-----------[]----------<>--------------------------------------------XX--XXX-----------------------o----------------[]--------------------XXXX--------------[]------[]---S---------[]--------XXXX------------------[]------[]-------------[]----[]---------XXX------XXXXXX--XXX-----------
-------------------E-E-------E--X----EE-E--E--X----EE-EEXX------------------[]---------------[]--[]--------------X-------EE-E-EE-------EE-E------EE--X------------E-----------------E-----E-EE---------------E-----------------X---EE--------------E-EE-------X------------------E-EE--X---------------------------XE------XXXXXXXXX-S-o------XX-------------------------------------E-----------E------------E----E----------XXXXXX----------E----[]---[]------S---------E------------EEEE--------XXXXXX--X--XX-----------------XXXXXX-XS--------XX---EE-E--[]-----------------------------------------EE-----E-------E-E-X-----------------------E---X-E----XXXXXX------[]-------EE--------------------o-------------------[]----[]-----E----[]-------------[]-----[]------------------------------E--[]-------E--XXXX-----------------------[]----XXXXXXXXX--------XXX--------------XXXXXXX---XX----------E---[]----[]----[]---E---------XXXXXX-------------------E--E-[]--[]----[]-E-----------------X-------XXX-------EE------E-EE--[]-E-------EE-E---------------------EE--------E-----------------XX-----------EE---[]------X---EE----E---XXXXX---E--XXXX-----------------------EE----------------------E-EEXXXXX--E------------EE-E---------------------E-[]--------[]-----E-----[]----------[]----X------------------------E----E---------XXE-XXX-E-EE---XX--XXXXXX----XXX---------------[]-------------------XXXXX--------------[]------[]---SE-EE-E---[]----E----XXX----X---E-EE------[]------[]------E-EE---[]----[]---E-E--XXXXE----XXXXXXX--XXXX----------
XXXXXXXXXXXXXXXXXXXXXXXXXXXXXXXXXXXXXXXXXXXXXXXXXXXXXXXXX---------------XXX---------XXXXXXXXXXXXXXXXX----XXXX---XX--XXXXXXXXXXXXXXXXXXXXXXXXXXXXXXXXXXXXXXXXXXXXXXXXXXXXXXXXXXX----XXXXXXXXXXXXXXXXX--XXXXXXXXXXXXXXXXXXXXXXXXXXXXXXXXXXXXXXXXXXXXXXXXXXXXXXXXXXXXXXXXXX-----XXXXXXXXXXXXXXXXXXXXXXXXXXXXXXXXXXXXXXXXXXXXXXXXXXX-----XXX-XXXXXXXXXXXXXXXXXXXXXXXXXXXXXXXX--XXXXXXXXXXXXXXXXXXXXXXXXXXXXXXXXXXXXXXXXXXXXXXXXXXXXXX-X-XXX--XXXXXXXXXXXXXXXXXXXXXXX--XXXXXXXXXXXXXXXXXXXXXXXXXXXXXXXXXXXXXXo--XXXXXXXXXXXXXXXXXXXXXXXXXXX--XX---XXXXXXXXXXXXXXXXXXX-XXXXXXXXXXXXXXXXXXXXXXXXXXXXXXXXXXXXXXXXXXX--XXXXXXXXXXXXXXXXXXXXXXXXXXXXXXXXXXXXXXXXXXXXXXXXXXXXXXXXXXXXXXXXXXXXXXXXXXXXXXXXXX-----------------------------XXXXXXXXXXXXXXXXXXXXXXXXXX-XXXXXXXXXXXXXXXX---XXXXXXXXXXXXXXXXXXXXXXXXXXXXXXXXXXXXXXXXXXXX--oo--XXXX----XX--XXXXXXXXXXXXXXXXXXXXXX---XXXXXXXXXXXX----XXXXXXXXXXXX---XXXXXXXXXXXXXXXXXXXXXXXXXXXXXXXXXXXXXXXXXXXXXXXXXXXX---XXXXXXXXXXXXXXXXXXXXXXXXX-X-XXXXX-X-XXXXXXXX-XX--XXXXXXXXXXXX--XXXXXXXXXXXXXXXXXXXXXXXXXXXXXXXXXXXX---XXXXXXXXXXXX--XXXXXXXXXXXXXXXXXXXXXXXXXX-X-XX-XXXXXXXXXXXXXXXXXXXXXXXXXXXXXXXXXXXXXXXXXXXXXXXXXXXXXXXXXXXXXXXXX----XXXXXXXXXXXXXXXXXXXXXXXXXXXXXXXXXXXXXXXXXXXXXXXXXXXXXXXXXXXXXXXXXXXXXXXXXXXXXXXXXXXXXXXXXXXXXXXXXXXXXXXXXXXXXXXXXXXXXXXXXXXXXXXXXXXXXXXXXXXXXXXXXXXXXXXXXXXXXXXXXXXXXXXXXXXXXXXXXXXXX--------------------------XXXXXXXXXXXXXXXXXXXXXXXXXXXXX-XXXXXXXXXXXXXXXXXXXXXXXXXXXXXXXXXXXXXXX--XXXXXXXX-XXXXXXXXXXXXXXXXXXXXXXXXXXXXXXXXXXXXXXXXXXXXXXXXXXXXXXXXXXXXXXXXXXXXXXXX-XXoXXXXXXXXXXXX