------------------------------------------------------------------------------------------------------------------------------------------------------------------------------------------------------------------------------------------------------------------------------------------------------------------------------------------------------------------------------------------------------------------------------------------------------------------------------------------------------------------------------------------------------------------------------------------------------------------------------------------------------------------------------------------------------------------------------------------------------------------------------------------------------------------------------------------------------------------------------------------------------------------------------------------------------------------------------------------------------------------------------------------------------------------------------------------------------------------------------------------------------------------------------------------------------------------------------------------------------------------------------------------------------------------------------------------------------------------------------------------------------------------------------------------------------------------------------------------------------------------------------------------------------------------------
------------------------------------------------------------------------------------------------------------------------------------------------------------------------------------------------------------------------------------------------------------------------------------------------------------------------------------------------------------------------------------------------------------------------------------------------------------------------------------------------------------------------------------------------------------------------------------------------------------------------------------------------------------------------------------------------------------------------------------------------------------------------------------------------------------------------------------------------------------------------------------------------------------------------------------------------------------------------------------------------------------------------------------------------------------------------------------------------------------------------------------------------------------------------------------------------------------------------------------------------------------------------------------------------------------------------------------------------------------------------------------------------------------------------------------------------------------------------------------------------------------------------------------------------------------------------
--------------------------------------------------------------------------------------------------------SSSSSSSS----------------------------------------------------------------------------------------------------------------SSSSSSSSSSSSSSSSSSSSSSSSSSSS-----------------------------------------------------------------------------------------------------------------------------------------------------------------------------ooo------------------------------------------------------------------------------------------------------------------------------------------------------------------------------------------------------------------------------------------------------------------------------------------------------------------------------------------------------------------------------------------------------------------------------------------------------------------------------------------------------------------------------------------------------------------------------------------------------------------------------------------------------------SSSSSSSSSSSSSSSSSSSSSSSSSSSS-----------------------------------------------------------------------------------------------------------------------------------------------------------------------------------------oo----------SS------------------------------------------------------------------------------------------------------------------------------------------------------------SSSSSSSS-----------------------------SSSSSSSSSSSSSSSSSSSSSSSSSSSS
-------------------------------------------------------------------------------------------------------------------------------------------------------------------------------------------------------------------------------------------------SSSSSSSSSSS-----------------------------------------------------------------------------------------------------------------------------------------------------------------------------XXXX---------------------------------------------------------------------------------------------------------------------------------------------------------------------------------------------------E-----------------------------------------------------oo------?-------Q-Q------------------------------------------------------------------------------------------------------------------------------------------------------------------------------------------------------------------------------------------------------------------------------------------------------------------------------------------------------------------------------------------------------------------------------------------------------------------------------------------------------------------------------------------------------------------------------------------------------X----------SS-----X------------------------------------------------------------------------------Q------------------------------------------------------------------------------------------------------------SSS------------------------
-------------------------------------------------oooo-------------------E-----------------------------------------------------------------------oooo-------------Eooo------------------oo--oo---------------------------------------------------SSSSSSSSSSSS--------------------------------------------------------------------------------------------------------------------------------------------E--------------------------------------------------------------------------------------------------------------------------------------------------------------------------------------------------------------------------------------XX------oo------------------------------------------------oo--------------ooo--------------------------------------------------------------------------------------------------------------------------------------------------------------------------------E-------------E--o----------------------------------------------------------------E---------------------------------------------------------oo--ooooo----------------------------------------------------------------------------------------------------------------------------------------------------------------------------------------------------------------------------------------------------?--------------------SS-------------------------------------------------------------------------------S---S-----------oo--oo--------------------------------------------------------------------------------------------SSS------------------------
-----------------SSS-----------------------XXX---XXXX-----------------SSSSS---------------------------------------------------------------------XXXX-------------XXXXX--SSSSS-------XX----------------SSS------SS-------------------------------SSSSSSSSSSSS--------------------SSS--------S--SSS-------------------SSS--------------------------------SS---------------------------XXX-------------SSQSS---SQS---?SSS----------------S------------------SSS---S-------SQ--------------------------------XX-------------S----------------------SSSSS-S-------------------------X-S---------------S-S-SSS----------------------------------------------------------------------SSSS----------SSSSE-------XXXX------E------XXX-SS---SS---------------------------------------XXX------------------------E-------------E---SSSS------E----------------------------------------------------------------SS-S----<>--S----------XXXX------------------XXXX-----------?-------------SSSSSSS----------SS-------------------S-----------------SSSSS------oo----------------------------------------------------------------------------------SSSSS---?------------------------------------------------------------------------------------Q-Q--------------------------------------------QQ---------------SSSSSSS----------SSS?X-------------------SS---QS---Q-oooo--------SS--------------------------------SSS-------------S----S-----S----XXQ--------------------------------------------S------------SSSSS-----------SSSS----QQQ---------------------------------------------
----------------------------------------------------------------------------------------o-----------------------------------------------------------------XX--------------XXX----------------XXXX-----------------------------------------------------------ooo----------------------------------------------------------------E-----------------------SS-----------------------------------------------S---------------------------------------------------------------------------------------------------------------------------------------------------------------------XX----------------------------------oooo-------------------oo---------------------------------------------------------XX-----------<>---------E----------------------------------------oo---XXXX-------------ooo-----------------------------------<>------------------------------------------------------------------------[]----------------------------------XXXXX-------------------------------------------S---------------------------------------------------------------------oooo---------oooo--------------------------------------------------------------------------------------------------------------------------------------------------------------o-------------------------------------------------------------------------------------SS---------------------------E------------------------------------------------ES-----------------XXX----------------------------------------------------------------------------------------XXX-------------------------------
------------------------------------------------------------------------------------S-------------------------------------------------------------------------------------------------------------XX--------------------------------------------------------------------------------------------------------------------------<>-----------------------SS------------------------------------------------------------------------E---------------------E---E-------------E--------------------------------------------------------------------------------------------------XXXX---------------------------------------------------------------------------------------------------------------------------------[]------------------------------------------------------XXXXX-----------------------------------------------o---[]------------------------------------------------------------------------[]---------------E-----------------EXXXXX------------------------------------------S------------E----------------------------X-----------------------------------------------E-----------E--------------------------------------------------------------------------------------------------------------------------------------------------XXX------------------XXXX--------------------------------------------------------X-SS---S----S-SS-SS----E--------------------------------------------------SSS---------------------------------------------------------------------------------------------------------------------------------------------------
---------------------------------------------------------------------------------------------S-S--------------------------------------------o---------------------------QSS-----------------------------------------------------------E--------ooooo---------------------------------------------------------E----------------[]-------------------ooooS------------------------------------------------S-----------------------<>----o---------S-----<>--<>----------------------------------S--------------E-------------------------------------------------------------XXXXX--------------------------------E-------oo---------oo----------------------------------------------------------------------------[]--------------------------------------S--------------XXXXXX-----------E---------------------------------------[]---------SS---------------------------------------------------E---------[]-------E---E--<>----------------XXXXXX---------------------------------------ooooSS-------E--<>----------------------E-------------S------------------E------------E------<>-------E----------------------oo-----------------------------------E--------------E--------------------------------------------------------------------------------------------------------------------------------E---------------------------X-SS---SoS--SoS--S----<>-----SQSQ------------------------------------o----SS----------------------------------------------------------------------------------------------------------------------------------S----oo----------o
EES-------------------<>---S-------------------------------------------SSS--------E-------------E---------------QQ--------------Q-----------------XXXXXX----------------------------XXXXXX------------QQQQ--QQ-Q-----Q?--QQQ---------<>-------SSSSSSS---SSSS----------------------------QQQ---QQQ-----------<>----------------XXX----------<>------SSSSSS-S---------------------------------------------S---S?SQS---S-----------[]----S---E-<>-----E--[]--[]---S-------S?S----------------------------XXX---<>-------------------------------S?S--------------------------XXXXXX----------------------o---XX---<>-----E-----------o---------------------XXX---XX-------QQQ--------------E--S---X-----------SS----XX-------------S?SSS------------------S---------------XXXXXXX----------<>------------E------E-X------Q--SSSS----XX------------------------E-------------------S------ES--------<>-S------SXXSSoo--<>--<>--[]-X--oooo-------XXXXXX-----------o--------EXX--X-----------X---SSSSS--S---<>--[]-----E--------------------XX-----------------XXXX-----<>-----------<>------[]------<>-------------------------------S-S------X---S?S----E------<>----------------XX------------X---------------E--S------------QQ--QQ?SQQ---------------S---------oooo--------------QQ-----------------SSSSSSS--QS--S?SQS------------X------XX-S---SSS--SSS----E--[]-------------------E--S-------------S?S--------S--------SS--------XXXSSSSS--------------X----------QS------------X-------S---------X------------------Q---XXXX--XX-----------ES----------E-----E--------
-------------------E--[]-----------------------------o-E-------------------------<>---EXXX---------E--------------------------------------------------------------o---o--------------------------------------------------------------[]--X------------------------X----------------XXXXX--------------------[]-----------------------------[]-----------------------------------------------------------------------------------[]----------[]----<>--[]--[]--SSX-------------------------------------------[]-----------------------------------------------------------XXXXXXX----------X-----------E--EEX---[]----<>----------------------------------------------------------------<>------X-----------------XX--XXX------------------------------SS--------------XXXXXXXX----------[]-----E-----<>-----<>-----------E----E--XX--XX-------------------<>------------------------------------[]-S--E--------[]--[]--[]--[]--------------EXXXXXX--------E----------<>XX--XX---------XX--------------[]--[]----<>--------------------XX-----------------------E--[]--------E--[]------[]------[]--------------------------------------------------<>------[]----------------X--X---------XX--------------<>----------------------------<>----------------XX----EE---------XXXX--------------------------------------------------X------XX----------------<>--[]------------------<>----------------------------------E---------------------------------X--------------------------------------XX--XX-------------------------------------E--------E----<>----<>--------
----------------------[]---------------XXXX----XX---XXXX-------------------------[]--XXXXX--------------------------------------------------------------------------XXXX------------------XXX------X---------------------------------[]--X------------------------------------------------------------------[]-----------------------------[]--X--------------------------------------------------------------------------------[]----------[]----[]--[]--[]--SSX-----------------X-------------------------[]----------------------------------------------------------XXXXXXXX---------XXX---X-----------X---[]----[]-------------------------------------------o--------------------[]------X-----------------XX--XXXX-----------------------------SS----------<>-XXXXXXXXX----------[]----<>-----[]-----[]---------------E---XX--XXXX-----------------[]------------------------------------[]-S-----------[]--[]--[]--[]------------EXXXXXXXX---------X---------[]XX--XXX-------XXX--------------[]--[]----[]--------------------XXX------X--------------<>--[]--------X--[]------[]------[]--------------------------------------------------[]------[]---------------EX--X--------XXX--------------[]-----------E----------------[]---------------XXXXXXXXXX--------------------------------------------------------------XX-----XX----------------[]--[]------------------[]--------------------------------------------------------------------X-------------------------------------XXX--XXX----------X------------------------<>-------<>----[]----[]--<>----
------------------E---[]-----------------------------------------EE-E-----E------[]-XXXXXX------------------EE-----EE-E------------E-E------------------------------------------------------------XX-------------------E-EE-------E--[]--X----------EE---------------------------------------E--------------[]-E---------------E-------E-E-[]--X-----E---------------------------------------------------E-E-------E------E-----[]---EE-E---[]----[]--[]--[]--SS------------------X--------X------------E---[]-----------E------------------------XXE----------E-------XXXXXXXXXE-------XXXX-E-X-----------XE--[]----[]----------------------------------------------------------------[]-E-E--X-----------------XXE-XXXX---E-E------------E----------SS----------[]XXXXXXXXXX----------[]----[]---E-[]-----[]-------------------XX--XXXX-----------------[]--------------E--EE-E------E--------[]-S-----------[]--[]--[]--[]-----------XXXXXXXXXX-------XXX---E----X[]XX--XXXX-----XXXX-E-EE---------[]--[]----[]--------------------XXX-----XX----XXXX------[]--[]-------EX--[]------[]------[]-----------E-E------------E--E--------------------[]------[]----------------X--X-----E-XXXX---------E----[]-E---------------EE-E-----E-[]--------------XXXX-------------------------E-E--------------------E----------------EE--XX---E-XX---E-E-------EE-[]--[]---E-----------E--[]-E---------S---E---------E------------------------------------------X-----E-EE-----------------X---------XXXX--XX-----E--E---------------------------[]-------[]-E--[]-E--[]--[]----
XXXXXXXXXXXXXXXXXXXXXXXXXXXXXXXXX-------------------------XXXXXXXXXXXXXXXXXXXXXXXXXXXXXXX---XXXXXXXXXXXXXXXXXXXXXXXXXXXXXXXXXXXXXXXXXXXXXXXX--XXXXX------XXXX-----------XXXXXXXXXXXX----------XXXXXXXXXXXXXXXXXXX--XXXXXXXXXXXX-XXXXXXXXXXXXXXXXXXXXXXXXXXXXXXXX---XXXXXXXXXX-XXXX------XXXXXXXXXXXX---XXXXXXXXXXXXXXX-XXXXXXXXXXXXXXXXXXXXXXX-XXXXXXXXXXXXXXXXXXXXXXXXXXXXXXXXX--XXXXXXXXX---XXXXXXXXXXXXXXXXXXXXXXXXXXXXXXXXXXXXXXXXXXXXXXXXXXXXXXX-XXX-XXXXXX----XXXXXXXXXXXXXXXXXXXXXXXX------XXXXXXXXXXXXXXXXXXXX--XXXXXXXXXXXXXXXX--XXXXXXXXXXXXXXXXXXXXXXXXXXXXXXXXXXXXXXXXXXXXXXXXXXXXXXXXXXXXXXXXXXXXXXXXXXXXXXXXXXXXXXXXXXXXXXXXXXXXXXXX--XXXX------------X-XXXXXXXXXXXXXXXXXXXXXXXXXXXXX-XXXXX-XXXXXXXXXXXXXXXXXXXXXXXXXXXXXXXXXXXXXXXXX---XXX---XX--XXXXXXXXXXXXXXXXXXXXXXXXXXXXXXXXXXXXXXXXXXXXXX--X-XXXXXXXXXXXXXXXXXXXXXXXXXXXXXXXXXXXXXXXXXXXXXXXXXXXXXXXXXXXXXXXXXXXXXXXXXXXXXXXXXXXXXXXXXXXXXXXXXXXXXXXXXXXXX-XXXXXXXXXXXXXXXXXXXXXXXXXXXXXXXXXXXXXXXXXXXXXXXXXXXXXXXXXXXXXXXXXXXXXXXXXXXXXXXXXXXXX---XXXXXXXXX-XX-XXXXXXXXXXXXX----------XXXXXXXX---XXXXXXX-XXXXXXXXXXXXXXXXXXXXXXXXXXXXXXXXXXXXXXXXXXXXXXXXXXXXXXXX--XXXXXXXXXXXXXXXXXXXXXXXX---XXXXXXXXXXXXXXXXXXXXXXXXXXXXXXXXXXXXXXXXXXXXXXXXXXXXXXXXXXXXXXXXXXXXXXXXXXXXXXXXXXXXXX----------------------XXXXXXXXXXXX---XXXXXXXXXXX--XXXXXXXXXXXXXXXXXXXXXXXXXXXXX-XXXXXXXXXXXXXXXXXXXXXXXXXXXXXXXXXXXXXXXXXXXXXXXXXX---XXXXXXXXXXXXXXXXXXXXXXXXXXXXX---XXXX-XXXXX---XXX--X--XXXXX-XXXXXXXXXXXX--XXXXXXXXXXXXXXXXXXXXXXXXX-XXXXXXXXXXXXXX--------XX-------------XXXXX-XXXXXXXXXXXXXXXXXXXXXXXXXXX