------------------------------------------------------------------------------------------------------------------------------------------------------------------------------------------------------------------------------------------------------------------------------------------------------------------------------------------------------------------------------------------------------------------------------------------------------------------------------------------------------------------------------------------------------------------------------------------------------------------------------------------------------------------------------------------------------------------------------------------------------------------------------------------------------------------------------------------------------------------------------------------------------------------------------------------------------------------------------------------------------------------------------------------------------------------------------------------------------------------------------------------------------------------------------------------------------------------------------------------------------------------------------------------------------------------------------------------------------------------------------------------------------------------------------------------------------------------------------------------------------------------------------------------------------------------------
------------------------------------------------------------------------------------------------------------------------------------------------------------------------------------------------------------------------------------------------------------------------------------------------------------------------------------------------------------------------------------------------------------------------------------------------------------------------------------------------------------------------------------------------------------------------------------------------------------------------------------------------------------------------------------------------------------------------------------------------------------------------------------------------------------------------------------------------------------------------------------------------------------------------------------------------------------------------------------------------------------------------------------------------------------------------------------------------------------------------------------------------------------------------------------------------------------------------------------------------------------------------------------------------------------------------------------------------------------------------------------------------------------------------------------------------------------------------------------------------------------------------------------------------------------------------
-----------------------------------------------------------------------------------------------------------------------------------------------------------------------------------------------------------------------------------------------------------------------------------------------------------------------------------------------------------------------------------------------------------------------------------------------------------------------------------------------------------------------------------------------------------------------------------------------------------------------------------------------------------------------------------------------------------------------------------------SSSS------SSSSS------------------------------------------------------------------------------------SSSSSSSSSSSSSS-------SSSSSSS--------------------------------------------------------SSSSSSSSSSSSSSSSSS?SSSSSSSSS------------------------------------------------------------------------------------------------------------------------------------------------------------------------SSSSSSSSSSS-----------------------------------------------------------------------------------------------------SSSSSSSSSSSSSSSSSSSSSSSSSSSS----------------------------------------------------------------------------------------------------------------------------------------------------------------------------------------------------------------------------------------------------------------------------------------
-----------------------------------------------------------------------------------------------------------------------------------------------------------------------------------------------------------------------------------------------------------------------------------------------------------------------------------------------------------------------------------------------------------------------------------------------------------------------------------------------------------------------------------------------------------------------------------S----------------------o----------------------------------------------------------------------------------------------------------------------------------------------------------------------------------------------------------------------------------------------------------------------------------------------------------------------SSSSS-----?-S--SS--SSSS--oS----------------------------------------------------------------------------------o---------------------------------------------------------------------------------------SSSS------------------------------------------------------------------------------------------------------------SSS------?oS--SS--SS----oS--------------------------------------------------------------------------------------------------------------------------------------------------oo------------------------------------------------------------------------------------------------------------------------------------
----Eooo-------------XXX----------------------------------------------------------------------------------------------------------------------------------------------------------------------------------------------------------------------------------------------------------------------------------------------------------------------------------------------------------------------------------------------------------------------------------ooo------------------------------------------E--------------------------------------------------------------E---------------E--------------------S----E------E--------------------E-----------------------------------------------------------------------------------------------------------------------------------------------------------------------------------------------------------------?----------------------------------E-------------------------------SSSSS-------S--SS--SSS---ES--------oo--oo---------------------------------------------------------------------S------------------------------------------------------------------------------------X-SSSS--E--------------------------------------------------------------------------------------------------------SSSS-E-----SS--SS--SS----SS-------------------------------------------------------------------------------------------------------------------------------------------------------oo--oo--oo----XXX-----------ooooooooooo----------------------E-------------------------------------------------------------------
----XXXXX-----------------------------------------XX------ooo----QS---------------------------------------------------SSSSS------------------------------------------------------------------SSSS--------------------S--------------------QQ------------------------------------------S----------SSSS-----------------------------------SSS----------------------------------------------------------------------?SSS----S-------------------------------XXXXX----------------------------------------SQS----S------------------------SSSS--S-----------------------SSQSSSSS----SS?---SS--------SSQ--------SS?SSS-----SSS---QSQ------------SQS-----SSS--------------E?SSS---------------------------SS----?SSS---------------------------------------------S-------SSS-------SS-------------------E-----oo-----------------SSS-------------------------------S---SSS----SSSSS--SS?S------------SSSSS------SS-------------SSS---S-SS----SS------------SS----So-----------------------------------------SSSSSSSS----SSSS?---S----------S---SSS---S------------------------SSSS----------------------------------------------XXXX--------SS---SSS-------S---?------------SSS-----------------------------------------------Q?SSS---?--------------SSSSSSS----SS-------------SS----------S---??SSS-------------------------------SSSSSS---SS-----------------S---SSS----SSSS---QQQ-Q---------------------------Q----------------SSSS-----------------------------oo--XX-----------------------------S--SSSSS-?-----S------------------------SSSS--------------------SSS-----
--------------------------------XXXX------o------XXXE---------------------------------------------------------------------------------------------------------------------------------------------------------------------------------------------------------------------------------------------------------------------------------------------------------------------------------------------------------------------------------------------------------------------------------------------------------------------------------------S----------------------------------XES----SS-------------S----------------------------------------------------------------------------------------------------------------------------------------------------------------------------------------------------------------------------------------------------------------------------------------------E-----------------------------S----SS------------SS---SS--------------------------------------------------------SS-------------------SS--------------------------------------------------------------------------------------------S---SSS------------------------------------------------------------------------------------------------------SS----SS-------------SS-----------------------------------------------------------------------------------------------------------------------------------------------------------------XX----------XX-----------------X-----E-----------------------------------------------------------o--------------------------
--------------------------------oo--------------XXXX-------------------oo---------------------------------------X-----------oo------------------------------------XSS-------------------------------------------------------------------------------------------------------------------------------------------------------------------------------------------------------------------E-----------E---------------------------------------------------------EX----------------------------------------------------------------------------S----------------------------------XSS----SS-------------S---------------------------------------------------------------------------------------------------------------------------------------------------------------------------------------XXX--------------E-------------------------------------------------------------------------------------S-----S------------E---E------S-S--SS------------SS---SS-----------------------------------------E--------------SS-------------------S---------------------------------------------------------------------------------------------S---SS-------------------------------------------------------------------------------------------------------SS--E-SS-------------SS----------------------------------------------------------------------------------------------------------------E-----------------------------------------------------------------------------------XXXXX------------------------------------------------------------------------------------
------------------------------------------------XXXX----------------------------oo-----------------------E--------------------------------------QSS--------------XXX--o-------------X------------------------------E----------------------------------------------Soo---------------------------------------------E-----------------------------SSSSSS?-----------------------------E--<>----------<>--------------------------------------------------------XXXS-----------S--------------------------------------------------------o------S----------------------------------XSS----SS-------------S---E---------------------------------------------------------------S----------------------S---------------------E--------------S-------------------SQSQS----------------------------------------------------------------------------------------------------E-----------------------------SSS-S-----S-----------<>--<><>--?-SoS--S--------oo??-SS---SX------------------S-SQ---------------oo----------E------SS-------------------S---E----------------E-------------------------oo--------------X------------------------------So??SS---------------------------------------------------------------o-----E---------------------------------SS--oSSS---------o??oSS--EEX--------------------------------E-----------------------------------ooooo------------------------------E--<>-------E-------------E--------------------------XXXXX------------XXXXX------------------------------------------------------------E-------------SSSSSSSSSS---------------oo-
------------------XX--------------------------XXX-X----------XXXXX-XXX----------------------------------<>-----------XXX-SSSSS----X--X--------------------------XXXX------SSS------XX--X-----SS--------------E----<>----------S-S------QQ?-------E--------------E-----------------X--------------QQQQ------------<>----------------------SS----------------S------------------E----<>--[]----------[]------------QQQ----------------------------------------XXXX---E-----------E---------------------QQQQ--QQ--------E----------------------S--SSSSS-------E--S-----S---------XX--SSSSSS--S------S------o--SS--SS---QQ--Q--Q--Q--QQQQ--Q---SQS---------S----------------------------------------S--QQQQ--QQQS--------<>------------E-----------------------o-------XXX-XXX---------X-X-X------------XXXX--XXXX-------------Q------------------SS------XXX-X------SSSS---Q---XXX---SSS--------------------SSS-------E--[]--[][]----SSS--S--S-----SSS--SS---SS----------------XX-----------------E------ESSSSSSSSS-S-------SS---EX--X---------SSSSSS--------E--<>-----E-----------------E-----SSS----------------------------------------SSS-SS------SQQ?--Q------------QQQQ-Q------------------------------E------<>--------SSS---------QQQQ--QQQQ---SSSSSSSS--S------SS--S--SSSS---QQQQ--QQQ-------------------<>-----------SS--SSSSSS--Q---------E-----Qo-------XXX--QQ--QQQS-QS-----<>--[]------<>---Q--SSSS--<>-------------------XXXXXX-------------XX------XX-XXXXX---------------------QQQQ--S-----S-------S--------E--<>-----E---S?S?----------------------------
----------------XXXX----------X---------------XXX-X------XXXXXX--------------?-S-S----E-----E-----------[]-------XXX-------------XX--XX--------E---------------XXXXX-------------XXXX--XX-------------------<>----[]---------E--X---------------<>-------------<>-----------------X------------------------------[]----------------------------------------------------------<>----[]--[]-------E--[]------------------------------X-----------------------XXXXX--<>----------<>------------------------------------<>------------------------EE----------<>--------E----EEXE-XX------------------------E-EX---------------------------------------------------------------------------------------------------------[]--E--------<>------------------------------XXXX-XXX--------XX--------------------------------------E--------------------------XXXX-XX---E-------X------------------------------------------<>--[]--[][]--------------------------EE----------------XXXX----------------<>-----------------------------XXX--XX-------EE-------E----<>--[]----<>----------------<>--------------------------------------------------------------------------------------------------E---------------<>------[]------------------------------------------XX-------------E----------------------------------[]-----E--------------------------<>-------------EX-X------------------[]--[]------[]------------[]--------------------------------------------------------------------------------------------------E---E<>--[]----<>----------E------------------------
----------------XXXXX---------X---------------XXX-X-----XXXXX----------------X-------<>----<>-----------[]-------XXX------------XXX--XXX----------------------XXXXXX------------XXXXX--XXX-----Eo-----------[]----[]--------<>--S---------------[]-------------[]-----------------X---X--------------------------[]---------------------------XX-----------------------------[]----[]--[]------<>--[]-----------------------------XX----------------------XXXXX---[]----<>----[]------------------------------------[]-----------X------------------------[]------------X-XXX-XX---------------------------X-------------------------------------------X-------------------------------------------------------------[]-<>--------[]-----------------------------XXXXX-XXX-------XXX----------------------------------------------------------------XXXXX-XXX------E---X------------------------------------------[]--[]--[][]-------------------------------------------XXXX-----------------[]----------------------------XXXX--XXXX-------------<>----[]--[]----[]----------------[]-----------------E-------------------------------------------------------------------------------<>---------------[]------[]-----------------------------------------XXX--------------------------------------------X---[]----<>--------------------------[]-----------EXXX-X------------------[]--[]------[]------------[]------------------------------------------o------------------------------------------------------<>--<>[]--[]----[]---------<>------------------------
--------X-X------XXXX---ES----X-----------E---XXX-X-----XXX------------------X---X---[]----[]--E-----E--[]----E--XXX-----------XXXXE-XXXX-E--------------E---XXXXXXX----E------XXXXXX--XXXX-------XX-E-EE-E-[]----[]------E-[]--S----E-EE-E--E--[]---------E---[]-------------EE--X--------------------------E---[]--E-EE------E---------EE---XX-----------------------------[]----[]--[]------[]--[]------E-----E-E---------EE--XXX---------------------XXXXXX---[]----[]----[]------------------------------------[]-----E-EE--X------------------E-----[]-----------XXXXXX-XXE----------E---------------X---------------------EE-E------E-------X---X-----EE-E-----------------------------E----E--------------E--[]-[]-E------[]----------------E-EE--------XXXXX--XXXX-----XXXX-------------ooo-----------?------------------------E---E------XXXXXX-XXXX-----Q---X-----------------------E-EE--E-E-------E--[]--[]--[][]---E--------------------------------------XXXXX---SSS-----------[]E-------------------E------XXXXXE-XXXX-------------[]----[]--[]----[]-------E--EE-E--[]----------------------------------------------E-----------------E-E---------------------E--------[]----------EE---[]---E--[]-E-E--E--------------------------E-E----XXXXXE------E-----------------------------EE-E--XE--[]----[]--------------------EE-E--[]-----------XXXXXX---------------E--[]--[]------[]--------E---[]------------------oo---XXX--------------XXXX-------------------------------E---EE-------E----X---[]--[][]--[]----[]---------[]------------------------
XXXXX---XX--XXXXXXXXXXXXXXXEXXXX--XXXXXXXXXXXXXXXXXXXXXXXSS---------------XX-X-------XXXXXXXXXXXXXXXXXXXXXXXXXXXXXX------XXXXXXXXXXXXXXXXXXXXXX-XXXX-X-XX-XXXXXXXXX--XXXXXXXXXXXXXXXX--XXXXXXXXXXXXXXXXXXXXXXXXXXXXXXXXXXXXXXXXXSXXXXXXXXXXXXXXXXXXXXXXXXXXXXXXXXXXXXXXX---XXXXXXXXXXXXXX-X-XXXXXXXX-----XXXXXXXXXXXXXXXXXXXXXXXXXXXXXXXXXXXXXXXXXXXXXXXXX----------XXXXX----XXXXXXXXX-XXXXXXXXXXXXXXXXXXXXXXXXXXXXXXX---XXXXXXXXXXXXXXXX--XXXXXXXXX--XXXXXXXX--XXXXXXXXXXXXXXXXXXXXXXXXXX-XXXXXXXXXXXXXXXXXXXXXXXXXXXXXXXXXXXXXXXXXXXXXXXXXXXXXXXXXXXXXXXXXXXXXXXXXXXXXXXXXXXXXXXXXXXXXXXXXXXXXXXXXXXXXXXXXXXXXXXXXXXXXXXXXXXXXXXXXXXXXXXXXXXXXXXXXXXXXXXXXXXXXXXXXXXXXXXXXXX-X----------XXXXX-XXXXXXXXXXXXX--XXXXXXXXXXXXXXXXXXXXXXXXXXXXXXXXXXXXXXXXXXXXXXXXXXXXXX--XXXXXXXXXXXXXX----XXXX----XXX------------XX-XXXXXXXXXXX---X--XXXXXXXXXXXXXXXXXXXXXXXXXXXXXXXXX--XXXXX--XXXXXXXX---XXXXXXXXXXXXXXXXXXXXXXXXXXXX-XX--XXXXXXXXXXXXXXXXXXXXXXXXXXXXXXXXXXXXXX--XXXXXXXXXXX----XXXXXXXXXXXXXXXXXX-XXXXXXXXXXXXXXXXXXXXXXXXXXXXXXXXXXXXXXXXXXXXXXXXXXXXXXX--XXX-XXXXXXXXXXXXXXXXXXXXXXXXXXXXXXXXXXXXXXXXXXXXXXXXXXXXXX-------------XXXXXXXXXXXXXXXXXXXXXXXXXXXXXXXXXXXXXXXXXXXXXXXXXXXXXXXXXXXXXXXXXXXXXXXXXXXXXXXXXXXXXXXXXXXXXXXXXXXXXXXXXXXXXXXXXXXXXXXXXXXXXXXXXXXXXXXXXXXXXXXXXXXXXXXXXXX-XXXXXXXXXXXXXXXXXXXXXXXXXXXXXXXXXXXXXXXXXXXXXXXXXXXXXXXXXXXXXXXXXXXXXXXXXXXXXXXXXXXXX-XX--XXXXXXXXXXXXXXXXXXXXXXXXXXXXXXXXXX--------XX----------------------------------------------XXXXXXXXXXXXXXXXXXXXXXXXXXXXXXXXXXXXXXXXXXXXXXXXXXXXXXXXXXXXXXXXXXXXXXXXXXXXXXXX---X