------------------------------------------------------------------------------------------------------------------------------------------------------------------------------------------------------------------------------------------------------------------------------------------------------------------------------------------------------------------------------------------------------------------------------------------------------------------------------------------------------------------------------------------------------------------------------------------------------------------------------------------------------------------------------------------------------------------------------------------------------------------------------------------------------------------------------------------------------------------------------------------------------------------------------------------------------------------------------------------------------------------------------------------------------------------------------------------------------------------------------------------------------------------------------------------------------------------------------------------------------------------------------------------------------------------------------------------------------------------------------------------------------------------------------------------------------------------------------------------------------------------------------------------------------------------------
------------------------------------------------------------------------------------------------------------------------------------------------------------------------------------------------------------------------------------------------------------------------------------------------------------------------------------------------------------------------------------------------------------------------------------------------------------------------------------------------------------------------------------------------------------------------------------------------------------------------------------------------------------------------------------------------------------------------------------------------------------------------------------------------------------------------------------------------------------------------------------------------------------------------------------------------------------------------------------------------------------------------------------------------------------------------------------------------------------------------------------------------------------------------------------------------------------------------------------------------------------------------------------------------------------------------------------------------------------------------------------------------------------------------------------------------------------------------------------------------------------------------------------------------------------------------
SSSSSSSSSSSSSSSSSSSSSSSSSSSS----------------------------SSSSSSSS-S------------------------------------------------------------------------------------------------------------------------------------------------------------------------------------------------------------------------------------------------------------------------------SSSSSSSSSSSSSSSSSSSSSSSSSSSS-------------------------------ooo----------------------------------------------------------------------------------------------------------SSSSSSSSSSSSSSSSSSSSSSSSSSSS----------------------------SSSSSSSSSSSSSSSSSSSSSSSSSSSS--------------------------------------------------------------------------------------------------------------------------------------------------------------------------------------------------------------------------------------------------------------------------------------------------------------------SSSSSSSSSSSSSSSSSSSSSS--------------------------------------------------------------------SSS------------------------------------------------------------------------------------------------------------------------oo-------------------------------------------------------------------------------------------------------------------------------------------------------------------------------------oo---------------------------------------------------------------------------------------------------------------oo---------------------------------------------------------------------------------------------------------
-SSSSS-------S--SSSSSS----SS----------------------------------------------------------------------------------------------------------------------------------------------------------------------------------------------------------------------------------------------------------------------------------------------------------------------SSSSS-----SSSSSSSSSSSSSSSS----------------------------------------------------------------ooo---------------------------------------------------------------------------------------------S-------------------------------------------------------------------------------------------------------------------------------------------------------------------------------------------------------------------------------------------------------------------------------------------------------------------------------------------------------------------------------------SSSS-----------------------------------------------------------------------------------------------------------------------------------------------------------------------------------------------------------------X-E-------------o-----------------------------------------------------------------------------------------------------------------------------------------------------------------------------------------------------------------------------------------------------------------------------------------E--E---------------------------------------------------------------------------------------------------
-SSSSS--E---ES--SSSSSS---SSS-----------------------------------------------------------------o----------------oo----------------------------------------------------------------------------------------------------------------------------------------------------------------------------------------------------------------------------------SSSSS-----SSSSSSSSSSSSSSSS---------------------------------------XXX------------------------------------------------------------------------------oo--oo----------------------------------S----------------------------------------------------------------------------------------------------------------------------------E---------------------------------------------------------------------------------------------------------------E------------------------------------------------E-----------------------------------------E-------------------------------------X-SSSS--E----------------------------------------------------------------------------------?--------------------------------------------------------------------------------------------------------E-------oo-----------------------------------------------------------------------------------------------------------------------------------------------------------------------------------------------------X------------------------------------------------------------------------------------------------------------XXXXXXX--------------------------------------------------------------oooo-------------------------------
--SS----S------------S--SSSS---------------------------------Q----------------------oo-----------------o-----XXX----------------------------Q?SSS---?--S------------SSSS-----------SSS---------------SS-------------------------SSS-------------------SSS--SSSSSS-----------SQS---------SS----S--------------------S----------------SSSSSSS--------XX-------SSSSSSSSSSSSSSSSS-SQSS---SS-------------------------------------------------------XXXX-----------------SSS----SQ------------------------------------------------------------------------------------------------------------------------------------------S--------------------------SQQQ-------------------------SQS--SQS-------------------------SQSS----S--SS---SS-------SSSXXX------S-----------------------------------------SQS--SQSS----------------------------------------SQS------SSSSSSSSS-----------------------SSQSSSSS---------------QQ-----------------SS---SSS----------------S-----------------------------Q---S-S-SQQQQ---------------SSS--SS??----------------------------------SQS-------------?-----------------------------------------------SS---S---SQS-XXX-------------------------XXXX--------------------------------------------------------------------SS-----------------------------------------------------SSS-----------------------------------------------------------?SSS---SSSS----------------SS--------------XX-------------------------------------S---------------------------S-------------------------------------------------XXXX-----SSSS----------------------
--SS---SS---S--------S--SSSS-------oooo-----------------------------------------------------------------------------------------------------------------------------------------------------------------------------------------E----------------------------------------------------------------------------------------------------------------------------------------------------SS----------------------------------oooo---------XXXX------------------------------------------------------------------------------------------------------------------------------------------------------------------------------------------------------------------------------------------------------------------------------------------------XXXX-S---------------------------------------------------------------------------------------------------------------------------------------------------------------------------------------SSS------------------------------------------------------------------------------------------<>---------------------------------------------------------X------------------------------------------------------SSS---------XXXX--------------------------------------------------------------------------ES--------oooo-----------------------------------------------------------------------------------------------o-oo-----------------------------------------------XXSS-------------------------------------------------------------------------------------------------------------------------------------------E--------
--SS---SS---S--------S--S-SS-------------------------------S-------------------------------------------------------------E-----------------------------------------------------------------------------------------------------------------------------------------------------------------------------------------------------------------------------------------------------------SS-----------------------------------------------------------------------------------------------------------------------------------------------------------X--------------------------------------------------------------------------------------------------------------------------E---------E-------------------------------------------------EXXXX----------XX----------o--------------------------------------------------------------------------------------------------------------------------------------------------------------S---SS------------------------------------------------------------------------------------o--o---[]---------------------------------------------------------oo----------------------------------------------------XXS-----------------------------------------------------------------------------------S-----S--------------------------------------------E---------------------------------------------------------------------------------o------------------------------XXX--------------------------------------X--------------------------S------------------------E------------------------------------------------E<>--------
--SS-?-SS---So??-So--S--SoSS--------------------------o----S-----------oo---------S-XXX----------------XXX------S-------<>---------E-----SSS---------------------------------------------------ooo-----------------------SQ--------------E-----E-----SQ------------------------------------------------------------X---------E---------------------------------oooo------------------SS------?------------------------------------X-QS-------------S-------------------------------------E---------------------------------------------oo--------XXX----------------------E----------------------SS--------------------------------------------------------------E--S-------<>--------<>------------------------------------------------XXXXXX------------------------------------E----E----------------------E---------------E------------X--------------------------------------------------------------------------o---------X--SoooSS--------E--------So---E-------------------------------------------S------------------E-EE--------------S--------E------------------------------------------------------------------S-------E-----------E---XXX--------S---------------------------------------------S----------------------E-E---------SS------E----------------------X-------------<>----------------E----------------------ESSSS----------------------o---X----------------------------------------XXXX----------------------------------SS--------------------------------------------o-----E---------------------------------------------S-----<>[]--------
--SSS---S---SSS--SS-SS--SSSS----<>-------------------XXX---SSS-------E--Q-----Q---S--------------------------------E----[]-------E<>-----------------------Q---------------------------S------o------Q-------E------Q----------------S---E----<>-----------SS?S----QQQ-----QQ------------S---SS-------------------XX--------<>------SQ---------------S---------SS--------SS-SSSSS------------------------------------------------XXX---------------XX-----------X--S?S--Q--S------------<>-----------XXX-----------------------E----------------XXXX--------------------E<>------QQQ---------------------------------QQQQ----------------------QQ?SQQQ----------<>-----E----[]---E-QSS[]------------SS--------E?QQ?--Q------------------XXXXXX-----------XX-------SS--------E----<>---<>---QQQQQQ--S----E----<>-Q------------<>-----------XX---SQS-----E--S----------------SS------XX-------SSS----X---Q-Q--Q--S----E----------QX--SSS--S-------<>--------SS--<>-------QS-----X--X------QS--S?QQ-SSQQQQ-------E--E---SSSSSSSSSSSS------------------E----<>----E?QQQ--QQQ-----o-------------XXX---------------E----------------------XS--S?SS-------XXXX-------------------SSS-----------------------------XXXX---------------------------X--X---SS-----<>----------S----------XX---------<>--[]-----------SS--<>-----------------X---<>-------------S-----<>---------X--------SSS---------------oS-----------XXXXX---------X-----SSS----------------SSSS---------------E---------X-S-----------E-------<>------------XX-E---------------X-------S--------E--[][]--------
-E----------E-------------SS----[]---------E------------------------<>-------------------E-------XX---------------<>----[]------<>[]-----E-----------------------------------------E------------------------<>--------------------------<>----[]-------------------------E--------------------------------------EXXX--------[]------------------------------------------------------------S----------------E---E----------------XXXX--------------------------EXS-----------------------[]------------------------------------<>---------------EXXXX-------------------<>[]----------------XXX-?----E-----------------------------------------------------------[]----<>----[]--<>----[]----------------------------------------------XXXXXXXX--------XX-XX----------------<>----[]---[]---------------<>----[]--------------[]----------XXX----------<>----------E---------------XXX--XX----------X---------------<>---------------------------[]------------[]-----------------XX--------------------------<>------S-SSSSSSSSSSSS---------E-----<>----[]--------------------------------XXXX-XXX----------<>------------E-----------------------XXXXX-XX---------------------------XX-----------------XXXXX----------X-----------------XX-X----------[]-----E-------E------XXX---------[]--[]-------E-------[]-----------------X---[]----------------E--[]---------XX--------------E----------------------XXXXXX-------EXX--------------------------SS--------------<>---------XSS----------<>-------[]---------XXXXXXXXX------------XXX--------E-----<>--[][]--------
-----E--------------------SS----[]--------<>------------------------[]------------------<>------XXXX--------------[]----[]------[][]----<>----------------------------------------<>------------------------[]--------------------------[]----[]--------------------------------------------------------------EXXXXX--------[]-----------------------------------------------------------S----SS----------<>--<>---------------XXXXX--------------------------XXS-----------------------[]------------------------------------[]--------------XXXXXX-------------------[][]-----------------------------E-------------------------------------------------------[]----[]----[]--[]----[]---------------------------------------------XXXXXXXXX-------XXX-XX-------------<>-[]----[]---[]---------------[]----[]--------------[]---------XXXX----------[]-------------------------XXXX--XX------E---X---------------[]---------------------------[]------------[]-----------------XXXX------------------------[]-----SSSSSSSSSSSSSSSS-------<>-----[]----[]-------------------------------XXXXX-XXXX---------[]-----------<>----------------------XXXXXX-XX---------------------------XXXX---------------XXXXXX-------XXX-----------------XX-X------S---[]----<>------<>-----XXXX---------[]--[]------<>-------[]-----------------X---[]---------------<>--[]---------XX-------------<>---------------------XXXXXXX-------XXX--------------------------SSX-------------[]---------XSS----------[]-------[]-----------------------------XXXXX-------------[]--[][]--------
----------E-------------EE------[]--------[]-------------EE---------[]-----E-EE---------[]-----XXXX---------------[]----[]------[][]----[]-----------------------E-EE------EE---E-[]-----------------EE-E---[]-------------------E--E---[]----[]-------------------------------------------E-----E-EE---------XXXXXX-E-EE-E-[]-E--E------E---------------------------EE---------------E-----o-SS----------[]--[]---E----------XXXXXX-------------X-----------XXX------------------------[]------------------------------------[]--------------XXXXXX-----E-------------[][]------------------------------------------------------------------E---------------E--[]----[]----[]--[]----[]--E------E-E-E------------------------------XXXXXXXXXX------XXXX-XX-------------[]-[]----[]---[]----E---E------[]----[]-----E-E------[]--------XXXXX----EE-E--[]-E---------------E-E----XXXXXE-XXXX--------X-----E-E-------[]----------E----------E-----[]------------[]----E--------EEE-XXXX-EEE--------------EE----[]--------oSSSSSSSSSSS--E-----[]-----[]----[]-----------EE-----E-----------XXXXXX-XXXX---------[]E----------[]---------E-E----------XXXXXX?X------X-----------------EEE-XXXX---------------XXXXX--------XXXE-EE----XXX--ES--X--X------XE--[]----[]------[]----XXXXX--EE-E---[]--[]------[]--XXX--[]----E-----E-EE-E-X---[]---------------[]--[]---------XXX------------[]-----EE-EE----------XXXXXXXX------XXXX---E-------E-E-----------E--X-----E-EE----[]-E-------XSX----EE-E--[]-------[]-----------------------------XXX----E----------[]--[][]--------
X-XXXXXXXXXXXXXXXXXXXXXXXXXXXXXXXXXXXXXXXXXXXXXX-XX-----XXXXXXXXXXXXXXXXXXXXXXXXXXXXXXXXXXXXXXXX-X-----------X-XXXXXXXXXXXXXXXXXXXXXXXXXXXXXXXXXXXXXXXXXXXQ--XXXXXXXXXXXXXXXXXXXXXXXXXXXXXXXXXXXXXXXXXXXXXXXXXXXXXXXXXXXXXXXXXXXXXXXXXXXXXXXXXXXXXXXXXXXXXXXXXXXXXXXXXXXXXXXXXXXXXXXXXXXXXXXXXXXXXXXXXXX-XXXXXXXXXXXXXXXXXXXXXXXXXXXXXXXXXXXXXXXXXXXXXXXX---XXXXXXXXXXXXXXXXXXXXXXXXXXXXXXX----XXXXXXXXXXXXXXXXXXXXXXXXXXXXXXXXXXXX----XXXXXXXXXXX-------XXXXXXX--XXXXXXXXXXXXXXXXXXXXXXXXXX-XXXX-------XXXXX-X-XX------XXXXXXXXXXXXXXXXXXXXXXXXXXXXXXXXXXXXXXXXXXXXXXXXXXXXXXXXXXXXXXXXXX-----XXXXXXXX-X--XX--XXXXXXXXXX---XXXXXXXXXXXXXXXXXXXXXXXXXXX-XXXXXXXXXXXXXXXXXXXXXXXXXXXXXXXXXXXXXXXXXXXXXXXXXXXXXXXXXXXXXXXXXXXXXXXXXXXXXXXXXXXXXXXXXXXXXXXX-X---XXXXXXXXXXXXXXXXXXXXXXXXXXXXXXXXXXXXXXXXXXXXXXXXXXXXXXXXXXXXXXXXXXXXXXXXXXXXXXXXXXXXXXXXXXXXXXXXXXXXXXXXXXXXXXXXXXXXXXXXXXXXXXXXXXXXXXXXXXXXXXXXXXXXXXXXXXXXXXXXXXXXXXXXXXXXXXXXXXXXXXXXXXXXXXXXXXXXXXXXXXXXXXXXXXXXXXXXXXXXXXXXXXXXXXXXXXXXXXXXXXXXXXXXXXXXXXXXXXXXXXXXXXXXXXXXXXXXXXXXXXXXXXXXXXXXXXXXXXXXXXXXXXXXXXXXXXXXXXXX--XXXXXXXXXXXXXXXXXXXXXXXXXXXXXXXXXXXXXXXXXXXXXXXX-XXXXXXXXXXXXXXXXXXXXXXX-XXXXXXXXXXXXXXXXXX--XXXXXXXXXXXXXXXXXXXXXXXXXXXXXXXXXXXXXXX-XXXX-XXXXXXXXXXXXXXXXXXXXXXXXXXXXXXXXXXXXXXXXXXXXXXXXXXX-XXXXXXXXXXXXXXXXXXXXXXXXXXXXXXXXXXXXXXXXXXXXXXXXXXXXXXXXXXXXXXX--XX--XXXXXXXXXXXXXXXXXXXXXXXXXXXXXXXXXXXXXXXXXXXXXXXXXXXXXXXXXXXXXXXXXXXXXXXXXXXXXXXXXXXXXXXXXXXXXXXXXXXXXXXXXXXXXXXXXXXXXXXXXXXXXXXXXXXXXXXXXXXXXX-----------------XXXX-------XXXXXXXXXXXXXXXXXXXXXXXXXXXX