------------------------------------------------------------------------------------------------------------------------------------------------------------------------------------------------------------------------------------------------------------------------------------------------------------------------------------------------------------------------------------------------------------------------------------------------------------------------------------------------------------------------------------------------------------------------------------------------------------------------------------------------------------------------------------------------------------------------------------------------------------------------------------------------------------------------------------------------------------------------------------------------------------------------------------------------------------------------------------------------------------------------------------------------------------------------------------------------------------------------------------------------------------------------------------------------------------------------------------------------------------------------------------------------------------------------------------------------------------------------------------------------------------------------------------------------------------------------------------------------------------------------------------------------------------------------
------------------------------------------------------------------------------------------------------------------------------------------------------------------------------------------------------------------------------------------------------------------------------------------------------------------------------------------------------------------------------------------------------------------------------------------------------------------------------------------------------------------------------------------------------------------------------------------------------------------------------------------------------------------------------------------------------------------------------------------------------------------------------------------------------------------------------------------------------------------------------------------------------------------------------------------------------------------------------------------------------------------------------------------------------------------------------------------------------------------------------------------------------------------------------------------------------------------------------------------------------------------------------------------------------------------------------------------------------------------------------------------------------------------------------------------------------------------------------------------------------------------------------------------------------------------------
------------------------------------------------------------------------------------------------------------------------------------------------------------------------------------------------------------------------------------------------------------------------------------------------------------------------------------------------------------------------------------------------------------------------------------------------------------------------------------------------------------------------------------------------------------------------------------oo----------------------SSSSSSSSSSSSSSSSSSSSSSSSSSSS------------------------------------------------------------------------------------------------------------------------------------------------oo------------------------------------------------------------------------------------------------------------------------------------------------------------------------------------------------------------------------------------------------------------------------------------------------------------------------------------------------------------------------------------------------------------------------------------------------------------------------------------------------------------------------------------------------------------------------------------------------------------------------------------------------------------------------------------------------------------------------------------------------------------------------------
-----------------------------------------------------------------------------------------------------------------------------------------------------------------------------------------------------------------------------------------------------------------------------------------------------------------------------------------------------------------------------------------------------------------------------------------------------------------------------------------------------------------------------------------------------------------------------------XXXX---------------------SSSSS----------------------------------------------------------------------------------------------------------------------------------------------------------------------XXXX---------------------------oo------------------------------------------------------------------------------------------------------------------------------------------------------------------------------------------------------------------------------Qoo-----------------------------------------------------------------------------------------------------------------------------------------------------------------------------------------------------------------------------------------------------------------------------------o---------------------------------------------------------------------------------------------------------------------------------------------------------------------------------------------------------------------------
ooo-------------E---------------------------------------ooo-----------XXXX---------------------------------------------------------------------------------------------------------------------------------------------------------------------------------------------------------------------?--------------E---------E-----------------------------------------------------------------------------------------------------------------------------------------------------------------------------------------------------------------------------------------------------------------------------------SSSSS-----------------------------------------Eooo--------------------------------------------------------------------------------------------------------------------oo----------------------------------------------------------------------------------------------------------------------------------------------------------------------------------------E---------------------------------------------------------------------------------------------oo------------------Eooo----------------------------------------------------------------------------------------------------------------------------------------------------------------------------------------------------------------------------------------------------------------------------------------------------------------------------------------------------------------------------------------E-----------------------------------------------------------------------------
XXXX------------E--E--------S---------------------------XXXX--o--------------------------------------------------------------------SSSS--SSS---------------------------------------SSSS-SSSS------------S-----------XXSSSS---SS-----------------------------SSSS--SS----SS--------------SSSS---??-------------E--E--Q?SSQS----SSSS---SSSS-----S------------------------------------------------------------------------------------------------------SS-----SSSS-------------------SSSSS----SSSS-------SSS--SSSSSSSS----------------------------------------------------------------------------------------SS--------------------------------------------XXXXX---S-SQQ----------------------------------SSSS---------------------------S--SSSSSSSSS------SS-----SSS------oo-----------?-----------------------S---SS-------------------------------------------------------------?SSS------------------------------------------SSSSQ-----?SSS------------------SSS------SSSSS------SSSS---------------------------------------------------SSSSSE--------XXXX-----oo--------------------------XXXXX--------------------------------S-o-------------------------------------QQ-QQ------------------------QQQ--------------------------------SS---SSSS--------------------------------------------------------------------Q-QQSSS---------Q?SSS------SSS--XX----------E?SSS----------------?---------------------------------------------SSS---SS-SSS--------------------------------S-----SQS--SSS-------------------------------------------S---------------SSSSSSSS----
------------------XXXXXX--------------------------------XXX---------------------o--X-------------------------------------------------------------------------------------------------------------------------------XXX------------------------------------------------------------------------------------------XXXX---------------------------------------------------------------------------E-oo---------------------------------------------------------------------------------------------------------------------------------------------------------------------------ES-----------------oooo--------S----------------------------------------------------------------------------------------------------------------------------------------------X----------------------X-----------------oo---------------------------------------------------------------------------------------------------oooo-----------------------------------------------------------------------------------------------------------------------------------------------X------------XX---------------------------------------------------------------------------------------------------------------------------------------------------------------SS----------------------------------------------------------------------------------------------------------XXX--------------------------------------------------------------------------------------------------------------------------------------------------------------------------------------------------------------
--------------------------------------------------------------------------------------------------E---------------------------------------------------------------------------------------------------------------XXXXX-----------------------------------------------------------------------------------------------------------------------------------------------------------------------<>-----------------------------------------------------------------------------------------------------------------------------------------------------------------------------<>S----------------------------SS-------S------------------------------------------------o----------------------------------------------------------------------------------------------------------------------------------------X------------------------------XX-o-------------------------------------------------------------------------------------------------E---------------------------------------------------------E-----------------------------------------------------------------------------------------------------------------------------------------------------------------------------------------------------------------------------SS--------------------------------------------------------E------------------------------------------------XXXX---------------------------------E---------------------------------------------------------------------------------------------------E------------E-----------------------------------------------------------
---------------------------------------------------------------XXXXX-----------------------------<>-------E----------------------------------------------<>--------oo--------------------------------------------XXXXXX--------------------------E-------E---------------------------------??-------------------------------------------------------------------------E-----------------------[]-----------------------------------------------E------------o----------------------------------------------------------------------------X----------------------E------------[]X---------------E-------------E-------SSS--------------------E------------------------------------------------------E-----------------------------------------------------------------------X-----------------------E----------XXSSSSSSS----------------------XXX-------------------------------------------------------------------E----------X-------------------<>--------------------------------------------------------<>--------------------E---------SSSS--XX---------------XXX-------------E------------------------------------------XS---------------oo--------E-----------------------------E-------------------------------------------------?-SS------------------------------E---------------------E--<>----------------------------------------------XXXXXX------------SS----------------------------------------------------SS-SQ-----------------------X-------------------------------------------E---E--<>-----------------------------------------------------------
X-------ooo--X-----------------E------------------------XXX----------XXX-XXXXXXXX---------E--S---[]------<>-----QQ-------------------------X-S-------<>--[]------oo--------QQQQ---------------------oooo-------XXXXXXXXX----------QQQQ-QQ-------<>------<>--QQQQ--QQQQ---------------------??SSSSSSSSS---XXXX------QS--QQQ--QQ--Q--S-----S?S--------QQQ-----S--------<>----------ooQo----E--<o[]-----E----------------------------------------<>---S------------QQQQ-------------------S-----oo-------XXX-XX-----SSSS--------------------XX--------------------<>-----------X[]X--------------<>------------SSSS---------------------------<>----------------SSSSS--SSS---------------------------<>---QQQQQ-------E--------QQ-------------SSS-SSSSS-------------S?S-----------------Q-------E----<>---------XXX-----------SS----X--X--------XXX---------S-----------E-----QQQQ--------------------X--------------<>---------XXX--QQ--QQQ------E--[]---E----------S---------------SS---------------------E--[]-------------------<>--------------------------XXXXX----------S--E--<>-----------------------------------------XXX-SSS---XXXX-------------<>-------------QQQ--QQQQ--Q---<>--------S---S--S?SQS-----------Q-------------------------------QQ--Q-Q------------<>---E-------------E--<>--[]------X------QQQ--QQQQ--------------SSQS-----XXX-XXX-X-------------E--Q--Q-----Q---S?S----QQ--------------------E--S-----------------X------------X--Q----------------------SS------S--S?S---<>--<>--[]------------Q-QQ--------S---------------------SSSSSSSSS---X
-----o----E-------------------<>---------------------------------------------------------<>------[]------[]-------------------------------XX---------[]--[]---------------------------------------------------XXXXXXXXXX------------------------[]------[]-----------------------------------SSSS--------------------------------------------------------------------[]-----------------<>--[][]----<>-------------------XXX------------------[]------E<>-----------------XX---X-----------X---------XXXX-XX---EEE-----X-----------------XX--------------------[]----------XX[]X-----XXX------[]---------X------------------------------E--[]------E----------------------------------------------[]-------------E<>-----E---------------------E-------X------------------------------------<>----[]--------XXXX--------------E--X--XX-------XXX--------------------------------------------------XX------X-------[]--------XXXX--------------<>--[]--<>------------------------------------------------<>--[]----X--------------[]-------------------------------------------<>--[]----------------------------------------XXXX-SSS--------------------[]----------------------------[]------------------------------------------------------EE-----------------E--------[]----------------<>--[]--[]------S-------------------------------------XXXX-XXX-X---------------------------------------------------------<>--------------------X----------XXX-------------------------SS---------------[]--[]--[]--------------------------------------------------E-------X
----XXXXXXX-------------------[]----------------------------XXXX-------------------------[]------[]------[]----------------------------E-XXX---------[]--[]----------------------------X-----------X---------XXXXXXXXXXX-------X----------------[]------[]-------------------------E---------SSSS--------------------------------------------------------------------[]-----------------[]--[][]----[]----------------------------------------[]-----<>[]----------------XXX---X-----------X--------XXXXX-XXX----------X----------<>-----X---------------------[]---------XXX[]X--------------[]---------X------------------------------E--[]-----<>----------------------X---------------X-------[]------------<>[]----<>-------------X---------------X---------------------------X--------[]----[]----<>-XXXXX------------E----X--XXX------XXX-------------------------------------------------XXX--------------[]-------XXXXX--------------[]--[]--[]----------------X-------------------------------[]--[]----X--------------[]-------------------------------------------[]--[]---------------------------------------XXXXX-SSS--------------------[]----------------------------[]------------------------------------------<>--------------------------------------[]----------------[]--[]--[]------S------------------------------------XXXXX-XXX-X-----------------------------------X---------------------[]--------------------X---------XXXX-------------------------SS---------------[]--[]--[]------------------------------------------------------E---X
---------------------------EE-[]----------------------EE---------------------------------[]-E----[]------[]----------------E--------------XXE--EE----[]--[]------------------------X-E-X----------XX--------XXXXXXXXXXXX------XX----------E-EE--[]------[]---------------------------------------oooo---------------------------E----------------------E-------------[]-----------------[]--[][]----[]-E-------------------------E-----EE-E---[]-----[][]-E-------------XXXX---X-----------X-------XXXXXX-XXX----------X--------E-[]-----X---------X-----EEEE--[]-E-------XXX[]X--------------[]---------X---------------------------------[]-----[]----------------E-----X-------------E-X-------[]------------[][]--E-[]-------------E-E-------------X-----------------------EE--X--------[]-E--[]----[]-XXXXX-----------------XE-XXXX-----XXX------------------------------------------------XXXX--------------[]------XXXXXX-E------------[]--[]--[]------------------E------------X----------EE-E--[]--[]----X----E-----E---[]-------E-E---------------------------------[]--[]-----------------------------E-E-E-E--XXXXXX-SSS-o------------------[]---EE-----------------E-E---[]--------EE-E----E-----E-EE-----------E----[]--------------------------------------[]-----E--------E-[]--[]--[]----EES---------E-E---E-EE----------------XXXXXX-XXX-X---E-------------------------EE----X-----E-EE------EEE---[]----------------E---X-S--------XXX-------E----------------SSS---------------[]--[]--[]------------E----------------E----------E---E-------------X
------------------------XXXXXXXXXXXXX---XXXXXXXX---XXXXX--------------------------XXXXXXXXXXXXXXXXXXXXXXXXXXXXXXXXXXXXXXXXXXXXXXXXXXXXXXXXXXXXXXXXXXXXXXXXXXXXXXXXXXXXXX----XXXXXXXXXXXXXXXXXXXXXXXXXXXXXXXXXXXXXXXXXXXXXXXXXXXXXXXXXXXXXXXXXXXXXXXXXXXXXXXXXXXXXXXXXXXX---XXXXXXXXXXXXX-XXXXXXXXXXXXXXXXX---XXXXXXXXXXXXXXXXXXXXXXXXXXXXXXXXXX-XXXXXXXXXXXXXXXXXXXXXXXXXXXXXXXXXXXXXXXXXXXXXXXXXXXXXXXXXXXXXXXXX----XXX-----XXXXXXXXXXXXXXXXXXXXXXXXXXXXXXXXXXXXXXXXXXXXXXXXXXXXXXXXXXXX---XXXXXXXXXXXX--XXXXXXXXXXXXXXXXXXXXXXXXXXXXXXXXXXXXXXXXXXXXXXXXXXXXXXXXXXXXXXXXXXXXXXXXXX----XXXXXXXXXXXXXXXXX---XXXXXXXXXXXXXXXXXXXXXXXXXXXXX--XXXXXXXXXXXXXXXXXXXXXXX--XXXXXXXXXXXX---XXXXXXXXXXXXXXXXXXXXXXXXXXXXXXXXXXXXXXXXX--XXXXXXXXXXXXXXXXXXXXXXX--XX----XXXXXXX-------XXXXXXXXXXXXXXXXXXXXXXXXXXXXXXXXXXXXXXXXXXXXXXXXXXXXXXXXXXXXXXXXXXXXXXXXXXXXXXXXXXXXXXXXXXXXXXXXXXXXXXXXXXXXXXXXXXXXXXXXXXXXX----XXXXXXXXXXXXXXXXXXX-XXXXXXXXXXXXXXXXXXXXX-XXXXXXXXXXXXXXXXXXXXXXXXXXXXXXXXXXXXX--X----XXXXX-XX--XXXXXXX-XXXXXXXXXXXXXXXXXXXXXXXXXXXXXX----XXX-------------------XXXXXXXXXXXXXXXXXX----XXXXXXX-XXXXXXXXXXXXXXXXXXXXX--SSXXXXX-XXXXXX-X-XX----XXXXXXXXXXXXXXXXXXXXXXXXXXXXXXXXXXXXXXXXXXXXXXXXXXXXXXXXXXXXXXXXXXXXXXXXXXXXXXXXXXXXXXXXXXX-XXXXXXXXXXXXXXXXXXXXXXXXXXXXXXXXXXXXXXXXXX--XX--XXXXXXXX---XXXXXXXXXXXXXXXXXXXXXXXXXXXXXXXXXXXXXXQoXXXXXXXXXXXXXXXXXXXXXXXXXX----XXXXXXXXXXXXXXXXXXXXXXXXXXXXXXXXXXXXXXXXXXXXXXXXXXXXXXXXXX-XXXXXXXXX--XXXXXXXXXXXXXXXXXXXXX-SSXXXXXXXXXXXXXXXXXX--XXX-XXXX-XXXXXXXXXXXXXXXXXXXXXXXXXXXXX-XXXXXXXXXXXXXXXXXXXXXXX--X