------------------------------------------------------------------------------------------------------------------------------------------------------------------------------------------------------------------------------------------------------------------------------------------------------------------------------------------------------------------------------------------------------------------------------------------------------------------------------------------------------------------------------------------------------------------------------------------------------------------------------------------------------------------------------------------------------------------------------------------------------------------------------------------------------------------------------------------------------------------------------------------------------------------------------------------------------------------------------------------------------------------------------------------------------------------------------------------------------------------------------------------------------------------------------------------------------------------------------------------------------------------------------------------------------------------------------------------------------------------------------------------------------------------------------------------------------------------------------------------------------------------------------------------------------------------------
------------------------------------------------------------------------------------------------------------------------------------------------------------------------------------------------------------------------------------------------------------------------------------------------------------------------------------------------------------------------------------------------------------------------------------------------------------------------------------------------------------------------------------------------------------------------------------------------------------------------------------------------------------------------------------------------------------------------------------------------------------------------------------------------------------------------------------------------------------------------------------------------------------------------------------------------------------------------------------------------------------------------------------------------------------------------------------------------------------------------------------------------------------------------------------------------------------------------------------------------------------------------------------------------------------------------------------------------------------------------------------------------------------------------------------------------------------------------------------------------------------------------------------------------------------------------
-------------------------------------------------------------oo------------------------SSSSSSSSSSS--------------------------------------------------------------------------------------------------------------------------------------------------------------------------------------------------------------------------------------------SS--------------------------------------------------------------------------------------------------------------------------------------------------------------------------------------------------------------------------------------------------------------------------------------------------------------------------------------------------------------------------------------------------------------------------------------------------------------------------------------oo------------------------------------------------------------------------------------------------------------------------------------------------------------------------------------------------------------------------------------------------------------------------------------------------------------------------------------------------------------------------------------------------------------SSSSSSSSSSSSSSSSSSSSSSSSSSSS----------------------------------------------------------------------------------------------------------------------------------------------------------------------------------------------------------------------------------------------------------------------------------------
------------------------------------------------------------XXXX------------------------------------------------------------------------------------------------------------------------------------------------------------------------------------------------------------------------------------------------------------------------------SS------------------------------------------------------------------------------------------------------------------------------------------------------------------------------------------------------------------------------------------------------------------------------------------------------------------------------------------------------------------------------------------------------------------------------------------------------------------------------------------E--------------------------------------------------------------------------------------------------------------------------------------------------------------------------------------------------------------oo---------------------------------------------------Q-----------------------------------------------------------------------------------------------------------------------------------------------------------------------------------------------------------------------------------------------------------------------------------------------------------------------o---------------------------------------------------------------------------------------------------------------------------------
---------------------------------------------------------------------------------------------------------------------------------------------------------------------------------------------------------------------------------------------------------------------------------------------------------------------------------------------SSS-----------------------------------------------------------------------------------------------E--------------------------------E-----------------------------------------------------------------------------------------------------------------------------------------------------------------------------------------------------------------------------------------------------------------------------------------------------E--------------------------------------------------XXX-----------------------------------------------------------------------------------------------E------------------------------------------------E-------------------------------------------------------------------o--E-------o----------------------------------------------------------------------------------------------------------------------------------Eooo------------------------------------------------------------------oooo---------------------------------------------------------------------------------------------------------------------E------------------------------ooooooo---------E-----------------------------------------------------------------------------------------------------------
------------------SSSS-------------------------------------------------------------S-------------------------------------------------------------------------SSSSS----------------------SSSSSS----S-------------------------Q------------------------------S---------------SSQS----------------------------?SSS---------------------SSSSSSSSSSSS-SSS------------------------------E---------S--SS-----ES-----------------S---------S----------SQS--SQQS---------S-SSS----------SQSSS-------------------------S---SSS---S----------------------------S-S-----E--S-------------------------------------------------------SSS---S?S-SS------SS---SS--------SS---------S--------------------------------------------------------------S---?SSS-----------------------SSSS-----------------E--E---------------------S-----Xo-------XXXX-o---------------ESSSSS-------?-------------------------------------------------------------------------SQS--SQS---------S--------------------------------E------SSSSSS-----------------S---------------------E----ooo--XXXX-----E-----------S---SSS----------XXX-----------------------------------S-----------------------------------------------------------------------XXXXX-----------------------SSS--SSS----QQ----------------------------XXXX------------------------------QQQQ---------------------------Q--------------Q?SSS---?-------------------XX-----------E--E-------oo--------------XXX-----------------QS-S---SSSSS--SSS----------?----------------SSSSS---------------------SSS---SSSS----------------------------
-------------------------XX-------------------------E----------------------------------------------------------------------------------------------------------------------------------------------------------------------------------------------------------------------------------------------------------------------------------------------------------------------------<>------------SS----<>S---------------------------------------------------------------------------------------------------------------------------------------------------<>------------------o----------------------------------------------------ES------------------------------------------------------------------------------------------------------------E-------------------------------------XXXXXX----------------------------------------------------<>--------------------------------------------------------------------------------------------------------------------------------------------------------------------------------------------XX---XX--------------XXXXXXX-------------------XXXX-------------------------------------------------XSS---------------E----------------------ooo---------------------------------------------------------------------------------------------------------------------------------------------------------------------------------------------------------------XXXXXX----------------------------------o---------------------------------------------------------------------------SS-----------------------------------
--------------------------------------------------XXXXXX---------------------------o--------------------------------------------------------------------------------------------------------------------------------------------------------------------------------------------------------------------------------------------------------------o------------------------------[]------------SS----[]S---------------------------------------------------------------------------------------------------------S-----------------------------------------[]-----------------------------------------X----o-------------------------S--------S---------------------------------------------------------E---------------------------------------------------------------------------------------------X-X-XX-----------------------------------E--[]----------------------------------------------E-------------------------------------------------------------------------------------XX----------------------------------------------------------------------------------------------------XXXXX------------------------------------------------XX---------------XXXX--------------------------------------------------------------------------------------------------------------------------o--------------------------------------------------------------------------------------------------XXXXXXX---------------------------------------XXXXXX--------------------------------------------------------------------------SS-----------------------------------
---------------------------------------------------------------------------------E--------------o---------------SQSSSSSS------------------------------E--------------------------------------------------------oo----------------------------------------------------------------------------S--------------------------------E--o--------------------SS-------------------------[]----------?-SS----[]S-------E---------E------------------------------------------------------------------------------ooo---?-SS-----------------------------------------[]---------------E------------------------XX-----------------------------SS----o---S--E----------------------------------o-----------------------------------------------------------SQ-----------------------E-------E------------------S---XXXX----------------------XXXX--------<>--XX-------------------------<>-----E------------<>---E---------------------------------------E----------------------------------E------XX----------------------E------------------------------------XXX-----------XXXXX------------------E-E-XXXXX-----S----S------------------SSSS--------------XXXS--S--------------------------------------------------------------------------------------E---------------o---ooo-----------o---oo----------S-------------------------------------------------------------------------------E-----X--------------------------------XXX-----------------------------S---------------------------SS-SQS---------E-----------------------------?-SS---------------o-------------------
--------------XXXX-----------------------------------------------------S--------<>-SQQ-------------------E----------------XXX--------------------XX--<>--------SSSSSS--------------E----S-------------------------------<>-QQ-----------------------------S----------------SSSQQQ------------------XXX-XX----SSS-------------<>--------SSSSSSSS-QQQ----------------------XX--S---[]SS----------SS--S-XXX---E------------<>--<>----S----E-------Q--EQQQQ----------ES-S----S-----SSQQSQQQQ--------------E---------------SS-----XXX----------------------E--SS[]SS-----E------<>-X---------------------XXX----------------XX--X----X---SS----S---SS<>-----ES--------X----------------E-------------------oS-------XX----------X------S?S---S----X------------------Q-------<>------<>-------------------S--X-XX-----------XXXXX------------------[]-----QQQQ--------------------[]-S--<>------------[]--<>-----------------E----------E---------<>-----------S---------------------<>------SX--QQQ------S---------SSS------SSSS--------------------X-------XX-XXXXX-------------------S-----S----XXXXX--------E--------------------------Q-SS------XXXXXX----------XXX----ooo-----XXXXX------------------------XXXXXXXXX------------------------SSSSS---SSSS---------------------------o----------XX--------------------E??QQQ-------------------E---QQQQQ----------------S?S------------XX----------XX-------------------------XX------------XXXX---------S--QQQ------------X-----------------------<>--------------------------------S----SS-------E---------------------
----------------------------------XXX-------XXXX-----------------------------XX-[]-S----------XXXX?-----<>--------------------------------------XXXX-[]--------E--E----X----E-----<>------------------------------------[]------------------------------------------------------------------------XXXX-XX--------------------[]-----------EE-----------------XX-?-------XXX------[]---E-----------EE------<>------------[]--[]--------<>-------------------------E-----------------------------------<>-----------------------------------X----------<>----[]------<>------[]-----------------------XXX---------------XXX--XX-------------------[]----<>---------XXX-------------<>-----------X---------------XXXX-------EXX--------------E--X--------------------------[]------[]--------------------X-X-XX----------------------------------[]-----------------------------[]----[]------------[]--[]----------------<>---------<>-----E---[]---------------------------------[]--E---XX--------------------EE-------------------------------S----------------------------------------------XXXXX-------<>-----------E-----------------------XXXXXXX---------------------------------------------------------------------------------------------------------------------------------------XXXX-----------XX-------------------------------<>-------------------------------------X-XX----------XXXXX-------------------------------------------------S--------------E--XX----------------------[]-------------------------------E--E--E-------<>---------------------
------------E---X----------------XXXXXXXX---------------E-----------------------[]-S--------------------[]------------------------XXXX---------XXXXX-[]----------------X----------[]------------------------------------[]-----------------------------------------------------------------------XXXXXXXX----------o---------[]----------------------------------------XXXX------[]--<>-------------------[]------------[]--[]--------[]-------------------------------------------------------------[]-----------------------------------X----------[]----[]------[]------[]---------------------X-XXX--------------XXXX--XXXX-----------------[]----[]---------XXX-------------[]---------XXXX-------------XXXX--------XXX-----------------X--------------------------[]------[]--------------------X-X-XX----------------------------------[]-----------------------------[]----[]------------[]--[]----------------[]---------[]----<>---[]---------------------------------[]------SX-----------------------------------------------------S----o------------o----------------------------XXXXX-------[]----------<>----------------------XXXXXXXX------o-------XXXX-----------------XX---------------------------oo--------------------------------------------------------------------XXXXX--------------------------------------------[]---------------------------------E---X-XXX-----------------------------------------------------XXXXX-----S--------------X--XXX---------------<>----[]-----------E---------------------------------[]--->-----------------
----------------X------------E--XXXXX------------------------EE-EE----EE-EE-X-X-[]-S--------------------[]------------------------------------XXXXXX-[]----------------X---EE-E---[]----------E-------------------------[]-------EE-E----------------E-----------E------------------------------XXXXXXXXXS--------XX-----EE--[]---------------------------------------XXXXX---E--[]--[]-------------------[]--------E---[]--[]--------[]-----E-----------EE-EE---------------------E-EE--------EE-E--[]--------E-E--------------------EE--X----------[]-E--[]--E---[]------[]-----------E----E------XXX--------E----XXXXX--XXXX----------EE-E---[]----[]---------XXX---------E---[]------E-EXXXX------------XXXXX------XXXXX-----------------X-----X---------E----E-EE--[]------[]--------------EE-E--X-X-XX----XXXXXX------------------------[]--------------------------E--[]-E--[]------------[]--[]----------------[]---------[]----[]---[]------EE----------------------E--[]----EES-----------E-E-------------E--E-------E-EE----------E----XXXX----------XXX---------------------------XXXXX-------[]----------[]--------------E------XXXXXXXXS--------X--------------------------------------XX--------------XXX----EE-E----EE-----------------------------------------------------XXXXXXS--------------------------E-EE---X---E-----[]---------EE-EE-----------------------X-XX---EE-E---------------------------------XXXXXXXXXXX-------------S--------------X--X-----------------[]-E--[]-----------S-----E-E-----E----------------E--[]-X[]-----E-----------
XX---XXXXXXXXX-------XXXXXXXXXXXXXXX-------------XXXXXXXXXXXXXXXXXXXXXXXXXXXXXX-XXXXXXXX--XXXX-----XXXXXXXXXXXXXXXXX---XX-------------------XXXXXXX--XXXXXXXXXXXXXXXXXXXXXXXXXXXXXXXXXXXXXXXXXXXXXX-XXXXXXXXXXX--XXXXXXXXXXXXXX-XXXXXXXXXXXXXXXXXXXXXXXXXXXXXXXXXXXXXXXXXXXXXXXXXXXXXXXXXXXXXXXXXXXXXXXXXXXXXXXXXXXXXXXXXXXXXXXXXXXXXXXXXXXXXXXXXXXXXXXXXXX-----XXXXXXXXXXXXXXXXXXXXXXXXXXXXXXXXXXXXXXXXXXXXXXXXXXXXXXXXXXXXXXXXXXXXXXXXXXXXXXXXXXXXXXXXXXXXXXXXXXXXXXXXXXXXXXXXXXXXXXXXXXXXXXXXXXXXXXXXXXXXXXXXXXXXXXXXXXXXXXX---XXXXXXXXXXXXXXXXXXXXXXXXXXXXXXXXXXXXXXXXXXXXX-----XXXXXXXXXXXXXXXXXXXXXXXXX-XXXXXXXXXXXXXXXXXXXXXXXXXXXXXXXXXXXXXXXXXXXXXXXXXXXXXXX---XXXXXXXXXXXX--XXXXXXXXXXXXXXXXXXXXXXXXXXX-X-XXXXXXXXXXXXXXXXXXXXXXXXX-----XXXXXXXXXXXXXXXXXXXXXXXXXXXXXXXXXX----XXXXXXXXXXXXXXXXXXXXXXXX----------------------------XXXXXXXXXXXX------XXXXXXXXXXXXXXXXXXXXXXXXXXXXXXXXXXXXXXXXXXXXXXXXXXXXXXXXXXXXXXXXXXXXXXXXXXXXXXXXXXXXXXXXXXXXXXXXXXXXXXXXXXXXXXXX--XXXXXXXXX--XXXXXXXXXXXXXXXXXXXXXXXX-XXXXXXXXXXXXXXXX-XXXXXXXXXXX----------------------------XXXXX-XXXXXXX-XXXXXXXXXXXXXXXXXXXXXXXXXXXXXXXXXXXXXXXXXXXXXXXXXXXXXXXXXXXXX--XXXXXXX----------------------------XXXXXXXXX-------------------XXXXXXXXXXXXXXXXXXXXXXXXXX--XXXXXXXXXXXXXXXXX-XXXXX--XXXXXXXXXXXXXXXXXXXX---XXXXXXXXXX-----XXXXXXXXXXXXXXXXXXXXXXXXXXXXXX-X-XXXXXXXXXXXXXXXXXXXXXXXXXXXXXX--XXXXXXXXXXXX--------------------------------------------------------XXXXXXXXXXXXX--XXXXXXXXXXXX-XXXXXXXXXXXXXXXXXXXXXXXXX--XXXXXXXXXXXXXXXXXXXXXXXXXXXXXXXXXXXXXXXXXXXXXXXXXXXXXXXXX