------------------------------------------------------------------------------------------------------------------------------------------------------------------------------------------------------------------------------------------------------------------------------------------------------------------------------------------------------------------------------------------------------------------------------------------------------------------------------------------------------------------------------------------------------------------------------------------------------------------------------------------------------------------------------------------------------------------------------------------------------------------------------------------------------------------------------------------------------------------------------------------------------------------------------------------------------------------------------------------------------------------------------------------------------------------------------------------------------------------------------------------------------------------------------------------------------------------------------------------------------------------------------------------------------------------------------------------------------------------------------------------------------------------------------------------------------------------------------------------------------------------------------------------------------------------------
------------------------------------------------------------------------------------------------------------------------------------------------------------------------------------------------------------------------------------------------------------------------------------------------------------------------------------------------------------------------------------------------------------------------------------------------------------------------------------------------------------------------------------------------------------------------------------------------------------------------------------------------------------------------------------------------------------------------------------------------------------------------------------------------------------------------------------------------------------------------------------------------------------------------------------------------------------------------------------------------------------------------------------------------------------------------------------------------------------------------------------------------------------------------------------------------------------------------------------------------------------------------------------------------------------------------------------------------------------------------------------------------------------------------------------------------------------------------------------------------------------------------------------------------------------------------
----------------------------------------------------------------------------------------------------------------------------------------------------------------------------------------------------------------------oo--------------------------------------------------------------------------------------------------------------------------------------------------------------------------------------------------------------------------------------------------------------------------------------------------------------------------------------------------------------------------------------------------------------------------------------------------------------------------------------------------------------------------------------------------------------------------------------------------------------------SSSSSSSSSSSSSSSSS--------------S-----------------S-------------------------------------------------------------------------------------------------------------------------------------------------------ooo---------------------------------------------------ooo-------------------------------------------------------------------oo-------------------------------------SSSSSSSSSSSSSSSSSSSSSSSSSSSS--------------------------------------------------------------------------------------------------------------------------------------------------------------------------------------------------------------------------------------------------------------------------------------------------------------------
-----------------------------------------------------------------------------------------------------------?--------------------------------------------------------------------------------------------------------------------------------------------------------------------------------------------------------------------------------------------------------------------------------------------------------------------------------------------------------------------------------------------------------------------------------------------------------------------------------------------------------------------------------o------------------------------------------------------E-------------------------------------------------------------------------------------------------------------------------------------------------------------------------------------------------------------------------------------------------------------------------------------------------------------------------------------------------XXXX-------------------------------------?----o-oo----XXXX-----------------------------------------------------------------XXXX-------------o----------------------------------------------------------------------------------------------------------------------------------------------------------------------------------------------------------------------------------------------------------------------------------------------------------------------------------------------------------------------
-----------------------------X--------------E------------------------------------------------------ooooooo-------------------------------------------o------------------------------------------------------oo---o---------------------------------------------------------------------------------------------------------------------------------------------------------------------------------------------------------E---------------------------oooo-------------------------------------E---------------------------------------------------------------------------------------------------------------------------------------------------------------------------------------------------------------------------------------------------------------------------S----------------------------------------------------------------------------------------------------------------------------------E-----------------------------------------------------------------------------------------------------------------------------------------------------------S---------------------------------------------------------------------------------------------?------------------X---S?--E------------------------------------------------------------------------------------------------------E------------------------------------------------------------------------------------------------------------------------------------------------------------------------------------------------------------------------------------------------------------
-------SSS---E------------------SSSS------SSSS--------SS--------------------XXX-----------------XX--------------------------------------SSSS------------------oo--------SSS------SSS-----------------------XXXX--------XX--------------------------------SSSSSSS-------------SSSSSS--SQS?SSS-----------------------------------S--------------------------------------------S?SSS---------SSSSS----SSSSS------------SSS---XXS-------------------XX----XXXXX--------------------------SSSSS-----SQS-----SSSSS---------SSS-----SS---------XX----------SSS--------------------SSSSSSS-----------------------------SSSS-----SSSSSS---?--------SSS------S----SSSSSS-------------------------?SSS-----SS?S-----------------SS------------Q-Q--------------------SS--------------XXX--------QQ--------------S---------------------SSS---SS--------S------------------------------------------------------------------SQS--SQSS-------SS------------SSSS-----SSSSS----SSS----?SSS--------?------------------------------SSSSS?SSS-----------------------------SS-------------SSSSS-S-S----SS---------S---SSS---S-------------------------------------------------SS-----------SSS??--------------XX----SSQ--SS---------------------------------------?---------------------SSSSS-------S---SS---------Q---------SSSS-----------------S---?----------------------SSSSSSS-----------------------------Q-----QQQ----------------QQQQ----------------------------------------?-SS------------------------------SSSSS---------------S------------------------------------------------
------------<>-------------------------------------------------------------------------------------------------o-------------------------------------------------------------------------------------------------------XXX-----------------------------------------------------------------------------------------------------------------------------------------------------------------------------------------------XXX--------XX--------------------------------------------------------------------------------------------------XX----------SS------------------------------------------------XXXX----------------------------------------------------------------------------------------------------------------------------------------------o-o--------------XXXX-------------------------------------------------------------------------------------------------------------------------------------------------------------------------------------------------------------------------------------------------------------------------SS----------------SS--E-----------------------------------------------------------------------XS-----------------------------------------S----SS-------E-------------------------------------------------------------------------------------------------------------------------------------------------------------ooo------------------------------------------------------------------------------------------------------------------------------------------------------------------------------------------
------------[]--o-------------------------------------------------------------------------------------------XXXX-------------------------------------------------------------------------------------------------------XXX----------------------------------------------------------------------------------------------------------------------------------------------------------------------------------------------XXXX----------------------------------------------------------------------------------------------------------XXXX-----------S-------------------------------------o---------------------------------------o-------------------------------------------------------------o----------------------------------------------------------------------XXXXX------------------------------------------------------------------------------------------------XX------------------------------------------------------------------------------------------------------------------------------------------------------------o----------SS----------------SS-------------------------------------------------------------------------XXX---------------------------------------SSS----SS------?-----------------------------------------------------------------------------------------------------------------------------------------------------------------------------------------------------------------------------------------------------------------------------------------------------------------------------------------------------------
------------[]----------------------------------------------------------------------------------------------------------------E--S------------X----------------XX---------XXX-------------------E-----------------------XX-----------------E--o----------------------ooo---------E--------------------------------------------------------E--------------------------------X---------------------------------------E-EE-XXXX---------------------------------------------E------------SSSS------------------------------------------X-XXXX----------SS----------ooooo--------------------------------------------------------------------SQ-Q---------------------------------------------------S----------------------------------------------------------------------XXXXXX---------------------------------------------------------------------------ooooo---------------XXS-S--------------E-------E----------------------------------------------SSSS-----------------------------------------E----------------S------------------------------ooSSS----------S-----SS--------S-----------------------------------------------------------------XX----------E------------------------------So?--SS---------------------------S-------------------------------------------------S----------------------------------------------------SS-S--------------------------------------------------------------ooo---o-------------------------------------------------------------E----------------E-------------------------------------E----------------------------------
X---SSX----SXXS-------------------S--------S----E--------QQ------------------------ES-------------XXXXX----------------------<>-----E------<>------------------------------------S?S-----------<>--------------------XXXXX----------------<>-------------------------------XXXX-SSSSSS---------------------S--------S--------Q-Q---S-----<>-----QQQ-----------------------XX---------------------SS-----------Q-----X--XX-XX------------------------------X-------------<>----------------SS---SQQ------X--XX---------------SSS----XXX-XXX---------XSS--SSS-----------------E?S-----------------XXXX-----------SSS---------------SS--------------------------------X-ooo----------XX------------SS------X-EX--X----------------QQ--QSQ-------------------oo-----------XXXXXXX-------??QQQ--Q-Q---------------------------------------oo---SS-------------------------------XXX------E-------SSSSSS----<>---QQQ-QQ--QQQ-----S---------------XX--X-----------------Q--QQQQ-----QQ---Q---------------<>---S---------------------QQQQ--XXX---SSS--------SSSS--S------SS-----SSSS-----SSS---------SS---XX-------------------------------------------XXX-XXX--------XXX---XXXX---------X-------------SSS--SS------Q-Q----------------E--S----SSS-------------------------SS---------E-----S-------SSSS-----------------------E----QQQ--QQQ-------------E------QQ?-------------<>------------------Q---QQ??S----------------QQQQQ---------------------------------QQQQ--------S-----<>---Q-----------<>----------------Q------SS---E-------<>-----------------------S------X---
XXX--------------E-----------oo----------------<>------X-----------------------X-------E---E------------------------<>----E--[]----<>------[]--------------------------------------------------[]------------------XXXXXXX-SSS------------[]------E-E------------------------E--E--------------------------------------------------------[]--E--------------------------XXXX---------------------------------------XX--XXXXX--------------------------------------------[]----------------SS----------EXX--XX-----E---------------XXXXXXXX--------XX----------------------------------------------------------SSSS------------------------------------------------XX-------------XXXX--X---------------XXXXX--XX----EE-------------------------------------------X---XXXXXXXX-------o-------------------------------------------------E-----------------------------------XXXX--X------E-E--E---------[]----------------------------------XXX--XX-------------------------------------------------[]----------------------------------------------------------------------SS---------E------------XX-XXX---------------E---------X------------XXXX-XXX-------EXX----------------XX---X----------------------------------------<>----E----------------------------------------<>---------------------------------------<>------------------------<>----------------XX----[]------------E-E-----------------------------------------XXX??--------------------------------------[]--E------------[]---------------------------<>-------[]------------------------------X---
XXX---SS--------<>-----------[]----------------[]------X-----------------------X------<>--<>----------XXXX----XX----[]-------[]----[]------[]------------oo----------------------------<>------[]----------------XXXXX-XXX----------------[]-----<><>----------------------------------------------------------E---X---------------------[]-<>-------------------------XXXXX----------<>--------------------------XXX--XXXXX-------X----<>------------------------------[]----------------SS---------XXXX--XXX-------------------XXXXX-XXX-------XXX---------------------------------------E------------------SSSS---------------------X---------------X---------XXX---------EXXXXXXX--X------E-------XXXXXX--XXX-------EE--------------------------------------XXXX-XXXXXXXX------------------------------------------------------------------------<>-----------------XXXXXX------------------------[]---------------------------------XXXX--XXX---------X--------------------------------------[]-------------------------------------------X-------------------------SSS--------<>------------XX-XXX-------------------------X-----------XXXXX-XXX------XXXX---------------XXX-XXX----------------------------------------[]---------------------------------------------[]---------------------------------------[]------------------------[]-----------------X----[]-----------<><>------------------------------------------------------------------------------------[]-<>------------[]---------------------------[]-------[]----------------------------X-X-X-
XXX-------------[]-----------[]---------E-E----[]------X-------E----------EEE--X------[]--[]-------X----------------[]---X--E[]----[]------[]------------------------------------------[]------[]----------XXXXX-X----XXXX--E------EE-E---[]-----[][]-E-E-----------XXXX------------------------------------------XX---E-------E---E-----[]-[]------------------------XXXXXX---E--E---[]----------E-E------------XXXX--XX-XX------XX----[]-----------------------EE-E---[]-E--E---------------------XXXXX--XXX------E-----E-----XXXXXX-XXX------XXXXE------------------E-----------------ooo--------------------------------------E----X---E-----E-E-E-X-------XXXXXE-------XXXXXXXXX--XSS------E----XXXXXXX--XXXX---------X---------------E--------E--E-------XXXX---XXXXXXX------X-------------------------------E-------E-E-----------------EE-E--[]--------E--E-----XXXXXX------------------------[]------------------E-E-----------XXXXX--XXX--------XX-------------------E-EE---XX---EE-E---[]---------EE-E------------------------EE-E-XX---E-------EE-E--E-------E--EE------[]-E---E-E----XX--XX--------EE----EE---------X----------XXXXXX-XXX-----XXXXX--ooo---------XX-X-XXX-------EE-------E-----------E-----------[]-------------E-----------E-EE------EE-E------[]-------------------E--------E---EE-E---[]-------E-EE----X-E-EE---[]-E-E-------EE---XXE-E-[]-----------[][]-------------------------------------------------------EE---------------E-E---E-EE--[]-[]---E-E--E---[]-E-------EE-E-E-----EE-E---[]-------[]-----------E-E--E-E--E--E-E---X-X-
XS-------XXXXXXXXXXX---XXXXXXXXXXXXXXXXXXXXXXXXXXXXXXXXX---XXXXXXXXX---XXXXXXXXXXXXXXXXXXXXXXX--XXXX------E-----XXXXXXXXXXXXXXXXXXXXXXXXXXXXXXXXXXXXXXX----------------------XXXXXXXXXXXXXXXXXXXXXXX-XXXX-----X-X-XXXXXXXXXXXXXXXXXXXXXXXXXXXXXXXXXXXXXXXXXXXXXXXXXX-------------XXXXXXXXXXXXXXXXXXXXXXXXXXXXXXXXXXXXXXXXXXXXXXXXXXXXXXXXXXXXXXXXXXXXXXXXXX----XXXXXXXXXXXXXXXXXXXXXXXXXXXXXXXXXXXXXXXXXXXX-XXXXXXXXXXXXX-XXXXXXXXXX--XXXXXXXX------------------XXXXXXXXXXXXXXXXXXXXXXXXXXXXXXXXXXXXXXXXX--XXXXXXXXXXXXXXXXXXXXXXXXXXXXXXXXXXXXXXXXXXXXXXXXXXXXXX-XXXXXXXXXXXXX--------XXXXX----------XXXXXXXXXXXXXXXXXXXXXXXXXXXXXXXXXXXXXXXXXXXXXXXXXXXXXXXXXXXXXXXXXXXXXXXXXXXXX----X-XX-XXXXXXXXXXXXXSXX--X-XXXXXXXXXXXXXXXXXXXXXXXXXXXXXXXXXXXXXXXXXXXXXXXXXXXXXXXXXXXXXXXXXXXXXXXXXXXXXXXXXXXXXXXXXXXX----XXXXXXXXXXXXXXXXXXXXXXXXXXXXXXXXXXXXXXXXXXXXXXXXXXXXXXXXXXXXXX-----XXXXXXXXXXXXXXXXXXXXXXXXXXXXXXXXXXXXXXXXXXXXXXXXXXXXXXXXX-E-XXXXXXXXXXXXXXXXXXXXXXXXXXX--XXXXXXXXXXXXXXXXXXXXXXXXXXXXXXXXXXXXXXXXXXXXXXXXXXXX-----XXXXXXXXXXXXXXXXXXXXXXXXXXXXXXXXXXXXXXXXXXXXXXXXXXXXXXXXXXXXXXXXXXXXXXXXXXXXXXXXXXXXXXXXXXXXXXXXXXXXXXXXXXXX--XXXXXXXXXXXXX-XXXX------XXXXXXXXXXXXXXXXXXXXXXXXXXXXXXXXXXXXXXXXXXXXXXXXXXXXXXXXXXXXXXXXXXXXXXXXX-XXXXXXXXXXXXXXXXXXXXXXXXXXXXXXXXXXXXXXXXXXXXXXXXXXXXXXXXXXXXXXXXXXXXXXXXXXXXXXXXXXXXXXXXXXXXXXXXXXXXXXXXXXXXXXXXXXXXXXXXXXXXXXXXXXXXXXXXX--XXXXXXXXXX----XXXXXXXXXXX---XXXXX-----XXXX--XXXXXXXXXXXXXXXXXXXXXXXXXXXXXXXXXXXXXXXXXXXXXXXXXXXXXXXXXXXXXXXXXXXXXXXXXXXXXXXXXXXXXXXXXXXXXXXXXXXXXXXXXXXXXXXXXXXXXXXXXXXX