------------------------------------------------------------------------------------------------------------------------------------------------------------------------------------------------------------------------------------------------------------------------------------------------------------------------------------------------------------------------------------------------------------------------------------------------------------------------------------------------------------------------------------------------------------------------------------------------------------------------------------------------------------------------------------------------------------------------------------------------------------------------------------------------------------------------------------------------------------------------------------------------------------------------------------------------------------------------------------------------------------------------------------------------------------------------------------------------------------------------------------------------------------------------------------------------------------------------------------------------------------------------------------------------------------------------------------------------------------------------------------------------------------------------------------------------------------------------------------------------------------------------------------------------------------------------
-----------------------------------------------------------------------------------------------------------------------------------------------------------------------------------------------------------------------------------------------------------------------------------------------------------------------------------------------------------------------------------------------------------------------------------------------------------------------------------------------------------------------------------------------------------------------------------------------------------------------------------------------------------------------------------------------------------------------------------------------------------S------------------------------------------------------------------------------------------------------------------------------------------------------------------------------------------------------------------------------------------------------------------------------------------------------------------------------------------------------------------------------------------------------------------------------------------------------------------------------------------------------------------------------------------------------------------------------------------------------------------------------------------------------------------------------------------------------------------------------------------------------------------------------------------------------------
------------------------------------------------------------------------------------------------------------------------------------------------------------------------SSSSSSSSSSSSSSSSSSSSSSSSSSS---------------------------------------------------------------------------------------------------------------------------------------------------------------------------------------------------------oo--------------------------------------------------------------------------------------------------------------------------------------------------------------------------------------------------------------------------SSSSSSSSSSSSSSSS-SSSSSSSSSSS--------------------------------------------------------SSSSSSSSSSSS-S-----------------S---------------------------------------------------------------------------------------------------------------------------------------------------------------------------------------------------------------oo----------------------------------------------------------------------------------------------------------------------------------------------------------------------------------------------------------------------------------------------ooo----------------------------------------------------------------------------------------------------------------------------------------------------------------------------------------------------------------------------------------------------------------------------------SSSSSSSSSSSSSS?SSSSSSSSSSSSS----------------------------
-------------------------------------------------------------------------------------------------------------------------------------------------------------------------------------------------------------------------------------------------------------------------------------------------------------------------------------------------------------------------------------------------------------X--E----------------------------------------------------------------------------------------------------------------------------------------------------------------------------------------------------------------------------------------------------------------------------------------------------------------------------------o------oS-------------------------------------------------------------------------------------------------------------------------------------------------------------------o--------------------------------------------XXX-------------------------------?--ooS------------------------------------------------------------------------------------------------------------------------------------------------o------------------------------------------------------XXXX-----------------------------------------------------------------------------------------------------------------------------------------------------------------------------------------------------------------------------------------------------------------------------------------------------------------------------------------
----------------------------oo-----------------------------------------------oooo---------------------------------------------------------------------------------------------------------------X-----------------------------------------------------------------------ooooooo-------------------------------------------------X--------------------------------oo--o---------------------------------------------XXX---------------------------XXX------------------------------o-----------------------------------------------------------------------------------------------------------------------------------------------------------------------------------------------------------------------------------------------------------------------SS--E---------------------------------------------------------------------------------------------------------------------------------------------------------------------------------------------------------------------------------------------------SS------------------------------------------------------------------------------------------------------------------------------------------------------------------------------------------------------------------------------------E-----------------------------------------------------------------------------------------------E---------------------------------------------------------------------------------------------------------------------------X-----------------------------------------------------------------------------------
----------------------------XX--------------oo----XXX-------XX-------E--E----XXXX---XX------------------------S-----------------X-SSSSSSSSSSSSSSS--------------------------XSQ------------------------S---S---------------------------------S-SSSSSSSS----SQ--------------------XX----------E-----SQQ-------------------------------------------------------X--------------------------SS------------SSS-S-------------------SSS---SS-Q--------------------------S----------------XXXX-------------------------XX-------ESSSS-------XXX------------------------S----------------X?SSS---?--SS-----------------------Q--SSSS------------------------oooo----------------------------------------------------------S---------S--SQQ----------------SSS-----S----SS-------------------S-----------SSS----------------SSS-------S--SSSS----S--------------------SSS-----------SSS---SQS-------oo-----------------------SSSSS----SSSS-------------------------------------X----------------------SSS------------SS---SSS----?------------SS---SSSS--S----------------------------?SSSS------SSS--------------S--------------------------------------------------------SSSS-------XXX--------S-----------------------?SSS------------------------------------SQS----SSSS-------------------S----?SSS-----------SSS------------------------------XXoo----X-----E--E------------------------SS---S-----S------------------------------------------------------S-----SSSS-----SSQS--------------SSSSS--------------------SE-----ooooooo----------------------------------------XX
--------oo---------------------o-------------------------------o-------XXXXX-------------------------XXX------------------------XX----------------------------------------------------------------------------------------------------------------------------------------------XX---------------------------------------------------oo-----------------------SSSSSS-----------------------------------------------------oo------------------------------oooo-----------------------------------------------XSSXX--------------------------------XXX------------------------------------------------------------------------------XX--------------------------------------------------------------------------------------------------------------------ES----SS----------------------------------------------------------------------------------------------------------XXX--------XX-----------XX-------------------------------------------------------------------------------------------------------SS---S---------------------------------------------------------------------------------------------------------------------------------------------------------------------------oooo----------------------------------------------------------------------------------------------------------------------------------------------------------XXXXXX------------------------------------------------------------------------------------------------------------------------------------------------SX---E------------------------------------------------X-
------------------------------XXX------------------------------X---XX----------------------------------------o----------------X-XX---------------------------------------------------------------------------------------------------------------------o------------------------XX-----------------------------------------------------------------------------XX----------------------------------------------------------------------o-------------------------------------------------------------------XXX-oX------------------------------oooo---------------------------------------------------------X-------------------------------------SSSS--------------------------------------------------------------------------E-----------------S-----SS----SS-------------------------------------------------------------------------------------------------------------------------------------------------------------------------------------------------------------------------------------------SS---S------------------------------------------------------------------------------XX------------------------------------------------------------------------------------------------------------------------------------------------------S----------------------------------------------------------------------------------------------------------XX---S---------------------------o------------------------------------------------------------------------------------------------------------S------SSSSSSS---------------------------------------XXS
----E--o----------------------------------------------------------------------------------------------------XXX-----------E---X-XX------------XXX-------------------------?----------E-----------------------------------------------------------------------------------------XXX------S------------------------E---SQ-Q----------E------------X---oo--------XXXSS--------------------E-----S-------------------------E-----SS------------------------E--------------o----------S----------X---oo----------XS--SQ--------XXX------------------------------------------------E----SS------------------------------------------------------------SoSSSS--------------------------------------------------------------------------------------------------SS----SS------------------------------------------E---------------------------------------------------------------------------------------------------E-----------------------------------------------E--------------------------------------------SS---Q----S-SQ----------E-----------X------------------S--------------------E-EE----X----------------------E-------E-----------------------S-SQ---------S-S-----------------------------------------------------------------------------X-------------------------E----------------------------------------S----ooo--------oo------------------------------SS-----E---------------------------o-o---------------------S--------E--S-----------------------------------------??-----------------------S------SSSSSS---------------------------------------XXX-
---<>-----------------------XX-----------XXX---XX----XX-XX-----XXX-------------------XX-------oooo-----------------------<>----XXX--------------S-----------<>------------??SS----------------------------SQS------E---------------------------XX--SSSS-------------XXX---------XX------S------QQ?SQQQ----------<>----------------<>-----------X---o--o-------XXXX--------------------<>--E-----E--S-----Q-Q-SS-------<>-----------S-SS---------------<>--------oo--o----------XX--------------o----------EXXX--X-----------------------XXX--SSS-------------------S--------<>------QQ---------XX-----------S--QQ--Q-Q--Q--Q---S---------------------------------------------------------------X----------------SS-----E-XX---SSS----------------------X-SSS--SS--S----ESSS--------SQ--QQQQ-QQ-Q---------<>----------------XX--X-----------X----------------SSS--------------XXX------XXX---S--------S----E--<>---------E------------------------------------<>-----------------------------SS----EXX--X---SS--ESSS---------------<>----------XXoo------------------------------S-------------XX---------------------<>-----E<>-------------------<>------------------E--------------------X-------------------------------------------S----------XX---S?S--QQ-Q------------<>-----QQQQ--------S-----------X-------------E-----------o--X-----XXXX--XXXX---------------SS---<>---E--S---------SSSS--------------XXX-----------------E----<>-----E--?----S----SS-----SSQS--------Q--Q------S-----XX--XX----------SSS----------------------EEE-----------------------XXXX-
E--[]-------------X----------------------------------------XXXX-----------o----XXXXX-------------E---XX------------------[]----XXX--------------------------[]---------------S-------SS---------------------------<>--------------------------------------E---------------------XX-SSS--------------------------[]----------------[]----------XX-------------XXXXX---------X----------[]-<>----<>---------------------[]---------X--------------------[]---------------------XXXX------------------------XXXXX-------------------------------------X------------------S-----[]------------------------------S--------------------------------------------------------------------E------------------------------E-----<>-XXX---------------------------X--------------<>---------------------------------[]---------------XXX--XX---------XX-------------------------E-----------------------------------<>--[]--------<>------S---------------------X-------[]----------------------------------XXXX--XX-----EE------------------[]---------XXXX-----------XXXXX-----------------------------XX---------------------[]----<>[]--E-------------E--[]-------------------------XX-----------XX----------------------------------------------E------XXX------------------------[]----------------------------XX------------<>--------------------------------------------------[]--<>-------------------------------------------------<>----[]----<>---------------E--------------------S---------XXX--XX-----------------E--------------XXXXXX----------------?-----XXXXX-
---[]-------------X------------------------------------oXXXXX------------------XXX------XXXXXXXXXXX----------------------[]----XXX---------X----------------[]---------------S-------SS---------------------------[]-------------------------------------<>-------------XXX-----XX------------------------------[]----------------[]---------XXX------------XXXXXX------oooX----------[]-[]----[]---------------------[]---------X--------------------[]--------------------XXXXX-----------------------XXXXXX------------------------------------XX------------------------[]-----------------------------XS-------------------------------------------------------------------<>----------X-------------------------[]-XXX---------------------------X--------------[]---------------------------------[]--------------XXXX--XXX-------XXX------------------------<>-----------------------------------[]--[]--------[]----------------------------X-------[]---------------------------------XXXXX--XXX------------------------[]--------XXXXX---------------------------------------------XXX--------------------[]----[][]-<>------------<>--[]------------------------XXX----------XXX---------------------------------------------<>-----XXXX------------------------[]----------------------------XX------------[]--------------------------------------------------[]--[]-------------------------------------------------[]----[]----[]---------------------------------------------XXXX--XXX---------------<>-----------------------------------------EXXXXX-
---[]---------E---X------------------------------------------------------------------------------------------------------[]----XXX--------XX----------------[]--------E-----------------------EE-E---EE-----------[]------------------------E-E----------[]---XXXXX-------------SX-E---------E--E-------E-------[]-----E-------E--[]--------XXXX-----------XXXXXX--SS?SS--XX----E-----[]-[]----[]-E---E-E----------E--[]---------X--------------------[]-------------------XXXX------S-----------------XXXXXXX--S--X---X-------------------------XXX----E-E--------E------E-[]------------------X----E-EE--XS----------------------E--------------------------------------------[]----------X-------EEE-----E--E------[]-XXX-E---------E---------------XE-E--------E--[]-E---------X----E----------------[]-------------XXXXX--XXXX-----XXXX----E-E--E---E-E--------[]-------------------------EE-----E--[]--[]oo------[]----------------------------X-------[]-----------E---------------EE---XXXXXX--XXXX----------E-EE------E--[]-------XXXXXX---------------------------------------------XXX-----XX---------E---[]----[][]-[]------------[]--[]-----------------------XXXX----SS---XXXX-------------------------------EE-E-EE-E---E-[]----XXXXX-E--------------------E-[]-----EE----------------EE---XX---------E--[]-------------------------------------------EE-E---[]--[]-------------------------------------------------[]-E--[]----[]------X------------------E-EE---------------XXXXX--XXX----E----------[]----------------------------------------XXXXXXX-
XX-XXXXXXXXXXXXXXXXXXXXXXXXX------------------------------------------------------------------------------------XXXXXXXXXXXXXXXXXXXXXXXXXXXX-----XXXXXXXXXXXXXXX--XXXXXXXXXXXXXXXXXX----XXXXXXXXXXXXXXXXXXXXXXXXXXXXXXXXXXXXXXXXXXXXXXXXXXXXXXXXXXXXXXXXXXXX--------------X----XXX--XXX-XXXXXXXXXXXXXXXXXXXXXXXXXXXXXXXXXXXXXXXXXXXXXXXXXXXXXXXXXXXX----XXXXXXXXX--SQ-ESSXXXXXXXXXXXXXXXXXXXXXXXXXXXXXXXXXXXXXXXXXXXXXXXX-XXXXXXXXXXXXXXXXXXXXXXXXXX--XX--XXXXXXXXXXXXXXXXXXX--------XX-XXXX-XXXXXXXXXXXXXXXX--SS--XXXXXXX---XXXXX-----------XXXXXXXXXXXXXXXXXXXXXXXXXXXXXXXXXXXXXXXXXXXXXXXXX---XXXXXXXXXXX----XXXXXXXXX-Q-XXXXXXXXXXX-XX-X--XXXXXXXXXXXXXXXXXX---X----XXXXXXXXXXXXXXXXXXXX----XXXXXXXXXXXXXXXXXXXXXXXXXXXXXXXXXXXXXXXXXXXXXXXXXXXXX--XXXXXXXXXXXXXXXXXXXXXXXXXXXXXXXXXXXXXXXXXXXXXXXXXXXXXXXXX--XXXXXXXXXXX--XXXXXXXXXXXXXXXXXXXXXXXXXXXXXXXXXXXXXXXXXXXX-----XXXXXX-----XXXXXXXXXXXXXXXXXXXXXXXXXXXXXXXXXXXXX-XXXXX--X-X-XXXXXXX-XX--X---XXXXXXXXXXXXXXXXXXXXXXXXXXXXXXXXXXXXXXXXX--XXXXXXXXXXXX-XXXXXXXXXXXXXXXXXXXXXXXXXXXXXXXXXXXXXXX-------XXXXX-XXXXXXXXXXXXXXXX---X--XXXXXXXXXXXXXXXXXXXXXXXXXXXXXXXXXXXXXXXXXXXXXXXXXXXXXXXXXXXXXXXXXXXXXXXXXXXXXXXX-------XXXXXXXXXXXXXXXXXXXXXXXXXX-XXXXXXXXXXXXXXXXXXXXXXXXXXXXXXXXXXXXXXXXXXXXXXXXXX--XXXXXXXXXXXXXXXXXXXXXXXXXXXXXXXXXXXXXXXX-----XXXXXXXXXXXXXX-XXXXXXXX-----------------------X----XXXXXXXXXXX-XXXXXXXXXXXXXXXXXXXXXXXXXX-XXXXX----XXX----XXXXXXXXXXXXXXXXXXXXXXXXXXXXXXXXXXXXXXXXXXXXXXXXXXXXXXXXXXXXXXXXXXXXXXXXXXXXXXXXXXXXXXXXXXXXXXXXXXXXXX-XXXX------XXXXXXXXXXX-----XXXXXXXXXXXX