------------------------------------------------------------------------------------------------------------------------------------------------------------------------------------------------------------------------------------------------------------------------------------------------------------------------------------------------------------------------------------------------------------------------------------------------------------------------------------------------------------------------------------------------------------------------------------------------------------------------------------------------------------------------------------------------------------------------------------------------------------------------------------------------------------------------------------------------------------------------------------------------------------------------------------------------------------------------------------------------------------------------------------------------------------------------------------------------------------------------------------------------------------------------------------------------------------------------------------------------------------------------------------------------------------------------------------------------------------------------------------------------------------------------------------------------------------------------------------------------------------------------------------------------------------------------
------------------------------------------------------------------------------------------------------------------------------------------------------------------------------------------------------------------------------------------------------------------------------------------------------------------------------------------------------------------------------------------------------------------------------------------------------------------------------------------------------------------------------------------------------------------------------------------------------------------------------------------------------------------------------------------------------------------------------------------------------------------------------------------------------------------------------------------------------------------------------------------------------------------------------------------------------------------------------------------------------------------------------------------------------------------------------------------------------------------------------------------------------------------------------------------------------------------------------------------------------------------------------------------------------------------------------------------------------------------------------------------------------------------------------------------------------------------------------------------------------------------------------------------------------------------------
---ooo------------------------------------------------------------------------------S----S---------------------------------------------------------------------------------------------------------------o--------------------------------------------------------------------------------------------------------------------------------------o--------------------------------------------------------------------------------------------------------------------------------------------------------------------------ooo------------------------------------------------------------------------------------------------------------------------------------------------------------------------------------------------------------------------------------------------------SSSSSSSSSSSSSSSSSSSSSSSSSSSS---ooo-----------------------------------------------------SS-------------------------------------------------------------------------------------------------------------------------------------------------------------------------------------------------SSSSSS-----------------------------------------------------------------------------------------------------------------------------------------------------------------------------------------------------------------------------------------oo-------------------------------------SSSSSSSSSSSSSSSSSSSSSSSSSSSS----------------------------------------E-------------------------------------------------------------------------------------------------------------------------------
---XXXX---------------------------------------------------------------------------------------------------------------------------------------------------------------------------oo-------------------------E--E----------------------------------------------------------------------------------------------------------------------------------------------------------------------------------------------------------------------------------------------------------------------------------------------------------XXXX-----------------------------------------------------------------------------------------------------------------------------------------------------------------------------------------------------------------------------------------------------SSSSSSSSSSS--SSSSSSSS-SSSSSS---XXXX----------------------------------------------------Q----oE------------------------------------------------------------------------------------------------------------------------------------------------------------------------------------------------------------------------------------------------------------------------------------------------------------------------------------------------------------------------------------------------------------------------------------------XXXX----E---------------------------------SS----------------------oS---------------------------------------------S?--------S----------------------------------------------------------------------------------------------------------------
----------------------------XXX-----------------------------oooo-------------Eooo---------------------------------------------------------------------------------------------------------------------------XXXXXXX-----------------------------------------------------------------------------------------------------------------------------o----------oooooo--ooo------------------------------------------------------------------E-------------------------------------------------------------------------------------------------------------------------------------------------------------------------------------------------------------------------------------------------------------------------------------------------------------------------------------------SSSSSSSSSSS--SSSSSSSS--SSSSS----------------------------------------------------------------XXXX------------------E---------------------------------oo--oo-----------------------------------------------------E-----------------------------------------------------------------------------------------------------------------------------------------------------------E------------------------------------------------------------------------------------------------------------------------------------------------------------------------------------------------------SS--E----------------------------------------------------------------------------S----------------------------------------------------------------------------------------------------------------
-----------------------------------------E------------------XXXX-------XXX---XXXXX--------------E--S-------------QS---------SSSSSSSS------------------------------------X------E----------------------------------------------------------SSSS--SSSSSS---------?-----------------------------------------S---SSSSS---------------------------SQQXX------------------------------------------SSS---------SSSSS--------------------------SSSSS----SSQQ---------------?------------XX----------S---SSSSSS---------------------?-------------------------------------------------------------------------------S------S--------------------SSSSS?SSS---SS--------------------------SSS-----------S-----SSS---?SSS----------------------------------------------------------SSSSSSSS--SSSSS-SSSSSSSS-SS-SSSS-----SSSS---------------------------X--------------------------X---------------------------XX--E--E-----QQQQQ------------------------------------------------------------------------------SQS---SS------------------XXX--------------------------?SSSS----------------------------------Q-Q-Q-----------------------------------------------SSSSSS----SS----------------XX--------------------SQS--SSS---------------------SSSSSSSSSS----------------------XXX-----------------------------------------S----XXX----S-----------------------------------------S----SS-------------SS-S-SS------------------------------------------------SS------------------------------SSoo------------------------------------------------------------------------------------
----------------------------------------<>-----------------------------------------------------<>----------------------------------------------------------------------------XXXX------XX-----------------------------o----------------------------------------------------------------------------------------------------------------------X--------------------------------------------------------------------------------------------------------------------------------XXXX-------------------------------------------------------oooo-------ooooo--------------------------------------------------------------------------------------------------------XXX------------------------ES-----------------------------------------------------------------------------------------------------------------S--E----------------------XXX----XXXX-----o---o-------------E---------o---o---o-------?--XXXXX------------------------------------oo-----------------------------------------------------------------------------------X-----------------------------------------------------------------------------------S-----------------------------------------------------XS--------------------------------------------------------------------------------XXXX-----------------------------------------------------------------------------------------------S----SS-------------SS---S-------------------------------------------------SS------------------------------------------------o---------------------------------------------------------------------
----------------------------------------[]--o--------------------------------------------------[]---------------------------------------------------------------------------------------------------XXXXXXX------------------------------------------------------------------------------------------------------------------------------------------------------------XXX-X-----------------------------------------------------------S--------------------------------------XXXX--------------E-------------------------------------------------------------------------------------------------------XXSS--------------------------------E-----------------------------------------------o<-Q-----------------------------------------------E-----------------------------------------------------S----S-SS-S-----------------------XXXXX------------XXX-XXX-XXX-----XXXXXXX-----XXX-XXX-XXX-----XXX---o--------------------------------------------------------------------------------------------------------------------------XX----------------------------------------------------------------------------------X-----------------------------------------------------XXX-------------------------------------------------------------------------------EXXXX------------------------E----------------------------------X-----------------------------------S----SS----------S-SSS-S-S-------------------------------------------------SS----------------------------S-SS-S---o-----XXX------------------------------------------------------------------------
---------------------------------E------[]------oo------E---------------------------SS------E--[]-------E---------------------------------------------------------X--oo----------------------------------------------------E------------------------------------oo-------------------------------------------------X-ooo------------------------------X-------------------------------------------------------------------------------------------------------------E--------XXXXX-------------?---------------------------S-----------E-----S----------------------------X-ooo-------------------------XX---------------o-------------X---?------------------------------------------------[]------------------------------SS-------E--S--E--<>-----------------------------------------------------SES--SoS?-S-S--------------------XXXXXX-------------------------------------o------------------XX--------------------------SS------------------S----------------------------------X---E------------------E-----------------E----XX-----------------------------------E--ooo------ooo-------------------------------XSS----------oo--------------------------------------XXXXX-------------------------------------X--------------------------EX-----------XXXXXXX--------------------E--<>-------------E-------------------------------------E--o--------------------SS---------oS?S---SoS--------------------------------oooo------ooo----SS--Qoo-----------------------SoS--------------------------------------------------------------------oo--------------XS-
-------------------------E-------------SXXS------------------------------------------------<>--[]------<>-------?QQQQ--QQQ--Q--QS-----------------XXX------------XX-------------XXXXX-----------------------?S------------<>-----?-QQ-QQ-Q-QQ--Q------------oooo--o------------------------------E----------------XX----------E-XX--XX---SSS----X-------XXXXXXXX---------------------------------------X------------E------X--------X--S?S-----SESQS------------o--<>-----E-XXXXXX----------------S--SSS------------E----Q------------<>----------------------------------X---------------------S-----<XXXX-------SS------------------XXSSS??SSSSS-S-S-----------------------------S--------[]-S---QQQ--QQQQ-------------------E----<>----<>--[]-----------------------------------X------S-S----S---SXX--SSSS-----------------------XXXXXXX-----------<>-------------------------------------------XXX--------S?SS-------------------XXXXXX------------------------------------------XX--<>---QQQQQQ--------<>----------------------XX------------QQQ---QQQ--------E----<>-----------------------Q-----o--------------XXX--------------------------S----------Q------------XXXXX------------------QQQ-QQ--QQ---------XX-----------E--S-Q--S-----<>Xoooo------XXXXXXXX--------------E----<>--[]-----------S-X---XXXX--SSS----XXXXXX--------------<>-------E-----------SSSSSSS--------SS-----SSS?S--E---------------------------SSSS-----------------S?SS--S---------------XX--SSS----S-------------------XXXX-----E-------------------------------------------------XXX-
------------------------<>-------------------E----------X------------------------o-E-------[]--[]------[]--<>-----------------------------XX--------------------XXX---------------------------------X---------------------[]-XXX-------------------------------------------XX-----o-o-----------<>---------------XXX----E------XXX--XX-----------------------------------------E----------------------XX------------E--E---X--------S------------------------------[]----<>-XXXXXX------------------E--------------<>-----------------[]---------X-------XXX-?-----E------------------------E---------[]-XXX------------------------EXXXSS---SSSS----SS----------------------------------XX-[]-S------------------------------<>----[]----[]--[]----------------------------------XX--E-----SS-----E---X----------------------------XXXX-XXXXX---------[]-------------E-----------------------------XX-----------------------------------------E------------------------------E------XXX--[]-----------------[]----------------------XX----------------------------<>----[]-------------------------------------------XXXX--XX---------------------------------------------XXXXXX---------XX-----------------------EXXXX----------<>-------------[]X---------XXXXXXXXX-------------<>----[]-----------E---E---X-------------XXXXXXX--------------[]------<>------------------XX-------------E-----<>---E---------------------------------------------------------------E---X-------------------------------------<>------------------------------------------------XXXX-
------------------------[]--XXXX-SSS--------<>----------X-------------XX--------XXXXX------[]--[]------[]--[]---------------------------XXXX-------------------XXXX---------------------------------X---------------------[]--XX-----------------------------------------XXXX---------XX--------[]--------------XXXX---<>----XXXXX--XXX--------X----o------------------------------------------------XXX-------------------XX-------S------------------------------[]----[]XXXXXXX---------X---------------<>------[]-----------------[]---------X----------------<>-----------------------<>-------XX[]-XXX----------------------E-XXXXSS---SSSS----SS---------------------------------XXX-[]-S------------------------------[]----[]----[]--[]---------------------------------XXX-<>-----S--------------------------------------XXXXX-XXXXX---------[]------------<>-----------------------------XXX---------------------------------------<>--------------------------<>-<>-----XXXX--[]-----------------[]------------------E---XX----------------------------[]----[]------------------------------------------XXXXX---X--------------------------------------------XXXXXXX--------XXX----------------------XXXXXX----------[]-------------[]X--------XXXXXXXXXX-------------[]----[]--------------------------------XXXXXXXXX-------------[]------[]-----------------XX--------------------[]--<>-------------------------------------------------------------------X-------------------------------------[]-----------------------------------------------XXXXX-
------E-EE----E---------[]------------------[]----------X----------------------------------[]--[]------[]--[]---------EE----------------XXXX---------------E--XXXXX---------------------------------X-----E--------EE-E---[]--XX---------------E-----------X-------------XXXX--SSSSS-----E-EE---[]-E--E--E-----XXXXX---[]---XXXXXXE-XXX--------X--XXXX-------------------------------E-EE-----------XXXX-------------------XXX------S-----------------------E-EE---[]----[]XXXXXXX--------XX-----------o---[]------[]----E-E-------E--[]---------X----------------[]-----XX----------EE-E--[]--EE--XXX[]-XXX---E-------E-E---------XXXXX---ooSSSSSSo-SS----------------E----EE-E--EE-EE-X-X-[]-S----------------------E-E-E---XX----[]-E--[]--[]-----------EE-E----E---------E--XXXX-[]---------------------EE-EE-----E-EE-E---E--XXXXXX--XXXX---------[]--E---------[]-----------------E-E---------XXX----EE-E-E---EE-E----------------------[]---------------EE-E-EE-E--[]-[]----XXXXX--[]---EE-E---E-E----[]----------------------XX----------------E-----------[]----[]-------------------------------------E---XXXXXX---------X---------EE-E--E---------------------XXXXXXXXS------XXXX-----E--E------------XXXXXXX----E-E---[]-------------[]XE-E----XXXXXXXXXXX--------XXE--[]-E--[]---------------X---o-----------XXXXXX-XXXX---E--E-----[]------[]---------E-E-----X---------------------[]--[]-----------------------E-EE--------------EE------------------E----XX----EE-------------------------------[]-----------E-----------------------------E-E--XXXXXX-
XXXXXXXXXXXXXXXXXXXXXXXXXXXX--------XX---XXXXXXX---XXXX-XXXXX-----XX----------------XX-XXXXXXXXXXXXXXXXXXXXXXXXX--XXXXXXXXXX---XXXXXXXXXX-X--XXXXX---XX-XXXXXXXXXXXXXXXX------XXX---XXXX---------------XXXXXXXXXXXXXXXXXXXXXXXXXX-XXXXXXXXXXXXXXXXXXXXXXXXXXXXXXXXXXXXXXXXXXX--X----SS--XXXXXXXXXXXXXXXXXXXXXXXXXXXXXXXXXXXXXXXXXXXXXXXXXXXXXXXX----------------------------X---XXXXXXXXXXXXX-XXXXXXXXXXXXXXXXXXXXXXX-XE-XXXXXXXXXXXX-XXXXXXXXXXXXXXXXXXXXXXXXXXXXXXXXXXXXXXXXXXXXXXXXXXXXXXXXXXXXXXXXXXXXXXXXXXXXXXXXXXXXXXXXXXXXXXXXXXXXXXXXXXXX-XXXXX-----XXXXXXXXXXXXXXX----XXXXXXXXXXXXXXXXXXXXXXXXXXXXXXXXXXXXXXXXXXXXXXXXXXXXXXXXXXXXXXXXXXXXXX-------XXXXXXXXXXXXXXXXXXXXXXXXXXXXXXXXXXXXXXXXXXXXXXX----XXXXXXXXXXXXXXXXXXXXXXXXXXXXXXXXXXXXXXXXXXXXXXXXXXXXXXXXXXXXXXXXXXXXXXXXX-XXX---XXXXXXXXXXXXXXXXXXXXXXXXXXXXXXXXXXXXXXXX-XXXXX--XXXXXXXXXXXXXXXXXXXXXXXXXXXXX-XX---XXXXXXXXXXX----XXXXXXXXXXXXXXXXXXXXXXXXXXXXXX-XXXXXX-----XXXXXXXXXX--XXXXXXXXXXXXXXXXXXXXXXXXXXXXXXXXXXXXXXXXXXXXXXXXXXXXXXXXXXXXX----XX-XXXXXXXXXXXXXXXXXXXXXXXXXXXXXXXX----XXXXXXXXXXXXXXX--XXXXXXX-XXX-XXXXXXXXXXXXXXXXXXXXXXXXXXXXXXX-XXXXXXXXXXXXXXXXXXXXXXXXXXXXXXXXXXXXXXXXXXXXXXXXXXXXSX--XXXXXXXXXXXXXXXXXXXXXXXXXXXXXXXXXXXXXXXXXXXXXXXXXXXXXXXXXXXXXXXXXXXXXXXXXXXXXXXXXXXXXXXXXXXXXXXXXXXXXXXXXXXXXXXXXXXXXXX-XXXX-----XXXXXXXXX-XXXXXXXXXXXXXXXXXXXXXXXXXXXXXXX--XXXXXXXXXXXXXX----XXXXXXXXXXXXXXXXXXXXXXXXXXXXXXXXXXXXXX---XXXXXXXXXXXXXXXXXXXXXXXXXXXXXXXXXXXXXXXXXXXXXXXXXXXXXXXX--------------XX---------XXXXXXXXXXXXXXXXXXXXXXXXXXXXXXXXXXXXXXX----XXXXXXXXXXXXXX--