----------------------------------------------------------X-------------------------------------------------------------------------------------------------------------------------------------------------------------------------------------------------------------------------------------------------------------------------------------------------------------------------------------------------------------------------------------------------------------------------------------------------------------------------------------------------------------------------------------------------------------------------------------------------------------------------------------------------------------------------------------------------------------------------------------------------------------------------------------------------------------------------------------------------------------------------------------------------------------------------------------------------------------------------------------------------------------------------------------------------------------------------------------------------------------------------------------------------------------------------------------------------------------------------------------------------------------------------------------------------------------------------------------------------------------------------------------------------------------------------------------------------------------------------------------------------------------
-----------------------------------------------------------------------------------------------------------------------------------------------------------------------------------------------------------------------------------------------------------------------------------------------------------------------------------------------------------------------------------------------------------------------------------------------------------------------------------------------------------------------------------------------------------------------------------------------------------------------------------------------------------------------------------------------------------------------------------------------------------------------------------------------------------------------------------------------------------------------------------------------------------------------------------------------------------------------------------------------------------------------------------------------------------------------------------------------------------------------------------------------------------------------------------------------------------------------------------------------------------------------------------------------------------------------------------------------------------SXX?---------------------------------------------------------------------------------------------------------------------------------------------------------------------------------------------------------
--SSSSSSSSSSSSSSSSSSSSSSSSSS----------------------------SSSS--------------------------------------------------------------------------------------------------------------------------------------------------------------------------------------------------------------------------------------------------------------------------------------------------------------------------------------------SSSSSSSSSSSSESSSSSS-SS-SSS-S--------------------------------------------------------SSSSSSSSSSSSSSSSSSSSSSSSSSSS----------------------------SSSSSSSSSSSSSSSSSSSSSSSSSSSS---S-----------------------S----------------------------SSSSSSSSSSSSSSSSSSSSSSSSSSSS-SSSSSSSSSSSSSSSSSSSSSSSSSSS----------------------------------------------------------------------------------------------------------------------------------------------------------------------------------------------------------------------------------------------------------------------------------------------------------------------------------------------------------------------------------------------------------------------------------------------------------------SSSSSSSSSSSSSSS-----SSSSSSSS----------------------------SSSSSSSSSS-----SSSSSSSSSSSSS------------------------------------------------------------------------------------SSSSSSSSSSSSSSSSSSSSXX-S-SSS-----------------------------------------------------SSS--------------------------------------------------------------------------------------------------------------------------------------------
--------------------------------------------------------oSSS---------------------------------------------------------------------------------------------------------------------------------------------------------------------------------------------------------------------------------------------------------------------------------------o------------------------------------------------------SSSS-----?oS--SS?-SS?---oS------------------------------------------------------------SS-----------SS--SSSSS-------------------------------SSSSSSSSSSSSSSSSSSSSSSSSSSS--SSS----------------------S----------------------------------------------------------SSSS------SSSSSSSSS--SSSSS-----------------------------------------------------------------------------------------------------------------------------------------------------------------------------------------------------------------------------------------------------------------------------------------------------------------------------------------------------------------------------------------------------------------------------------------------------------------------------------------------------------------------------------------SSSSSSSSSSS----------------------------------------------------------------------------------------------------SSSSS?-SSSS-------------------------------------------------------SS------o-------------------------------------------------------------------------------------------------------------------------------------
----------------------------------------------------Eooo-SS-------------------------ooo------------------------------------------------------------------------------------------------------------------------------------------ooo-----------------------------------------------------------------------------E------------------------------------------------------------------oo--oo----------------SSSS--E---SS--SS--SS----SS-------------------------------------E----------------------SS--E--------SS--SSSSS-------------E----------------ESSSSSSSSSSSSSSSSSSSSSSSSSSS--SSS--E------------------ES--------------------------------------------------------X-SSSS--E---SSSSSSSSS--SSSSS------------------------------------------------------------------------------------------------------------------------------------------------------------------------------------------------------------------------------------------------------------------------------------------------------------------------------------------------------------------------------------------------------------------------------------E----E----------------------------------------X-----------------oo--oo-------------------------------SSSSSSSSSSS---------------------------------------E---------------E--------------------------------------------SSSSS--SSSS-------------------------------------------------------SS-----------------------------------------oo--oo--oo-----------------------------------------------------------------------------------------
-------------------------------------------XXX------XXXX----------------------------XXXX------E----ooo----XoX-------SSSS---SSSSSS--SS-------SSSS-------------------------------------------------------oo---XXXX----------------XXXXX-----------------------------------------------SSSS------------------------SSSS-----------SSS--SSS----------SSS--------SS--SSSSSSS-----oo-----------------------------S----S-----------SS--SSS------------------S------SSSS-------QQE--E-------XXX--------SS------------SS--SSSSS------------SQS--SQS---------SSS-SSSSSSSSSSSSSSSSSSSSSSSSS--S---SS??--------------SSS----------------------------------------oooo----------------S----S---S-------SS--SSSS------------------------------S---SQQ--------------E-----------------------?SSS-----------------------S?SSS---------------------------------------S----SSS----------------------------------------------SQS----SSS---------SSS------------------SSS---------------SS---------S---------S---------SSSS---------Q-Q--------------------------XXS--------------------------SSS-----------------------------S----SSSSS-SQS--------------SS--SQS---?------------SSS---------------oo-------------o--S---------------------------QQ--------S-SSSSSSSSSSSSS-----------Q-Q----------------SSS-----SQS--SQS-------SSS------Q-Q---------------------------------o----SS---SSS------SSSSSS--E---------------------------------S----SSS----SS---SSS-------------------------------------------------------------------------o-----------XXX----o-------o-----------S----SSS----SS---
------------------------------------E--------------------------------------------------------XX--------------------------------------------------------------------------------------------------------------------------------------------------------------------------------------------------------------------E---------------------------------------------------------------------------------------S----S-----------SS----S-----------------------------------------XXXX---------------S----------------------------------------------------------------------------------S---SS----------------SSS------------------------------------------------------------S---SSS-----------S--------------------------------------------------------<>-------------------------------------------------------------------------------------------------------------------------------------------------------------------------------------------------------E------S----------------------------------------------------o---------E--o------XX---------------------------------------------------------------------------------------------------------------------------------------------------------------XSSS-------------------------------------------------------------------------------------------------------------------------------------------SS---SS--------------<>--------------------------------------SS----------------------------------------------------------------------------------------------------SSSS--------XX----------------------------
------------E----------------------<>-------------------------------------------------------------------------------------------------------------------------------------------E--------------------------------o-----------------------------------------------------------------------------------------------------------------------------------------------------------------------------------------S----S-----------SS--S-S----------------------------------------------------------S-S-------------------------------------------------------------SS-------------------S---SS--------------------------------E-----------E--------------SSSSS-------------S-S----S------------S----SS--------------------------------------------------[]------------------------------------------------------------------------------------------------------------------------------------------------------------------------------------------------------XX----------------------------------------------------------XXX-----XXXXXXXX-----XX------------------------------------------------------------XX--------------------------------------------------------o---------S-----------------------------XXX-------------S------------------S--------------------------------------------------------------------------oo---------------------------SSSS-SS---S----XX---------[]--------------------------------SoS---SS----------------------------------------------------------------------------------------------------------------o-----------------------------
-----------<>----------------------[]-------------------oo-----------------------------------XX-----XX------------------------------------------------------------------SSS--------------SS-SQ-------------------------------------------XXXXX----------------------------E--S------------S-----------E-------E--QSS---------------------------X----------------------------SQ-SSS-------------------------Sooo-S----oo-oo?-SS--QoS---------------E--------------------------------------------SoS----------------------------------------------------EE-----SS---?oooooooo-----?-ooooSS----------------<>-------------<>-------E--<>--------------SSSSS---------------So?oSS---?ooooooooS--ooSS--------------------------------------------------[]-------------------E------------------------------------------E-E---------------E----------------------------------X---------------------------------------EEEE-----------------------------------------------------------------------------------------------------------------------XXX-----------------E-------------SSSSQSS--------------------XSXX-------------------------E-------------------SSSSSSSS------------SSSSS-----------XX--oo-------XXXXX--------------E------------oooo----E-----------------------------------------------------------------------------------o--------------SoS--SoSS---S----XX---------[]----------E---------------------SSS---SS-------------------XX---------Q---------------------oo---------E--------------S-------XX------------------------------------------------------
---XX------[]----------------------XXX---------------XXX?SSS------------------------XXXXXX--------------X----XX----QQQQ----XX--XX-------------S?S--QQ-------------------------S?S------XXX---------------XXX--SSS-------XX-------------------------XXXXXXX------------E--<>-----E--S-----------------<>------<>--------------------S----------XX--QQ-----------------------X---------XXX-------------------SSS-SS-----------SS--SSS--------------<>-----------S-Q-Q---S?S----------------------SSS-----E-----QQ--QQ-------------QQ-Q-----------------SSSSS--SSSSS-??SSSSSSSSSSS---SSSSSSS-S-------------[]-------------[]------<>--[]---SSS-----X------------------XX--SSS--S---?SSSSSSSSS--SSSS--------S----SS-----<>------Q-Q---SSS------E---E--[]--------------E---<>-------Q-----QQQ-----------XXX--S------X-<>--------E------E<>----S?S------QQ-Q----------------EX--------------------------------SQS----XX----X-----------------------------SQS------------SS---------SS--------S---QQQ---SQQ----------QQQ------------------------XXXX-------Q--------<>-----------E---------------------------XX-XX--------S?SQS----E------SSS--S?SS------E-------------SSSS---------------------------o--o-----XXXXXX---------X--ESSS-----XX-----SSSSS-SSS------------SSS-----------------E--------Q--Q-QQ--Q--Q--Q------XXS---S---------------------------SSS--SSSS---SSS-XXX-SS-----SXXS--------<>--X------------------------SSSSS---S?S----SS----XX-----------------------------------------<>-------------------------------------XXXX-------------------------SSS----E-X--
--XXXX-----[]--------------------E------------E---------------------------------------------------------------------------XXX--XX-----------------------------------------------------XXXX---------------------------XX--X-------------------------------------------<>--[]----<>--------------------[]------[]------------------------------XXX----------XX---X---E------XX---------------E-----------------------------------------------------[]----------------------------E----------------------<>-----------------------------------------E--ESSSSS---SSSS---------------------------------------[]-------------[]------[]--[]-----------E---------------EX-X------------------------------------------------[]--------------------<>--<>--[]--------E----<>---[]------------------XX------------------XX-[]-E-----<>-----<>[]--------------------------------<>X--------------------------E-----------XX---X-X--------------------------------------------------------------<>-S------------------------------------------------XXXXX----------------[]-----E-----E--------------------------XXXXXX----------------<>------S-------------<>-------------------------------------XXX?-----------XXXXXXX--------XX---------XXXX---------------------------------------------<>---------------------------------------E----XX---------------X------------E-----XXX--------------------[]--X----------------------E---E------------------XX--------------------------XX-------------[]------------E-----X-----------------------------------------------------<>-XXX
X-XXXX-----[]-----------X-X-----<>-----------<>--------------------------------------------------------------------------XXXX--XXXX--------------------------------------------------XXXX---------------------------XXX--X-------------------------------------------[]--[]----[]--------------------[]------[]-----------------------------XXXX---------XXX---X---------XXX--------------<>-----------------------------------------------------[]---------------------------<>----------------------[]----------------------------------------<>----SSSS---SSSS---------------------------------------[]-------------[]------[]--[]-----------X--------------XXX-X------------------------------------------------[]--------------------[]--[]--[]-------<>----[]---[]------------------------------------XXXX-[]<>-----[]-----[][]--------------------------------[]X-------------------------<>----------XXX---XXX------------------------------------XX------------------------[]-------------------------------------------------XXXXXX----------------[]----<>-----X------------------X------XXXXXXX----------------[]------X-------------[]---------------------------------------------------XXXXXXXX-------XXX--------XXXXX--X------------------------------------------[]--------------------------------------<>-----X---------------XX-----------------XXX--SSSS------X-------[]--X----------------------------------------EE---XX-------------------------XXXX------------[]-----------<>------X--------------------XXX-----------------------------[]-XXX
X---XX-----[]-----E-EE--X-----E-[]ooo--------[]-------------------------------------------------------------------------XXXXX--XXXX--------------------------------E-E--------------XXXX--------------o------------XXXX--X-----E---------------------------X---EE----[]--[]----[]-E--------------E---[]------[]--------E-----E-E-----------XXXXX--------XXXX---X--X-----XXXX--------------[]---------------E-E----------------E-E----E-EE--------[]------E--------------------[]-------------E-EE-----[]-------E-EE--------E-E----------------E-[]--------oooS-SS----------------E---------E-E----------[]---------EE--[]------[]--[]-----------X-------------XXXX-X-----------------------EE-E------E----------E-E-[]------------E--E----[]--[]--[]-------[]-E--[]---[]-----------------------------------------[][]-----[]-----[][]-------------E------------------[]X-E-----------------------[]---------XXXX---XXX----------EE------------------------XX---E-------E---E--------[]---------------------------------------------EE--XXXXXX------EE----E---[]----[]----------------E-------X-----XXXXXXXX---------E------[]------X-------------[]--------------------------------------------------XXXXXXXXX------XXXX-EE----XXXXXXE-X------E-------------E-E-E-------------E---[]-----------------EE-------------------[]----XX--------EE-E-E-X---E--------------XXX------------X---E-E-[]--X--------EE-EE----------------------------X---XX----EE-E------o---------XXXX--SSSSS------[]-----------[]-----XX------XXXXXXXXXXX----------------EE-E--E-E--E-------[]-XXX
XXXXXXXXXXXXXXXXXXXXXXXXXXXX-XXXXXXXXX--XXXXXXXXXXXX----XXXXXXXXXXXXXXXXXXXXXXX----X----------------------------XXXXXXXXXXXXX--XXXXXXXXXXXXXXXXXXXXXXXXXXXXX----XXXXXXXXXXXXXXXXXXXXXXXXX-XXXXXXXXXX-XXXX-----XXXXXXXXX-XXXXXXXX-------------------------XXXXXXXXXXXXXXXXXXXXXXXXXXXXXXXXXXXXXXXXXXXXXXXXXXXXXXXXXXXXXXXXXXXXXXXXXXXXXXXXXXXXXXXXXXXXXXXXXXXXXXXXXXXXXXXXXXXXXXXXXXXXXX-XXXXXXX-----XXXXXXXXXXXXXXXXXXXXXXXXXXXXXXXXXXXXXXXXXXXXXXXXXXXXXXXXXXXXXXXXXXXXXXXXXXXXXXXXXXXX----XXXXXXXXXXXXXXXXXXXXXXXXXXXXXXXXXXXXXXXXXXXXXXXXXXXXXXXXXXXXXXXXXXXXXXXXXXXXXXXXXXXXXXXXXXXXXXXXXXXXXXXXXXXXXXXXXXXXXXXXXXXXXXXXXX-XX--XXXXXXXXXXXXXXXXXXXXXXXXXXXXXXXXXXXXXXXXXXXXXXXXXXXXXXXXXXXXXXXXXXXXXXXXXXXXXXXXXXXXXXXXXXXXXXXXXXXXXXXXXXXXXX-XXXXXXXXXXXXXXXXXXXXXXXXXXXXXXX--XXXXX----XXXXXX----XXXXXX-----XXXXXXXXXXXXXXXXXXXXXXXXXX-XXXXXXXXXXXXX--XXXXXXXXXXXXXXXXXXXXX---XXXXXXXXXXXXXXXXXXXXXXXXXXXXX---XXXXXXXXXXXXXXXXXXXXXXXXXXXX--XXXXXXXXXXXXXXXXXXXXXXXXXXXXXXXXXXXXXXXX-XXXXXXXXXX----XXXXXXXXX---XX-XXX-----XXXXXXXXXXXXXX--XXXXXXXXXXXXXXXX--XXXXXXXXXXXXXXXXX-XXXXXXXX-XXXXXXXXXXXXXX--XXXXXXXXXXXXXXXXXXXXXXXXXXXXXXXXXXXXXXXXXXXXXXXXXXXXXXXXXXXXXX----XX----XX-----XXXXXXXXXXXXXXXXXXXXXXXXXXXXXXXXXXXXXXXXXXXXXXXXXXXXXXXXXXXXXXXXXXXXXXXXXXXXXXXXXXXXXXXXXXXXXXXXXXXXXXXXXXXXXXXXXXXXXXXX--XXXXXXXXXXXXXXXXXXXXXXXXXXXXXXXXXXXXXXXXXXXXXXXXX------XXXXXXXXXXXXXXXXXX-XXXXXXXXXXXXXXXXXXXXXXXXXXXXXXXXXXXXXXXX--X--XXXXXXXXXXXXXXXXXX--XXXXXXXXX--------XX-XXXXXXXXXXXXXXXXXXXXXXXXXX--XX------S--Q----------------XXXXXXXXXXXXXXXXXXXXXXXXXXXX