------------------------------------------------------------------------------------------------------------------------------------------------------------------------------------------------------------------------------------------------------------------------------------------------------------------------------------------------------------------------------------------------------------------------------------------------------------------------------------------------------------------------------------------------------------------------------------------------------------------------------------------------------------------------------------------------------------------------------------------------------------------------------------------------------------------------------------------------------------------------------------------------------------------------------------------------------------------------------------------------------------------------------------------------------------------------------------------------------------------------------------------------------------------------------------------------------------------------------------------------------------------------------------------------------------------------------------------------------------------------------------------------------------------------------------------------------------------------------------------------------------------------------------------------------------------------
------------------------------------------------------------------------------------------------------------------------------------------------------------------------------------------------------------------------------------------------------------------------------------------------------------------------------------------------------------------------------------------------------------------------------------------------------------------------------------------------------------------------------------------------------------------------------------------------------------------------------------------------------------------------------------------------------------------------------------------------------------------------------------------------------------------------------------------------------------------------------------------------------------------------------------------------------------------------------------------------------------------------------------------------------------------------------------------------------------------------------------------------------------------------------------------------------------------------------------------------------------------------------------------------------------------------------------------------------------------------------------------------------------------------------------------------------------------------------------------------------------------------------------------------------------------------
SSSSSSSSSSSSSSS---------------------------------------------------------------------------------------------------------------------------------SSSSS-----------------------------------------------------------------------------------------------------------------------------------------------------------------------------------------------------------------------SSSSSSSSSSSSSSSSSSSSSSSSSSSS--------------------------------------------------------------------------------------------------------------------------------------------------------------------------------------------------------------------------------------------------------------------------------------------oo----------------------------------------------------------------------------------------------------------------------------------------------------------------------------------------------------------------------------------------------------------------------------------------------------------------------------------------------------------------------------------------------------------------------------------------------------------------------------------------------------------------------------------------------o-------------------------------------------------------------------------------------------------------------------------------------------------------------------------------------------------------------------------------------------------------------------------------------------------------------------
-------------------------------------------------------------------------------------------------------------------------------------------------------------------------------------------------------------------------------------------------------------------------------------------------------------------------------------------------------------------------------SSSS----SSSSSSSSSSSSSSS----------------------------------------------------------------------------------------------------------------------------------------------------------------------------------------------------------------------------------------------------------------------------------------------X---E--E----------------------------------------------------------------------------------------------------------------------------------------------------------------o-----------------------------------------------------------------------------------------------------------------------------------------------------------------------o-------------------------------------------------------------------------------------------------------------------------------------------------------------------------------------------------------------------------------------------------------------------------------------------------------------------------------------------------------------------------------------------------------o-----------------------------------------------------------------------------------------------------------
----------------------------------------------------------------------------------------------------------------------------------------------------------------------------------------------------------------------------------------------------------------------------------------------------------------------------------------------------------------------------E--SSSS--E-SSSSSSSSSSSSSSS-----------------------------------------------------------------------------------------------------------------------------------------------------------------------------------------------------------------------oooooo--------------------------------------------------------------------XXXXXXX----------------------------------------------------------------------------------------------------------------------------------------------------------------------------------------------------------------------------------------------------------------------------------------------------------------------------------------------------------------------------------------------------------------------------------------------------------------------------------------------------------------------------------------XXX--------oo--oo--ooo------------------------------------------------------------------------------------------------------------------------------------------------------------o-ooo--oo-----------------------------------E-----------------------------------------------------------------------------------
---S----------------------------------------------------SSS---SSS-------E--E-------------------SSSSSSSSSSSSS---S-----------SSS----------Q---------------------------------------------------------SS-------SSQS-------oo----------------------------------XX-------------------E------------------------------------------S-------------------------------------------------S---S----SS--S-SSSSSSSSSSS------------------SSSS----SSSS---------?SQS----------------------E--SS-------------------XXXXX----------oo-------------------SSS--SS-------------?---------------XXX------------------------------------XXoo---XX-----------------S-S---------XX------oo-------------------------o------------------------------SS--------------------XX-----------oo-----------------------------------------------------Q?SSS-----QQQQQQ------------SS---------------SSSSSSS----S?SSS---------SSSSSSSS---SSS--------------------------------------------------XXX-------------------------------S---------------------------SSS-----?SSS------------------SSS------XXXX----------------------------------S---SS-----------------------------------SS------------------------QQS----------S---------S----------------------------SSSSS----------SSS------S--------XXX--------------------SQSSQ----------SSSSS-----------S---QQQ------------------Q?SSS----------SSSSSSSSSS--------------SSS---SSSSS---------?------------------------S?---------------------------?SSS-----?SS---------------SS--SSS-----------------SS-----------------------------X----------------------------
---------------------------------------------------------------------------XXXXX----------------------------------------------------------------------------------------------------------------------------------------------XX-------------------------XXX----------------------XXXX----------------------------------------------------------------------E------------------------SS-------------------------------------------------------------------------------<>--------------------------------------SS-------------------------------------------------------XX---------oooo-----------------------------------------------E--XXX-----------------------XX---------------------------------------------ooo--------------o-o-------XX---------------------------------------------------oo--------------------------------------------------------------------------------------------------------------------------------------------------XXXX-------------------------------------------------------XXXX-------<>-----------------------------------XSS--------------------------------------------------------------------------------------------------------------------------------------------XX-----------------------------------XX------------------------o----------------------------------------------------------------------------------------------------------------------------------oo-----------------------------------------------------------------S-----------------------------------------------------XX----------------------------
--SS--------------------------------------------------------------------------------------------------------------------------------------------------------------------------------------------------------------------------o-------------------------XXXX-----------------------------------------------------------------------------------------------XXX-XX-------X------------SS-------------------------------------------------------------------------------[]-------------------------------------XX------------------------------------------------------XSXX---------------XXXX---------------------------------------XXXXX-------------------------oo-----------------------------------------------------------------------XXXXX-------------------------------------------------------XX--o-----------------------------------------------------------------------------------------------------------------------------------------XXXXX------------------------------------------------------------------[]----------------------------------XXX---------------------------------------------------------------------------------------------------------------------------------------------------------------------------------------------------------XXXXX-------------------------------------------------------------------------------------------------------------------------------------------------------------------------------------------E-----------------------------------------------------------X---X----------------------------
---So--------------------------------------------------------E---------------XXX--------------------------------------------------oo------------E--S----ooo-----E--------------------------------S-----------------------------------------------------XXXXX------------------------------------------------------E----------------E-------E---------------------------XXS-----E-----SS----o---ooooo--------E--S----ooo--------------------------------------------E--XX--------------------o--------------SXSS------------------------E------------X---oo----------XXXXX-----------------------------------------------------------------------------------------------E------------------------SSSQ-------S-------------------E---------XXXX-------------------------------E-------oo----o----------XXS-------------------------------------------------------------------------------------------------------------------E---------o------------XXXXXX----oo---oo----------XX-------------------------------------------[]----------------------Soo-------XXXXX----------------------------------------------------------------------------------------------------------------------------------------------------------------------------SSSSSS------XX---------------------------------------------------------------------------------------------------------------------------------------------------E-----S---------------------------XXXX---------------S-----<>--------E-------------------------------------------------XX---X----------------------------
X--SSS------------------Q--o----------------SQ?-------------SS------XXX----------------SQS------X--X---SSSSSSS--Q?QQQQ--QQQS----------QQQ---E--<>--------------<>---Q?Q--QQQ-----------------------E-----XXX------XXXX------SS---------S--------------XX-XXXo-----------XXXXXX------------------------------E----<>-Q--Q--S-------<>---E--<>--------------------------XXX----oSSS----SSSS--SSSSSSSSSS------<>-----E---------E-------S--QQQ--QQQQ--------------So--<>-----QQQQ------------------------------XXXX-----------------------<>-------------ooo--o--------XXXXXX------------XXX---ooo-------------------XXXX---------------------------------XXXXXX-XXXX-----------------XXX--------------------------E--S---------o--<>---------XXXXX--------X---XXXX-------------<>------------------------XXX--------------QQQ--QQQQ--Q---------QQ---------------------Q----------------Q--S-----S--------------------------<>-<>---------------------XXXXXXX---------------------XX------------------SS-----------------------[]-?S--------E----------o--o-----XXXXXX---------X----------<>---------SS---------------------------------------SSS-----------------------SS-----------------------------ooo----------------------------------------------X-------XXX-------------------SSS----------QQQ?--------S--QQQ--SQQ--Q------E---E------SSS---<>----E?QQ?SSSSS----------------X--X------------oo-Q--------XX<>------------S---------XXXX--------------------E--------E--[]-----E--SS--S?S--------S---------------------------------XXX-XX------------E--?-------------
--------------------------------------------------------------------------------------E-------XXX--XX---------------------------E-----------E--[]--------------[]-------------------XXXX?-------X-XX-----------------XX------------------------------XXX-XXXXX------------------------E-------------E------<>----[]---------------[]--<>--[]---------XXXXX-----------XXXX----ES--------SS------------------[]----<>--------<>--------------------------------E----[]------------------------------------XXXXXXX--S----S---------------[]--------------------------XXXX-XXX-------------------E---------XXXXX------------o-------------------------------------------S-------------------------EX---------E----<>---------------[]-------XXXXXXX-------EX--------XXXXX-------[]----X-------------------XXX---------------------------------------------------------------------------------------------------------------[]-[]--------------------XXXXXXXX--------------------XXX------------------------E-------E----------------------<>------X-----------XXXXXXX--------XX----<>----[]---------------X-----------------X------------------------------XX----------------------------------------------------------------------<>--------------------------------------------------------------E----------X------------------<>--<>------------[]-----------------------------XX--XX--------EE------------XXX[]------------------------------------------------------<>--[]----<>--------------------E---E-------------------------XXXX-XXX----------<>----------------
---------------------------------------X---------------------XSS-----------------------------XXXX--XXX-------------------------<>--------------[]--------------[]-------------------------------X---------------X----XX-----------------------------XXXX-XXXXXXX---------------------<>------------<>------[]----[]---------------[]--[]--[]------------------------XXXXX---o----------SS------------------[]----[]--------[]-------------------------------<>----[]----------------------------------XXXXXXXXX-----------------------[]----------------------<>-XXXXX-XXX-------------XXXXXXXX------------------------XXXX---XX----XXX---------------------------ooS------------------------<>X--------<>----[]---------------[]----<>-XXXXXXX------XXX--------------------[]----X-------------------XXX--------------------------------------------------X---------------------------------------X--------------------[]-[]-------------------XXXXXXXXX-------------------XXXX-----------------------<>------<>----------------------[]------X----------XXXXXXXX-------XXX----[]----[]--------------XX-------------X---X---------------------------E---X----------------<>---XXX----------------------------------------------[]--------------------------------------------------------------------------S-----------------[]--[]------------[]----------------------------XXX--XXXX--------X----------XXXX[]-X-------X-X-------------------X----------------------[]--[]----[]-------------------<>--<>------------------------XXXXX-XXX----------[]----------------
-----------------------------------------E--------E-E-----------------------------E---------XXXXXE-XXXX------------------------[]--------------[]--------------[]-------------------------------X-------------XXXX---S---S----------E-E--------E---XXXXX-XXX-X-----------------------[]----------E-[]------[]-E--[]-----E-E-------[]--[]--[]-----------------------XXXXXX-------------E----------E-----E---[]----[]--------[]----------E--------------------[]----[]----------------------------XXXXXXXXXXXXXXX-----E------E-------E--[]----------------------[]-XXXXX-XXX-----X------------------------------ooo------------------------------------o------------X[]------------------------[]X-EE-----[]-E--[]------------E--[]----[]XXXXXXXX-----XXXX--------------------[]----X---------------E---XXX---E-------------------E------EE-E-E--E-------E-E-X------------------------EE--------E-E--X-------EE-----E-EE--[]-[]------------------XXXXXXXXXX-----------------EXXXXX-----------------------[]------[]----------------------[]------X---------XXXXXXXXS------XXXX---E[]E---[]-------------XXX-------------XX--X---E--E-----E------------E-X---X-------E-EE-----[]-E-XXXXE-EE----X---------------------------E--------[]-E-E---------EE--------------------------------E--------------------------------------------[]--[]-----EE-----[]-E-E-------E----------E----XXXX--XXXX------XXX---------XXXXX[]-X----E--XXX--------oo-------------------E---------EE-[]--[]----[]-----E-------E-----[]--[]-------E-----EE-----E--XXXXXX-XXX----------[]------------E-EE
--XXXXXXXXXXXXXXXXXXXXXXXXXXXXXXXXXXXXXXXXXXXXXXXXXXXXXX-----------------------XXXXXXXXXXXXXXXXXX-XXXXXXXXXXXX--XXXXXXXXXXXX-XXXXXXXXXXXXX--XXXXXXXXXXXXXXXXXXXXXXXXXXXXXXXXXXXXXXX-----XXXXXXXX---XXXXX-----XXXXX-------XX-XXX-XXXXXXXXXXXXX-XXXXXXXXXXXXXXX--------XX---------XXXXXXXXXXXXXXXXXXXXXXXXXXXXXXXXXXXXXXXXXXXXXXXXXXXXXXXXXXXXXXXXXXXX-----XXXXX---XXXXXXX----XXXXXXXXXXXXXXXXXXXXXXXXXXXXXXXXXXXXXXXXXXXXXXXXXXXXXXXXXXXXXXXXXXXXXXXXXXXXXXXXXXXXXXXXXXXXXXXXXX--XXXXXXXXXXXXXX-------XXXXXXXXXXXX---XX--XXXXXXXXXXXXXXXXXXXXXXXXXX----XXXXXXXXXXXXXXXXXXXXXXXXXX-XXXX-------------------------XXX------------------------------XXX-----------------XXXXXXXXXXXXXXXX---XXXXXXXXXXXXXXXXXXXXXXXXXXXXXXXXXXXXXXXXXXXXXXXXXXXXXXXXX-XXXXXXXXXXX--XX-------XXXX--XXXXXXXXXXXXXX-X-XXXXXXX--XXXXXXXXXXXXXXXXXXXXXXXXXXXXXXXXXXXXXXXXXXXXXXXXXXXXXXXXXXXXXXXX--XXXXXXXXXXXXXXXXXXXXXXXXXXXXXXXXXXXXXXXXXXXXXXXXXXXXXXXX-XXXX----XXXXXXXXXXXXXXXXXXXXXXXXX---XXXXXXXXXXXXXXXXXX-X----XXXXXXXXXXXXXXXXXXXXXXXXX-XXXXXXXXX---XXXXXX--XXXXXXXXXXXXXXXXXXXXXXXXXXXXXXXXXXXXXXXXXXXXXXXXXXXXXXXXXXXXXXXXXXXXXXXXXXXXXXXXXXXXXXXXXXXXXXXXXXXXXXXXXXXXXXXXXXXXXXXXXXXXXXXXXXXXXXXXXXXXXXXXXXXXXXXXXXXXXXXX---XXXXXXXXXXXXXXXXXXXXXXXXXXXXXXXXXXXXXX----------------------------XXXXXXXXXXXXXXXXXXXXXXXXXXXX--XXXXXXXXXXXXXXXXXXXXXXXXXXXXXXXXXXXXXXXXXXXXXXXXXXXXXXXXXXXXXXXXXXX--XXXXXXXXXXXXXXXXXXXXXXXXXXXXXXXXXXXXXXXXXXXXXXXXXXX------------------XXXXXXXXXXXXXXXXX-XXXXXXXXXXXXXXXXXXXXXXXXXXXXXXXXXXXXXX-XXXXXXXXXXXXXXXXXXXXXX--XXXXXXXXXXXXXXXXXXXXXXXXXXXXXXX