-------------------------------S---------QX-----------------------------------------------------------------------------------------------------------------------------------------------------------------------------------------------------------------------------------------------------------------------------------------------------------------------------------------------------------------------------------------------------------------------------------------------------------------------------------------------------------------------------------------------------------------------------------------------------------------------------------------------------------------------------------------------------------------------------------------------------------------------------------------------------------------------------------------------------------------------------------------------------------------------------------------------------------------------------------------------------------------------------------------------------------------------------------------------------------------------------------------------------------------------------------------------------------------------------------------------------------------------------------------------------------------------------------------------------------------------------------------------------------------------------------------------------------------------------------------------------------------------------
------------------------------S-S----oo--XSX----o-X---------------------------------------------------------------------------------------------------------------------------------------------------------------------------------------------------------------------------------------------------------------------------------------------------------------------------------------------------------------------------------------------------------------------------------------------------------------------------------------------------------------------------------------------------------------------------------------------------------------------------------------------------------------------------------------------------------------------------------------------------------------------------------------------------------------------------------------------------------------------------------------------------------------------------------------------------------------------------------------------------------------------------------------------------------------------------------------------------------------------------------------------------------------------------------------------------------------------------------------------------------------------------------------------------------------------------------------------------------------------------------------------------------------------------------------------------------------------------------------------------------------------
------------------------------SSS----XX--XXXXS--------oo-------------------------------------------------------------------------------------------------------------------------------------------------------------S-S---------------------------------------------------------------------------------------------------------------------------------------------------------------------ooo---------------------------------------------------------------------oo---------------------------------------------------------------------------------------------------------SSSSSSSSSSSSSSSSSSSSSSSSSSS---------------------------------------------------------SSSSSSSSSSSSSSSSSSSSSSSSSSSS------------------------------------------------SSSSSS----------------------------------------------------------------------------------------------------------------------------------------------SSSSSS----------------------oo---------------------------------------------------------------------------------------------------oo---------------------------------------------------------------------oo----------------------------------------------------------------------------------------------------------SSSSSSSSSSSSSSSSSSSSSSSSSSSS--------------------------------------------------------------------------------------------------------------------------------------------------------------------------------------------------------------------------------------------------------------------------------------------------------------------
-----------------------------------XXXXX-XXXX-------------------------------------------------------------------------Q-------------------------------------------------------------------------------------------------------------------------------------------------------------------------------------------------------------------------------------------------------------------?--------------------------------------------------------------------------XXX---------------o--o-----------------------------------------------------------------------------------------------------------------------------------------------------------------------------------------------------------------------------------------------------------------------------------------------------------------------------------------------------------------------------------------------------------------------------------------E--E----------------------------------------------------------------------E-------------------------------------------------------------------------------------------------E--E----------------------------------------------------------------------------------------------------SSSSSSSSSSSSSSSSSSS---------------------------------------------------------------------E---------------------------------------------------------------------------------------------------------------------------------------------------------------------------------------------------o-ooo-----------------------------------------------
--oo--oo----------------------------XXXX------X-XXX-------------ooo----------------------------------------------------------------------------------------------------------------------------------------------------------------------------------------------------------------------------------------------------------------------------------------------------------------Eooo------------------------------------------------------------E---------------------------------------------------------------------------------------------oo-----------------------------------------------------------------------------------------------------------------------------------------------------------------------------------------------------------------------------------------------------------------E-------------------------------------------------------------------------------------------------------------------oo---o--------------------------------------------oo--oo--------------XXX----------Eoo---------------------------------------------------------------------------------XXXXXXX--------------------------------------------------------------------------------------------------SSSSSSSSSSSSSSSSSSS---------------------------------------------------------------------XX-------------------------------------------------------------------------------------------------------------------------------------E-----------------------------------------------------------------oo---------------------------------------------
------------------------------------------------------SX-------XXXX----------XXX-----XX-------------------------S----------------E-------------------S-S------------SSSS-----------------------------------------------------------------------------------------------------SSSSS--SSSS-----------SS-------------SSSS---------------SS---SSSSSS-----------------------E-----------XXXXX-----XXX---------------------------SSQ-------------------SSSSSS----------S----S----------S---SSS---S---SS----------------------SSSS------SS------E----XX-------------------SQSS--?SSSSSS-------------------------------------------------------------------SSSSSSSSSSSS----------------------------------------------------------------------------------QQQQ-------------------------------------------------------------QQQS------SSSSSSSSS?SSS---SSSSQ---S---SSSQSSS----SS-------------------------------------------------SSSSQQQQQ-oo-------------------------------XXX-----XX--------------------------------------------SS--XXXX------------------S-------------------------------------------SSSSSS-----o-------------------------------------------XX-------SS-Q--SS-SSSS---S-----X--------Q-----------------SSSSS-----SSSSSSSSSSSSSSSSSSSS-QQS--------------------SS-----S----SSSSS---?SSS-----E--?--------oo-------E----ooo----Xo--------------------SSS--------------------SSSSSSSSSS-------SSSS---QQQQ------------------------------------------SSS--------------------------SS--E------------------------X---S----XXXX------XXX-----------------------------------
-------------------------------E--------------------------------------------XXXX----------------------------o-------------------<>------------------------------------------------------------------------------------------------------------------------------------------------------------------------------------------------------------------------------------<>---------------------XXXSS--------------------------------------------------------------E---------------------S-------------------------------------------------<>-----------------------------------------------------------------------------------o-------------------------------------------------------------------------------------------------------------------------------------------oo---------------------------------------------------------------------------------------------------------------------------------------------------------------------------------------------------------------------------------------------------------XXSS---------------------------------------------------------------------------------ooo------------------------XX------------------------------X-----------------------------------------------------------------------------------------------------------<>-------------------XXX----------------------------------ooo---------------------------------------------------------XXX----------------------------------------------------------------XXX----------------------XXX-------------XXX-----------------------------------
----------------------------XXXXXXXXX--------------------------------------XXXX-------------------------------------------------[]--------------------------------------------------------------------------------E------E--------------------------------------------------------------------------------------------------------E-----------------------------------[]--------------------XXXX-------------------------------------------------------------------------------------SS--------S----------------------------------------[]------------------------------------------E----------------------------------------------------------------------------------------------------------------------------------------------------------------------------------------------X--------------------<>----------------------------------------------------------------------------------------------XSS--o---------------------------------------------------------------------------------------------------------------------XXXX---------------------------o-------------------------------------------------------------------------------XXXX----------------------------XXXX------------------------E---------S------------------------------------E---------E------------------------[]----------------------------------------------------------------------------------------------------------------------------------------E--------------------------------------------------------------------------------------XXXX-----------------------------------
------------XXXXX----------------------------E--oo------------------------XXXXX----------------XXX------------------------------[]------SSSS--S-----------E--o------SS---------------------------o---------------<>-----<>---------------------------------X-----------E---------------------------E-----------------------------<>-----------------------------------[]----o--------------XXXXX------------------oo---------------------XS-SS---------------------------------------SS--------SoS--S----ooo--------------XX------------XXX------------------E----------------------------ooo---oo-------------------------E-----------------------------------------------------------------------------------------------------------oo---o-------------------------------------XX--------------------[]-------------------------------------------------------------------------E-------------------XXX----------------------XXXX------------------------------------------------oo----------------------------XXQ--S-S--------XXXXS---------------o-------------------------------------------------XX--oS------------------------------------XXXX----------E---------------E-XXX---------------------------------------------E----?---------------------E--------<>-----------E---E--------[]-----------XX-------------XXX----------------------------------------------------------------------------------------------------------<>-------E------------------oo-----------------------------------------QSSSSS------E---XXXX------------------------------E-----
-------------------XXXXXXX------------------<>---------------XXX---------XXXXXX-------------------------XX---------E-------------------------------------<>-----E--S----S---------S------E-----------S----E------[]-----[]--------------------------------XX------------XX--XX---SS----S----------<>---S----E-------SS-------XX--[]------S---------------------------XXX---E---------------XXXXX------------------------XXXX-SSSS------XXX-------S-------------------SS------------------XXX----SS-----E--------E-----S-----XXX---XXXX----------XXXX--------<>----E?QQ?--QQQ---S-QQ?------------------QQQ-----------------<>---------E-------------XX--X-----------X---S--------------------SS--QS---S---------------------------E-----------QQ--QQQQ------------------E---------XXX-----E--------------[]--------SSQS---------SQQ?--QQQ-------S?SQQQQ--Q--Q--Q--S?S----QQ--------<>------E------E----XXXX-SS----S-------ESSQS-----------XXX------------------------XXXXX-------------------XXXX---------------------------------XXXXXX---------oo--o-----------------------QQQ-------------SQS--QQQ---------------------------------------------XXXXX----------QX--S?SQ-----S----XXX-------SS--------------SSS---X-----SSSSSSSSSSSSSSS??SQ--QQQ------------<>------SS[]----------<>--<>--S-----[]------Q-o----XXX-------------------XX-----------------S-----------------------X--S---------<>---QQ--QQQQ--Q--------------------<>------[]-----E<>-------------------------------EX---XX--------------------------------------XXXXX----------------------ES-----<>---Q-
----------XXXX--------------XXXX?-----------[]--------------------------XXXXXXX-------E---------------------------<>-------------------------------------[]----<>--------------E-------E<>---------------<>------[]-----[]------------------------E------XXX-----------XXX--XX--------------------[]------E<>-E---------E----[]-------------------------------------XXXX---------------E-XXXXXXX-SSS----------------------------------XXXX----------------------------------------------EXXX----------<>-------<>-------------------------------------------[]------------------------------------------------------------[]--------<>------------XXX--XX----------X--------------------------------------------------------------------------------------------------<>--------XXXX----<>--------E-----[]------------------------------------------------------------------------[]----E<>------E---XXXXX------------------------------------------------------XXXX------------------------------------------------------------XXXXXXX----------------------XXX-----E-------------------------------------------------E------------------------XXXXXX--------XX------------------XXX--------------------------E--X-----SSSSSSSSSSSSSSS--SS-----------------[]--------[]----------[]--[]--------[]------------------------------------------------------------------------------X------------[]X---------------------------------[]------[]----<>[]-----------------------------X<>XX--XX-----------------X-------------------XXXXXX---------------------<>------[]--E--
--------------------------XX----------------[]-------------------------XXXXX-XX------<>---------------------------[]-------------------------------------[]----[]---------E---<>------<>[]---------------[]------[]-----[]-----------------------<>-----XXXX----------XXXX--XXX--------X----------[]-----<>[]----------<>----[]----------------X-------------------XXXXX--------------<>-XXXXXXX-------------------------------------XXXXXX------------------------------------X-------XXXXX----------[]-------[]-------------------------------------------[]------------------------------------------------------------[]--------[]-----------XXXX--XXX-------X-X--------------------------------------------------------------------------------------------------[]-------XXXXX----[]-------<>-----[]------------------------------------------------------------------------[]---<>[]-----<>--XXXXXX--SSS------------------------------------------------------------------------------------XXXX------------------------XXXXXXXX---------------------XXX---------EE--------------------------------------------<>-----------------------XXXXXXX--------XX------------------XXX-----------------------------X-----SSSSSSSSSSSSSSS--SS-----------------[]--------[]----------[]--[]--------[]----------------------------------------------------------------------------<>X--XXX-------[]X---------------------------------[]------[]----[][]----------------<>-----------X[]XX--XXX----------------X------------------XXXXXXX---------------------[]------[]-<>--
---------------------------------------E----[]------------------------XXXXXX-XX------[]---------------------------[]-------------------------------------[]----[]-------------[]------[][]----------E-E--[]------[]-----[]-E--E----EE----E-E-----[]---XXXXXX---------XXXXX--XXX--E-EE--X---E------[]-----[][]---E-E-E--[]-E--[]----------EE---XX---------------EE-XXXXXX--E-----------[]XXXXXXXX---------------------o-o------------XXXXXXX---X------------EE-EE-E-E-------E---X-E----XXXXXX----E-----[]-------[]--------------ooo----------------------E---[]-----------E--------------------------------------------E---[]--------[]----------XXXXX--XXXX------XXX----------------------------------------------------E-EE---------------------EE-----E----------E--[]------XXXXXX----[]-----E-[]-----[]-------------------E----------------------------------------XX---EE-E---[]---[][]-----[]--XXXXXX---------------------E-o--------------------------------------------------------ooo---------------------------------XXXXXXXXX--------------------XXXX------S----------E-E-----------------------------------[]-----S----------------XXXXXXXX-------XXXE-------------E---XXX------XE---------------------------SSSSSSSSSSSSSSSooSSE---------EE-E---[]--------[]----------[]--[]----E---[]----------ooo--------------------------------------------------------E------[]X--XXXX------[]X---------------------------------[]------[]----[][]---------EE-E---[]-----------X[]XXX-XXX------E-----E---X---------------------XXXX----E--X------E-EE-E-[]---E--[]-[]--
XXX--XXXX------------------------XX---XXXXXXXXX---XXXXXXXXX-X----XXXXXXXXXXXXXXXXXXXXXXXXXXXX-XXXXXX---------XXXXXXXXXXXXXXXXXXXXXXXXXXXXXXXXXXXXXXXXXXXXXXXXXXXXXXXXXXXXXXXXXXXXXXXXXXXXXX-XXXX--XXXXXXXXXXXXXXXXXXXX--XXXXXXXXXXXXXXXXXXXXXXXXXXXXXXXXXXXXX---XXXXXXXXXXXXXXXXXXXXXXXXXXXXXXXXXXXXXXXXXXXXXXXXXXXXXXXXXXXXXXXXXXXXXXXXXXXXXXXXXX-XX-XX---XX-XXXXXXX-XX-XXXXX------XXXXXXXXXXXXXX----XXXXXXXXXXXX---XXX-----XXXX---XXXXX----XXXXXXXXXXXXXXXXXXXXXXXXXXXXXXXXXXXXXXXXXXXXX-XXXXXXXXXXXXXXXXXXXXXXXXXXXXX------XXXX------------------XXXXXXXXXXXXXXXXXXXXXXXXXXXXXXXXX-XXXX----XXXXX--XXXX---XXXXXXXXXXXXXXXXXXXXXXXXXXXX--XXXXXXXXXXX--XXXXXXXXXXXXXXXXXXXXXXX---XXXXXXXXXXXXXXXXXXXXXXXX----XXXXXXXXXXXXXXXXXXXXXXXXXXXXXXXXXXXXXXXXXXXXXXXXXXXXXXXXXXXXXXXXXXXXXXXXXXXXXXXXXXXXXXXXXXXXXXXXXX-XXXXXXXXXXXXXXXXXXXXXXXXXX-XXXXXXXXXXXXXXX---XXXXXXXXXXXXXXXXXXXXXXXXXXXXXXXXXXXXXXXXXXXX------EXXXXXXX-XXXXXXXXXXX--XXXX---XXXXX-----------------------XXXXXX----------XXXX------------------------XXXX-XXXXXXXXXXXXXXXX--XXXXXXXXXXXXXXXXXXX----XX-XXXXXXXXXXXXXXXXXXXX-XXXXXXXXXXX---XXXXXXXXXXXXXXXXXXX-----XXXXXXXXXXXXXXXXXXXXXXXXXXXXXXXXXXXXXXXXXXXXXXXX-XXXXXXXXXXXXXXXXXXX--XXXXXXXXXXXXXX---XXXXXXXXXXXXXXXXXXXX-XXXXXXXXXXXXXXXXXXXXXXXXXXXXXXXXXXXXX-XXXXXXXXXXXXXXXXX---XXXXXXXXX--XXXX-------------------XXXXXXXXXXXXXXXXXXXXXXXX---XXXXXXXXXXXXXXXXXXXXXXXXXXXXX-XXXXXXXXXXXXX----XXXXXX-X--XXXXXXXXXXXXXXXXXXXXXXXXXXXXXXXXXXXXXXXXXXXXXXXXXXXXXXXXXXXXX-XXXXXXXXXXXXXXXXXXXXXXXXXXXXXXXXX-XXXXXXXXXXXXXXXXXXXXXXXXXXXXXXXXXXXXXXXXXXXX