------------------------------------------------------------------------------------------------------------------------------------------------------------------------------------------------------------------------------------------------------------------------------------------------------------------------------------------------------------------------------------------------------------------------------------------------------------------------------------------------------------------------------------------------------------------------------------------------------------------------------------------------------------------------------------------------------------------------------------------------------------------------------------------------------------------------------------------------------------------------------------------------------------------------------------------------------------------------------------------------------------------------------------------------------------------------------------------------------------------------------------------------------------------------------------------------------------------------------------------------------------------------------------------------------------------------------------------------------------------------------------------------------------------------------------------------------------------------------------------------------------------------------------------------------------------------
------------------------------------------------------------------------------------------------------------------------------------------------------------------------------------------------------------------------------------------------------------------------------------------------------------------------------------------------------------------------------------------------------------------------------------------------------------------------------------------------------------------------------------------------------------------------------------------------------------------------------------------------------------------------------------------------------------------------------------------------------------------------------------------------------------------------------------------------------------------------------------------------------------------------------------------------------------------------------------------------------------------------------------------------------------------------------------------------------------------------------------------------------------------------------------------------------------------------------------------------------------------------------------------------------------------------------------------------------------------------------------------------------------------------------------------------------------------------------------------------------------------------------------------------------------------------
----------------------------SSSSSSSSSSSSSSSSSSSSSSSSSSSS------------------------------------------------------------------------S-SSSSSSSSSS------------------------------------------------------------------------------------------------------------------------------------------------------------------------------------------------------------------------------------------------------------------------------------------E--SSSSSSSSSS----------------------------------------------oo-----------------------------------------------------------------------------------------------------------------------------------------------------------------------------------------------------------------------------------------------------SSSSSS---------------------------------------------------------------------oo-----------------------------------------------------------------------------------------------------------------------------------------------------------------------------------------------------------SSSSSSSSSSSSSSSSSSSSSSSSSSSS------------------------------------------------------------------------------------SSSSSSSSSSSSS??SSSSSSSSSSSSS------------------------------------------------------------------------------------------------------------------------------------------------------------------oo--------------------------------------------------------------------------------------------------------------------------------------------------------------------------------------------------------
-------------------------------SSSSSSSSSSSSSSSSSSSSSSSSS--------------------------------------------------------------------------SSSSSSSSSS-------------------------------------------------------------------------------------------------------------------------------------------------------------------------------------------------------------------------------------------------o--------------------------------------XXS---SSSSSSSSSSSSS-----------------------------------------XXXX----------------------------------------------------------------------------------------------------------------------------------------------------------------------------E-------------------------------------------------------------------------------------------------------------------------------------------------XXXX---------------------------------------------------------------------------------------------XXXX---------------------------------------------------------------------------------------------------------------------------------------------------------------------------------------?---------------------------------SSSSS-------------------------------E-EE-E--------------------------------------------------------------------------------------------------------------------------------------------------------E----------------------------------o-----------------------------------------------------------------------------------------------------------------------------------------------------------o----oS
-------------------------------SSSSSSSSSSSSSSSSSSSSSSSSS--------------------------------------------------------X-----------------SSSSSSSSSS----------------------------------------------------------------------------------------------------------------------------------------------------------------------------------------------------------------------------------------------------------------------------------------XSS--?SSSSSSSSSSSSS------------------------------------------------------------------------------------------------------------------------------------------------------------------------------------------------------------------------XXX-------------------------------------------------------------------------------------------------------------------------------------------------------------------------------------------------------------------------------------------------------------------------------------------------------------------------------------------------------------------------------------------------ooo--------------------------------------------------------------------------SSSS-------------------------------XXXXXXXXX----------------------------------------------------------Eoo----------------------------------------------------------------------------------------XXX--------------------------------E-----------------------------------------------------------------------------------------------------------------------------------------------------------S-----SS
----------------------------S--SSSSSSSSSSSSSSSSSSSSSSSSS-------SS---------XX-----------------------SSSS------------SSS-------SSSSSSSSSSSSSSS---------------------------------------SS----------------------------------XX-----------S----------XXX---SS-----S-------------------------------------------------------QSS--------------SSSSSS----------SSS----SSS----------------------------SSS------SSSS----XXXXX----------XXX------SSSSSSSSSSSSSSSSSSS-QQQQQ------SSSS-------------SS-------S-------------------------S---------------SQS-----SSSSSSSSSS----------Q--Q---------S-----------X------?SSS-----------------------SSS----------------------------------------E--S------------------S-----------SSSSSSSSSSS------SSSS-----Q--------------------QQSS---SS----------Q-S----SSSSS------S------SSS----------------------------------------------------------------QQS---S---SSSSSSSSS-------------------Q-QQQ--------------------------------------------------X--------------------------------SSSSSSS-------------------------------QQ-----------------------------o------XXXX--------XXX----------------------------------------------------------Q---SS-----ooooooo------------------------------------------SSS--------E----SQQ-?-------------------------XXXX---SQ-SQ---------S----------Q-Q-------------------------------XX-------XX----------------------S-----SSS-----SS----------SQS-----SSSSS-------------S---SS--------------XX----------------------------------------------------------------------------SSSS---SSSSSS---S----------------SS---S--
--------------------------------------------------------------------------XX-------------------------------------------------------------------------------------E-----------------------------------------------ooo---XX-SS------------------XXXX-----------------------------------------------------------------------------------------------------------------------------------------------------------------------------------------------------------------S----------------SS-------------------------------------------------------------E----------------------XXXX----------------------------------------------------------------------------------------------X---------o-------XX-----------------------------------------------------------------SS-------------------------------------------------------------------------------------------------------------------------------------------------------------------------------------------XXX-----------XXSS---------------------------------------------------------------------------------------------------------------XXX--------------------------------------------------------------SS----------------------------------------------------------------------------XXXX-----------------------------------------------------------------------------------------------------XXX---------------------------------------------------------------------------------------X--------------------------------------------------------------------------------------------------------------SS------
--------------------------------------------------------------------------XX-------------------------------------SSS--------------------------------------------<>-----------------------------o----------------------XXX--------------------EXXXX---------------------------------------------------------------------------------------------------------------------------------------------------------------------------------------------------------------S-S------------------------------------------------------------------------------------------------------------------------------------------------------------------------------------------------XXXXXX-------------------X-S---------E-------------------------------------------------------SS-------------------------------------------------------------------------------------------------XX------------------------------------------------------------------------------------XS---------------XXXX-----------------------------------------------------------------------------------------------------------------XX--------------------------------------------------------------SS-----SSSSSSS---------------------------------E------------------S------------------------------------------------------------------------------------------------------------------------------------------------------------------------------------------------------------XXXX-------------------------------------------------------------------------------------------------------------SS------
---------------------------------S------o?ooooo------oo----------------E--XX---------------------------------------------------------------------E--------------[]-----------------------------------oo---------------XXX-------------------XXXXXX------------XXX-----------------------------------E-E--S--------E----------o-----------------------------------------E-------------------------------X----------oo--------------------------E--E-E---------------So-------------------E------------------E------------S------E----------------SSSS----------------------------SSSSSSS--------------------------------------------------SSQSS?--------------------------------------------X-------------------------------------------------------E------E------SS----------------------------------------------------------------------------E-------------------XXX-----------------------------X-----------------------XS----------------------------XXXQ-------------XXXXX---------------------E-------------------ESS--------------------------------oo--ooo--------------------------XS--X-------XXX-------------------------XXXX------------------------SE-----SSSSSSS--------------------------------<>----------------------------------------E-----------------------------------------------------E----------------------------------------------------------------------------------------------------------------------------------XX--S-----E--S----------E-----------------------------------------------E---------------------Soo------ooo--??-SS--Qoo?
----------------------E--S--------S-SS--SSSSSSS-----SSSS------------XX--XXXX-----------------Q--Q--QSQS---------S---SS--S---SSSSSSSSSSSSSSSS----<>--------------[]---E-----QQQ--QQQS----------------------------------XXX-------oooSSS-----XXXXXXX-------------------------------------------------<><>-----E----<>-SS-------------XXXXX-SSSSS--Q?-QQQQ--Q------------<>-------------E----E-----------XX----------------------------SSSSSSSSSSSSSSSS--S--QQ-Q-QQ---SSS-----------------ESSS-QQ------------<>---------------E--<>------E---QQQQ----------S--ooQ--Q--Q--Q-------------------------XXX--SSS-------------------QS----------------Q--Q--------E----------X----------------------X-XX--------S?S---------SSS-----X??QQQ--SQS---------E--<>---S--SSS---<>---E--QQQ--QQQ-------------Q--SSQQ--------------Q---------------------------<>------------------XXXX-X??QQQ--QQQ--Q--QQ---------EX-----------QQQQQ------XXX-X-------------------------XXX---------------XXXXX--------XX----------<>--S-----S------E--<>--------X---------------SS-S----------------S-S-------------------XXX--XX------X-----------------------S-------------------------QQQ---SSSS----------------------E----------------E--[]---------------o-------Q--Q------------<>----------------SSSSS-----QQQ-QQQ--Q--Q--Q--QQQQ----<>--------------------------------XXXXXXX------------------QSQ-------------XoX-----S--QQQ---------X-----------------S-----------X--XXX--S----<>------S-----<>---Q--Q-----------------------E---------------<>----E?SSS----o--SS---SSS----E---------SS-ESSS?
---------------------<>-------------SS-----------------------------XXX--XXXX--------------------------------------------------------------------[]------------E-[]--<>------------------------------------------------XXX-----------------XXXXXXXX-----------------------E-------------------------[][]----<>----[]---------------------------------------------------[]------------<>---<>----------XXX----------------E-----------SSSSSSSSSSSSSSSS-SS---------------------------------------------------[]---------X-S--<>--[]-----<>-----------------------------------------------------------------------------------------------------------E-----<>----------X---------------------<>-XXX-------------------E------XX------------------<>--[]------------[]--<>-----------------XX-----------------------------------------------------[]-----------------XXXXX---------------------------XXX-E-------------------XXX--XX----E-------E----------XXXX-------------XXXXXXX-------XXX----------[]-------------E-E--[]------XXX--XXX---------------------------------------------------XXXX--XX------X-------------------------------------------------------E----------------------XXXX?-------------E<>--[]---------------------------------------[]----------------------------------------------------[]--------E-----<>------------------------------S----------------------------X----------------X---X-----------------------------X-XXXX-------[]--E---------[]-----------------------------<>---------------[]------E-------E------------<>------------E----
---------------------[]-------------SS-------------------------<>-XXXX--XXXX--------------------------------------------------------------------[]--------------[]--[]-----------------------------------------------XXXX----------------XXXXXXXXX---------X------------<>-------------------------[][]----[]----[]--------X------------------------------------------[]------------[]---[]------<>-XXXX----------------------------SSSSSSSSSSSSSSSS-So------------------XXX------------------------------[]-------XXX-X--[]--[]-----[]----------------------------------------------------------------E---X---X----------------------------------------[]----------X---------------------[]-XXX-----------------------E-XXX------------------[]--[]------------[]--[]-----------------XX-----------------------------------------------------[]----------------XXXXXX--------------------------XXXX--------------------XXXX--XX---<>------<>---------XXXXX------------XXXXXXXX------XXXX---X------[]------------<>-]--[]--<>-XXXX--XXXX----------------------------------------------<>-XXXXX--XXX-----X----------------------------------------<>-----------------------------------------------------<>[]--[]----------<>---------------------------[]----------------------------------------------------[]-------<>-----[]--------------------------E---X--------------------------X-------S----------XX--XXX-------------------------X-XXXXXX-------[]-<>---------[]-----------------------------[]---------------[]---------------------------[]-----------------
-----E-EE-E-----EE---[]-E--------------------------------------[]XXXXX--XXXX------------------------------E----X-------------------------------E[]-----------E--[]--[]-----------------------EE----X--------------E--XXXX------X--------XXXXXXXXXX--------XX------------[]---------------------E---[][]----[]-E--[]---------------------------------------------------[]-----E-EE-E-[]---[]------[]-XXXX----------------------------SSSSSSSSSSSSSSSS-S---------------E----XX----------E-------------E--E--[]------XXXX-X--[]--[]-----[]------E--E---------------------------------------------------------XX---X------E-E-EE-------E---X----------------[]E---------X-----E-E------EE-----[]-XXX------------------------XXXX---------------EE-[]--[]-----E------[]E-[]--------------EE-XX-------E----------EE-E-------------------------------[]-----------EE--XXXXXXX--------E----------------XXXXX----X----E------E--XXXXX--XX---[]-E----[]-E------XXXXXX------o----XXXXXXXXX-----XXXXX------E---[]--E--E------[]-X--[]--[]XXXXX--XXXX--------E-------------------------------------[]-XXXXX--XXXE----X----------------------------------------[]-----------------------------------------------------[][]--[]--------E-[]---------------------------[]----------------------------------------------------[]-----E-[]-----[]-----E-E-XXXXXXX--------------X----------E--------E------X----------------X-XXE-XXXX---E-E---E--------------XXXXXXXX-------[]-[]-----E---[]--------------E--E-----------[]-E------E--E---[]-E--E------------X---E-EE--[]-----------------
XXXXXXXXXXXXXXXXXXXXXXXXXXXX-XXXXXXXX---XXXXXXXXXXXXXXXXXXXXXXXXXXXXXXXXXXXXXXXXXXXXXXXXXXXXXXXXXXX-XXXXXXXXXXXX--XXXXXXXXXXXXXXXXXXXXXXXXXXXXXXXXXXXXXXXXXXXXXXXXXXXXXXXXXXXXXXXXXXX----XXXXXXXXXXXXXXXXXXXXXXXXXXXXXXXXXXXXXXXXXXXXXXXXXXXXXXXXXXXXXXXXXXXXXXXXXXXXXXXXXXXX-----------XXXXXXXXXXXXXXXXXXXXXXXXXXXXXXXX-------XXXX------XXXX---XXXXXXXXXXXXX--XXXXXXXXXXX--XXXXXXXXXXXXXXXXXXXXXXXXXXXXXXXXXXX---X--XXXXXXXXXXXXXXXXXXXXXXXXXXXXXXXXXXXXXXXXXXX-XXXXXXXXXXXXXXXXXXXXXXXXXXXXXXXXXXXXXXXXXXXXXXXXXXXXX-XX-[]XXXXXXXXXXXXXXXXXXXXXXXXXXXXXXXXXXXXXXXXXXXXXXXXXXXXXXXXXXXXXXXXXXX--XXXXXXXXXXXXXXXXXXXXXXXXXXXXXXXXXXXXXXXXXXXXXXXXXXXXXXXXXXXXXXXXXXX--XXXXXXXXXXXXXXXXXXX-XXXXXX---XXXXXXXXXX-XXXXXXXXXXXXXXXXXXXXXXXXXXXXXXXXXXXXXXXXXXXXXXXXXXXXXXXXXXXXXXXXXX----XXXXXXXXXXXXXXXXXXXXXXXXXXXXXXXXXXXXXXXXXXXXXXXXXXXX----XXXXXXXXXXXXXXXXXXXXXXXXX--XXXXXXXXXXXXXXXXXXXXXXXXXXXXXXXXXXXXXXXXXXXXXXXXXXXXX--X-XXXXXXXXXXXXXXXXXXXXXXXXXXX-XX-XXX--XXXXXXXXXXXXXXXXXXXXX-XXXXXXXXXXXXXXXXXXXXXXXXXXX--XXXXXXXXXXXXXXXXXXXXXXXXXXXXXXXXXXXXXXXXXXXXXXXXX----XXX-----X-XXXXXXX---XXXXXXXXXXXXXXXXXXXXXXXXX--------XXXXXXXXXXXXXXXXXXXXXXXXXXXXXX-XXXXXXXXXXXXXXXXX-XXXXX----XXXXXXXXXXXXXXXXXXXXXXXXXXXXXXXXXXXXXXXXXXXXXXXXXXXXXXXXXXXXXXXXXXXXXXXXXXXXXXXXXXXX-X-XXXXXXXXXXXX-XXXXXXXXXXXX--XXXXXXXXXXXXXXXXXXXXXXXXXXX--------------XXXXX--X--XXXXXXXXXXXXXXXX---XXXXXXXXXXXXX--XXXXXXXXXXX-XXXXXXXXXXXX-XXXXXXXXXXXXXXXXXXXXXXXXXXXXXXXXXXXXXXXXXXXXXXXX-XXXXXX--XXXXXXXXXXXXXXXXXXXXXXXXXXXXXXXXXXXXXXXXXXXXXXXXXXXXXXXXXXXXXXXXXXXXXXXXXXXXXXXXXXXX