------------------------------------------------------------------------------------------------------------------------------------------------------------------------------------------------------------------------------------------------------------------------------------------------------------------------------------------------------------------------------------------------------------------------------------------------------------------------------------------------------------------------------------------------------------------------------------------------------------------------------------------------------------------------------------------------------------------------------------------------------------------------------------------------------------------------------------------------------------------------------------------------------------------------------------------------------------------------------------------------------------------------------------------------------------------------------------------------------------------------------------------------------------------------------------------------------------------------------------------------------------------------------------------------------------------------------------------------------------------------------------------------------------------------------------------------------------------------------------------------------------------------------------------------------------------------
------------------------------------------------------------------------------------------------------------------------------------------------------------------------------------------------------------------------------------------------------------------------------------------------------------------------------------------------------------------------------------------------------------------------------------------------------------------------------------------------------------------------------------------------------------------------------------------------------------------------------------------------------------------------------------------------------------------------------------------------------------------------------------------------------------------------------------------------------------------------------------------------------------------------------------------------------------------------------------------------------------------------------------------------------------------------------------------------------------------------------------------------------------------------------------------------------------------------------------------------------------------------------------------------------------------------------------------------------------------------------------------------------------------------------------------------------------------------------------------------------------------------------------------------------------------------
------------------ooo------------S------------------------------------------------------------------------------------------------------------------------------------------------------------------------------------------------------------------------------------------------------SSSSSSSSSSSSSSSSSSSSSSSSSSSS--------------------------------------------------------SSSSSSSSSSSSSSSSSSSSSSSSSSSS----oo-------------------------------------------------S--------------------------------------------------------SSSSSSSSSSSSSSSSSSSSSSSSSSSS--------------------------------------------------------------------------------------------------------------------oo----------------------------------------------------------------------------------------------------------------------------------------------------------------------------------------------------------------------------------------------------------------------------------------------------------------------------------------------------------------------o---------------------------------------------------------------------------------------------------------------------------------------------------------------------------------------------------------------------------------------------------------------------------------------S--------------SSSSSSSSSSSSS---------------------------------o------------------------------------------------------------------------------------------------------------------------------------------------------------------
------------------XXXX--------------------------------------------------------------------------------------------------------------------------------------------------------S------------------------o--------------------------------------------------------------------------------SSSSSSSSSSSSSSSSSSS------------------------------------------------------------------SSS----------------------SS--------E--E----------------------------------?-------oS---------------------------------------------------------------------------------------------------------------------------------------------------------------------------------------------------------------E-------------------------------------------------------------------------------------------------------------------------------------------------------------------------------------------------------------------------------------------------------------------------------------------------------------------------------------------------------------------------------------------------------------------------------------------------------------------------------------------------------------------------------------------------------------------------------------------------------------------------------------------------------------------------SSSSSSSSSSS---------------------------------X-----------------------------------------------------------------------------------------------------------------------------------------------oo-----------------
---------E----------------------------------------------XX------------------------------------------------oooo------------------------------X-------------------------------------------------------------------------E---------E----E-------------------E------------------------------SSSSSSSSSSSSSSSSSSS------------------------------------------------------------------SSS-------------------------------XXXXXXX----------------------------------------ES----------------------------E--------?---------------------------------------------------------------------------------------------------------------------------------------------------------------------XXXXXXX-----------------------------------------------------------------------------------------------------------------------------------------------------------------------------------------------------------------------------------------------------------------------------------------------------------------------------------------------------------------------------------------------------------------------------------------------------------------------------------------------------------------------------------------------------------------------------------------------------------------------------------------------------------------------SSSSSSSSSSS--------------------------------------------------------XX--E------------------------------------------------------------------------------------------E----E------------------------------o--------
---------E--E------o------------S-------------------------------------------------E-----------------oo----XXXX---------------------SSSSS-------SQQS--------------SSSSS------------------------------?SSS-------------S?S-SSS--------SQS-SSS------------SSSSS-------------------SS-----ESSSSSSSSSSSSSSSSSSSS--QQE----o------------------?SSS------------------------E--------SS?---------oooooo------oSoo--SS--------------------------SSS-E-S--------S--SS--SSSS--SSS----------------?-S----Q---SQS-S??-------------------------------------S---------------SQQQ-----------------------------------------------------------SSSSS-------S-------SQ--------------------------------------------------------------------------------------------------SSS--------SSSS--------------------SS---Q-Q--Q--------------S------------------------------------------------------------------------------------SS--SSS----------------------------------------------------------SSSS----E-------SSSS?SSS------QS--QQSSS---------S?S--------------------------------------------------------------------------------S?SSS---?---------------------------------------------------------------SSSS-------------------------SSSSS---------S------------------------SSSSS------------------------------------------------SSS----------------SSSSSSS--------SSQS------SSSSSSSSSSSSSSS------------SSSSSSSS----------S------------------------S----E-----QQQS------------------SSS---------------------------S------------------------------------SQS-----SSSSS-----------XXX-------------o
--------------------------XX----------------------------------------E---------------------------------------------------------------------------------------------------------------------------------------------------------------------------------------------oooo--------------------------------------------------------------------------XXX------------------XXXXX--SS----------------------SS-------------------ooooo--------SSS<>-------------SS--SSS-----------------------------------------------------------------------------------------------------------------------------------------------------------------------------------------------------------------------o-------------------------------------------------------------------------------------------------------------------------------------o-----------------------------------------------------------------------------------------------------------------------------------------------<>-------------------------------------------------------------------------------------------------------------------------------------------------------------------------------------------------------------------------------------------------------------------------------------------oooo--------------------------------------------------------------S------------------------------------------------------------------------------------------------------------------------------------------------------------------------------------------------XXXXXXX-------------------XX
-------------------------XXX---------------------------------------<>--------------------------------------------------------------------------S--------------------------------------------------XX----------------------------------------------------------------------------S-------------------------------------------------------------------------------------------SS-----------SSSSSS---S-SS-S------------------------------SSS[]-------------SS--SSS-------------------------------------------------------------------------------------------------------------------o-------XX------------------------------------------XX----------------------------------------------------X----------------------------------------------------------------------------------------------S----S-S------------------------XXX-o-------------------------------------------------------------------------------------------------------------------------------------E------[]-----------------------------------------------------------------------------------------------------------ooo-----X------------------------------------------------------------------------------------------------------------o--------------------------------------------------------------------------------------------------------------------------S-S-----------------------------------------------------------------------E--------XX---------------------------------------------------------------------------------------------------------------------------------------XXX
---------------------------------------oo-----------------E--------[]-----------E-----------------------------------------------------------------------------------------------------------------XX------------------------------------------E-----------S-----E---------o-----S---------?-------------?E--------------o---------------------------------------------------SS----------SSS?-SS---SoSSoS---------------E--<>----------SSS[]-----------?-SS--SSS??---------------------------------------------------SS-------------oo-------------------------------------------------------------------------------------------------XX---------------------------------------------------XXX-----E--------------------------------------------SSSSSSSS-----------------------------oS----SoS--SoS---------S---------------------------oo---------------------------------E-------------------E----E-----------------------------------------------------XX---E------------[]---------S---------------------------------------o----o------------------------------------------------------------XX-ooo------------------E--<>---------E-------------------------------E---------------------oo--------------------------SSSQS---------------Q------SSS---------S------E--<>------------------o---------------------------------------------E------------o-----------------------------------------------E-----E--<>--------XX---------------------------------------------------------------------E-----S---------------E----------------------------------------------
-----XXXXX----XXXXX-----------S?S------------------------<>--------XXX---------<>-------------XXXX-----XXXXXXXXXQ--------E-----------------X--ESQS------------------S---S----E--------E----------XXX----------XX--X-------------QS--S?S------<>-----------S----<>-----<>--------E----SSS-S--S----------S??SS---S-----Q-Q---------------------------------------X------------SSSS---------S---SS---SSSSSS--------------<>--[]--------X--SS[]-SS----------S---SSSS-----E------QQQQ--Q--QQQQ---Q--ES?SQQ------------------------------------------------------QSSSSSS-----------------------------------------EQ--------------SQ-------XXXXQQ-----SS---------------XX--S--E------------------XXXX----<>-------Q----SSS---E-------------------------------------XXXX-SSS----------------S-SSQ--SSS--SSS--SS-----S---------------S---------------------------------------------<>---Q--QQQ------E--<>----XS--S?S-------<>-------------------------------------XXX--<>------QQ---SXX-----S-----E-----QQQ--QQQQ--QSQS-------QS----------------------------E------------------------------XXX------------X---------S-Q--Q----E--<>--[]--------<>----------------------XX------<>-------ESQS-------------------------S---------------------------------------------E--------E--<>--[]---------------E--------------SQ------------X--X-----------Xo---SS-----E-------SSSSSSSS?----------o-ES----------------------<>----<>--[]--------XX------Q?-SQSQQ---------------SQS------X-----------------------------<>---------------E----<>---E-E?QQ--QQQ------------------XXXXX--SS-----
---------------------------------------------------------[]--------------E-----[]---------------------------------------<>-----------------X--------------------------------<>------E<>--------EXXXX---------XXX--XX-----E-------------------[]-------E--------[]-----[]------E<>-------------------------SS----------------------------------------------E-------------------------EXX---------------SS--------------[]--[]-------------[]-------------------SS------------------------------------------------------------------------------------X-------------------------------XXXXX?-------------XXXXX-----------------------EXXXX-----------------------XXX----<>-----------E-----XXXXX----[]-----------------<>-----------------------E-------------------------------------S------------------------------XXXXXXX-----E--------------------------E------X--------[]--------------<>--[]------------------[]--E---E--X--------------------------XXXX--[]-----------------------------------------------------------------------------X----<>--------------------------------------------XX------------------<>--[]--[]--------[]----------------------XX------[]-----------------------E---------------------------------------------X-------------------E<>--[]--[]--------------<>---------------------------XX--X----------XX--E-------<>----------------------------E--E---E----------------[]----[]--[]--------XX-------------------------------------XX---X-------------------------[]--------------<>----[]---------------------------------------------X
------------------XXXX-----------------------------------[]-------------<>-----[]---------------------------XXXX--------[]-----X-----------X--------------------------------[]-----<>[]-------XXXXXX--------XXXX--XXX------------------------[]------<>--------[]-----[]-----<>[]-------------------------SS----------------------------------Eo---X----------E-------------------XXXXX--------------SSS------------<>[]--[]-------------[]--------------------S------------------------------------------------------------------------------------X------------------------------------------------------------------------------XXXXX----------------------XXXXX---[]----------<>----XXXXX-----[]-----------------[]----------------------<>-------------------------------------S-----------------------------------------<>-------------------------<>------X--------[]--------------[]--[]------------------[]-<>--<>--X-------------------------XXXXX--[]----------------------------------------------------------<>-----------------X----[]--------------------------------------------XX------------------[]--[]--[]--------[]---------------------XXX------[]----------------------------------------------------------------------------------------<>[]--[]--[]--------------[]-------------------------X-XX--XXX-------XXX----------[]----------------------------------------------------[]----[]--[]--------XX------------------------------------XXX---XX---------X--------------[]---------X----[]----[]------------------------------------XXX-----XX
-Sooo-----XXXX-------------------------------------------[]--------E----[]-E---[]--------------------------------E-EE---[]-E-E-X-E---------X-E--------------------E---------[]---E-[][]-------XXXXXXE-E----XXXXX--XXXX---------X---E---------[]------[]--------[]-----[]-----[][]----------------------oo-SS------------------------------------EE-X------------------------E-EE-XXXXXX-E------------E---E----------[][]--[]----------EE-XXX-------E------------------------------------E-EE----------------------E-E-EE---------------------E-----ES--------------------------E--------------------------------------------------XXXXXX--EE-E----------E-E--XXXXXX---[]----------[]---XXXXXX-----[]----E-------EE---[]----------------------[]---------XX---------------E----------------------------------EE-E--------------[]-------------------------[]------X--------[]-----------EE-[]--[]-------E----------[]-[]--[]--X------------------------XXXXX---[]------------------E-E--X---------E--E---E-EE--------EE----[]---------------E-X----[]-----------------------------o-------------XXXX------E----------[]--[]--[]--------[]----EE----EE---------XXX--E---[]----------------------------EE--E--E-----------------------------------X----------------[][]--[]--[]-------EE-E---[]-------------------EE----X-XX--XXXX--EE-XXXX---E------[]-E-------------------------------------------EE-E---[]----[]--[]--------XX---------E----------E-E-E----------XXXX---XX----EE-E-X-----------E--[]---------X----[]----[]-----------EE--------------XXXXXX----------XXX
--XX------------------------XXXXXXXXXXXXXXXXX----XXXXXXXXXXXXXXXXXXXXXXXXXXXXXXXXXXX----------------------------XXXXXXXXXXXXXXXXXXXXXXXXX--XXXXXXXXXXXXXX-XXXXXXXXXXXXXXXXXXXXXXXXXXXXXXXXXXXXXXXXX-XXXXXXXXXXXX--XoXQXXXXXXXXXXXXXXXXXXXXXXXXXXXXXXXXXXXXXXXXXXXXXXXXXXXXXXXXXXXXXXXXXXXXXXXXXXX-E-XXX---XX-XXXXXXXXXXXXXXXXXXXXXXX-----XX-----XXXXXXXXXXXXX-------XXXXXXXXXXXXXXXXXXXXXXXXXXXX-XXXXXXXXXXXXXXXXXXXXXXXXXXXXXXXXXXX-XXXXXXXXXXXXXXXXXXXXXXXXXXXXXXXXXXXXXXXXXXXXXXXXXXXXXXXXXXXXXXXXXXXXXX--XXXXXXXXXXXXXXXXXXXXXXXXXXXXXXXXXXXXXXXX---XXXXXXXXXXXXXXXXXXXXXXXX-XXX--------X--X--XXXX------XXXXXXXXXXXXXXXXXXXXXXXXXXXXXXXXXXXXXXXX---XXXXXXXXXXXXXXXXXXXXX-XXXXXXXXXXXXXXXX---XXXXXXXXXXXXXXXXXXXXXXXXXXXXXXXXXXXXXXXXXXXXXXXXXXXXXXXXXXX-------XXXXXXXXXXXX-XX-XXX-XXXXXXXXXXXXXXXXXXXXXXXXXXXX--------XXXXXXXXXXXXXX----XXXXXXXXXXXXXXXXXXXXXXX-XXXXXXXXXXXXXXXXXXXXXXXXXXXXX-XXXXXXXXXXXXXXXXXXXXXXXXXXXXXXXXXX----XXXXXX----XXXXXXXXX-XXXXXXXXXXXXX---XXXXXXXXXXXXXXXXXXXXXXXXXXXXXXXXXXXXXXXXXXXXXXXXXXXXXXXXXXXXXXXXXXXX--XXXXXXXX--XXXXXXXXX-----------XX-X--XXXXXXXXXXXX-XXX--XXXXXXXXXXXXXXXXXXXXXXXXXXXXXXXXXXXXXXXXXXXXXXXXXXXXXXXXXXXXXXXXXXXXXXXXXXXXXXXX---XX---XXXXXXXXXXXXXXXXXXXXXXXXXXXXXXXXXXXXXXXXXXXXXXXXXXXXXXXXXXXXXXXXXXXXX-XX--XXXXXXXXXXXXXXXXXXXXXXXXXXXXXXXXXXXXXXXXXXXXXXXXXXXXXXXXXXXXXXXXXXXXXXXXXXXXXXXXXXXXXXXXXXXX-XXXXXXXXXXXXXXXXXXXXXXXXXXXXXXXXXXXXXXXXXX-XXXXXXXXXXX---XXXXXXXXXXXXXXXXXXXXXXXXXXXXXXXXXXXXX---XXXXXXXXXXXXXXXXXXXXXXXXXXXXXXXXXXXXXXXXXXXXXXXXXXXXXXXXXXXXXXXXXXXXXXXXXXXXXX-----------XXXXXXX