------------------------------------------------------------------------------------------------------------------------------------------------------------------------------------------------------------------------------------------------------------------------------------------------------------------------------------------------------------------------------------------------------------------------------------------------------------------------------------------------------------------------------------------------------------------------------------------------------------------------------------------------------------------------------------------------------------------------------------------------------------------------------------------------------------------------------------------------------------------------------------------------------------------------------------------------------------------------------------------------------------------------------------------------------------------------------------------------------------------------------------------------------------------------------------------------------------------------------------------------------------------------------------------------------------------------------------------------------------------------------------------------------------------------------------------------------------------------------------------------------------------------------------------------------------------------
---------------------------------------------------------------------------------------------------------------------------------------------------------------------------------------------------------------------------------------------------------------------------------------------------------------------------------------------------------------------------------------------------------------------------------------------------------------------------------------------------------------------------------------------------------------------------------------------------SXX?-----------------------------------------------------------------------------------------------------------------------------------------------------------------------------------------------------------------------------------------------------------------------------------------------------------------------------------------------------------------------------------------------------------------------------------------------------------------------------------------------------------------------------------------------------------------------------------------------------------------------------------------------------------------------------------------------------------------------------------------------------------------------------------------------------------------------------------------------------------------------------------------------------------------------------------------------------------------
---------------------------------------------------------------------------------------------------------------------------------------------------------------oo-------SSSSSSSSSSSSSSSSSSSSS----------------------------------------------------oo-------------------------------------------------------------------------------------o--------------------------------------------------------------------------------------------------------------------------------------------------------------------------------------------------------------------------------------------SSSSSSSSSSSSS-SXX-S-ES------------------------------------------------------------------------------------------------------------------S-SS-------------------------------------------------------------------------------------------------------------------------------------------------------------------SSSSSSSSSSSSSSSSSSSSSSSSSSSS------------------------------------------------------------------------------------------------------------------------------------------------------------------------------------------------------------------------------------------------------------------------------------------------------------------------------------------------SSSSSSSSSSSSSSSSSSS?SSSSSSSS------------------------------------------------------------------------------------------------------------------------------------------------------------------------------------------------------------------------------------------------------------
------------------------------------------------------------------------------------------------------------------------o-------------------------------------XXXX---------------------------------------------------------------------------------------------------------------------------------------------------------------------XXX-----------------------------------------------------------------------------------------------------------------?-o-------------------------------------------------------------------------------------------------------------------------------------SS--SSSS-----------------------------------------------------------------------------------------------------------------------------------------------------------------------------------o-----------------------------------------------------------------------------------------------------SSSSSSSSSSSSSSSSSSSSSSSSSSSS--------------------X-----------------------------------------------------------------------------------------------------------------------------------------------------------------------------------------------------------------------------------------------------------------------------------------------------------------------------------------------SSSS----------------------------------------------------------------------------------------------------------------------------------------------------------------------------------------------------------------------------------------------------------------
--------oo--oo----------------------------------------------------------------------------------------------------------------------------oo---------E-----------------------------------------XXX-------------------------------------Eooo----------------------------------------------------------------------------------------------------------------------------------------------------------------------------------------------------ooooooo-ooo----------------------------------------------------------------------------------------------------------------------------------------ESS--SSSS----------------oo-------------------------------------------------------------------------------------------------------------E---EE-------------------------------------------------------oo-------------------------------------------------------------------------------------------SSSSSSSSSSSSSSSSSSSSSSSSSSSS---------------------------------------------------------------------------------------------------------------------------oo--oo--oo-----------------------------------------------------------------------oo-------------------------------------------------------------------------------------------------------------------------------------------------------SSS------------------------------------E---------------------------------------------------------------------------------------------------------------------------------------------------------------------------------------------------------------------------
----------------------SSSS--o---------------------------S------------------------------------------------------------o----XX------oo-----------SS---SQS--------XXX---------------------------------------------------------------------XXXXX----------------SS-----------------------------------------------------------------SSS-SSSSSSS--------------------------------------------SQQS----------------SSQQ-SS----------------------------------------------E------o-----------------------------SSS-------E---------Q----------------------------S---------------SSSSSSSSSSS-------------------SS---SS-----------------------------------------------SSSSSSS---------S----------XXX-----SSSSSSS----SSSS------oo----------QQQQS------SSSSSSSSSSSSS---------------------SSS?S-------S-------XXXX---------------------------------------------------------S-----------?---?----------------SSSSS---SSSSSSSSSSSSSSSSSSSSSSSSSSSSSSSS-SSSS------------oo--------------SSSS------------------------------------SSSS---------------------XX------------------------------------------SQ-----------------------------------------SSSS----------XXXX--------------------------?SSSS----o-------------------------------------------------------XXX------------------------XX-----SSQQ-SQQQQ---------------SSSS-----------------------XXX--------SES----QQQS-------------------S-----SSS---SS-------------------------------------SSS----S-------------SSSSSSS-S--------------XX------------SS--SQQQ---------------------SSS---------------------------------------SSSSSSS----
--------------------o-------------------------S--------------------------------------------------------------------XXX------------------------------------------XX---------------------------------------------------------------------------------------------------------------------------------------------------------------------------------------------------------------------------------------------S---------------------------------------------E-E---------------------------------------------<>------------------------------------------------------------------------------------SS---SS-------------------------XX------------------------------------------------XX---------------------------------XXXX----------------------------------------------------------XXX----------------------------------------ooo----------------------------------------------------------------------------------------------------------X-----------------------------------------------------------------------------o-----o----------------------------------------o-------------------------------------------------------------------------------------------------------------------E-------------------------------------o---XXXX------------------------XX-------------------------------------o-----------------------------------------------------------------------------------------------------------------------------------------------------------XX---------------------------oo-----------------------------------------------------------------
---------------------------------------------------------------------------------------------oo----------------------------------------------------------------XXX-----------------------------------XXX-----------o--------------------------------o------------------------------------------------------------------------------------------------------------------------------------------------------------------------------------------------------XXXXX---------------------------------------------[]------------------------------------------------------------------------------------SS---SS------------------------------------------------------------------------XXXXX--------------------------------------------------------------------------------------------------------------------------------------------E-------------------<>-----------------------------------------------------------------------------------------------------------------------------------------------------------------------------XXX------------------------------XXXXX----------------------------------------------------------------------------------------------------------------XXXXXXXX-----XX-XXX-------------------------EXXXX------------------------XX----------S--E----------------S----------------XX----------------XX----------------------------------------------------------------------------------------------------------------o-----------X-XX---------------------------------------S-S----------------------------------------------------
XX---------------E----SSSSSSX---------------XX---Q------------------------------------------------------o------------------------------------------------------XXX---------------------------E------------------------------ooo-------------------S-SQ------E---------------------E-----SSSSSSS------------------------------------------------X------SS----------------------------------------------------------------------------SSSSSS----------------------------X--------------------------------------[-------E-----------S-S----------------------------oo-------------------------------?-SS---SS??-------------------------------------------------------------------EXX-XXXX--------------E---------------------------------------------E------oo-----ooo----------------QSSSSS-----------------------SSSSS---------E--<>----------E--------[]-----------E------------------------------------------------------------------------------------------E-----------------------------------------------------------------------X---oo---S-------------------------------------------------------S--------------E-----SSSSSS------------------------------------------------XXX--------------oo-------------XXS-S---------------XXXXXX------------------------XX-------------------------oo-?-SSS--------------------------------S------------------------E------------------------------------------------------------------------------------------------E----XXX---------------------------------E-------SoS--------------------------------E-----------------
S--E------------<>-----------------------XXXXX-------------------S----------------------SSSSSS?S----S-------------------------XXX----------------XX-------------XX--------------------------<>---QQ----------------------------------XXXX-------XX----------QS-------------------<>-----------------S----X-------------QQQQ-------------------XX------------------------------<>---QQ?SSQS--------E--<>---ESS--QQ------Q------------------------------------------------XXX-----------------------Q--S-SS-----------<>-XS------E-------------------E----------E------S----X---XX-------------------SS---SSS?-------oo--XXX---------------------------------------------QQQQ----XXX-XXXX-------------XXX---XXXXXX---XXX-------?SSQS-------------SSSSSSS------------------XXXX--SS------------------XXX-------------------------<>--[]---------<>--------XXS---------<>----o-o--------------------------SSSSSSSSSSSSSSSSSSSSSSSSSS---S?S-Qo-------XXXXX--XXXX---<>----------E------------X---------E------Q-----------o----------------XXX------------------------------------------S?S----------------------E-----E----<>-----------------XX------------------------E?QQ-QSQQ--------------------------------------XXX------------------XXXXXX--------------------XX--XX-----------SSS------------SS--SSS----SX--------------------------S--QQ--QQ?SSQSQ---------<>-----QQQ-----E--S-------------QQ-------------S------------QQ--SSSS---------Q----oo----SS-------<>-X-XXXX------------QQ--SQSS-----E---E--<>-------SSS--------------E----------------<>-----SS----XX--XX
--<>---E--------[]---------------E------XXXXXX----------------------E-------------------SSSSS-------------------------------------------------------------------XX--------------------------[]--------------------------------------------------XX-------------------------------[]--------------------E-------------------------------------XXX----E---------------------XX--[]-----------------<>--[]----------------------------------------------------------------------------------------------------------X--[]------X-<>----------------XXXX---------<>--------E--E----X---------XX-----------E-------------------------------------------XX-------------------------EXXXX-XXXX----------------------------------------------------------------X----------------------------------------------------------------------[]--[]---------[]--------------------[]-------------XX------------------SSSSSSSSSSSSSSSSS---------------------------------------[]---------<>-----------XX--------<>-----------------------------------XXX------------------------------------X-------------E---------------<>----<>----[]-----------------------------------------------------------------------------------------XXXX--------------E-XXXXXXXX-------------------XXX--XX--------X----------XX--------------------------------------------S-----------------------[]------------<>---------------------------E------E----------------------------------------------[]-XXXXXX---E--------------------<>--<>--[]-----------------------<>-------------X--[]--------E--X---XX
--[]---E--------[]---------------------XXXXXXX---------X-----------<>-------------------SSSSS-----------------------------------------------------------E-------XX--------------------------[]-------------------------------------------------XXX-------------------------------[]-------------------<>-----S------------------------------XXXX---<>--------------------XXXSS[]-----------------[]--[]------------------------------------------------XXX----o----------------------------------------------<>-----[]------X-[]-----------------------------[]----------------X--------XXXXX----------------------------------------------------XXXX--XX-------------------XXXXXX-XXXXX--------------S--------------------------------X---------------X-----------------------------------------------X----------------------[]--[]---------[]--------------------[]------------XXX---XXX----------ooSSSSSSSSSSSS-SSSS---------------------------------------[]---------[]----------XXX--------[]----------------------------<>-----XXX------------------------------------X-----------------------------[]----[]----[]----------------------------------------------------------------------------------------XXXXX-------------<>-XXXXXXXX-----------------XXXXX--XX--------X---------XXX--------------------XXXX--------------------S-----------------------[]------------[]--------------------------<>-----<>----------------------------------------------[]-XXXXX-------------------------[]--[]--[]-----------------------[]------------XX--[]-----------XX--XX
--[]--------E---[]--------------------XXXXXXXX--------XX-----------[]------------------------oo---------------EE----ooo----------------------------------------XXX--------------------------[]-E--E-------------------------------oo---------XXXXX---S---------E-------E--EE-E---[]-------------------[]-----S-----------------------------XXXXX---[]--------------------XXXSS[]-E-EE-------E----[]--[]-----------------------EE-----------------------SS-------------o--------------------------------------[]-----[]----X-X-[]-----------------------E-----[]----------------XE--E---XXXXXE---------------------------------------------------XXXXXE-XX-X-----E-----E-E--XXXXXXX-XXXXX-----------------------------------------------X-E-------------X----------XXXX---------------------------------X------X-----------EE--[]--[]---------[]----EE-E--------E---[]-----------XXXXE--XXX----------SSSSSSSSSSSSSSoSSSS---------------------------------------[]---------[]---------XXXX-E-EE---[]------------------E---------[]-----XXX-------X----------------------EE----X-----------------------------[]----[]----[]------------------------------------------------------------------------------------E--XXXXXX-------------[]XXXXXXXXX------X---------XXXXXX--XX----EE--X-E------XXXX--------------------------------------------S-----------------------[]-E---E------[]-E----------E-------------[]-----[]-----E---E--E------------------------E--------[]-XXXXXS----------------EE------[]--[]--[]-----------------------[]------EE-----X--[]-----------XX--XX
XXXXXXXXXXXXXXXXXXXXXXXXXXXXXXXXXXXXXXXXXXXXXXXXXXXXXXXX---XXXXXXXXXXXXXXXXXXXXXXX-----XXXXXXXXX--X-XXX---XXXXXX----XXX-X-XXXXX----------XXXXXXX----XXXXXXXXXX-XXXXXXXXXXXXXXXXXXX--XXXXXXXXXXXXXXXX---XXXXXXXXXXXXXXXX-XXXXX--X--XXX---X-XXXXXXXX------XXXXXXXXXXXXXXXXXXXXXXXXXXXXXXXXXXXXXXXXXXXXXXXXXXX-XXXXXXXXXXXXXXXXXXXXXX-XXXXXXXXXXXXXXXXXXXXXXXX----XXXXXXXXXXXX-XXXXXXXXXXXXXXXXXXXXXXXXXXXXXXXXXXXXXXXXXXXXXXXXXXXXXXXXXXXXXXX-X----XXXX--E----SXXX----XXX---------XXXXXXXXXX--XXXXXXXXXXXXXXXXXXXXXXXXXXX-XXXXXXXXXXXXXXXXXXXXXXXX---XXXXXXXXXXXXXXXXXXXXXXXXXXXXXXXXXXXXXXXXXXXXXXXXXXXXXXXXXXXXXXXXXXXXXXXXXXX------XXXXXXXXXXXXXXXXXXXXXXXXXXXXXX--XXXXXXXXXXXXXEoXXXXXXXXXXXXX-------------------------XXXXXXXXXXXXXXXXXXXXXXXXXXXX--XXXXXXXXXX-------------------XXXXXXXXXXXXXX-----XXXXXXXXXXXXXXXXXXXXXXXXXXXXXXXXXXXXXXXXXXXXXXXXXXXXXXXXXXXXXXXXXXXXXXXXXXXXXXXXXXXXXXXXXXXXXXXXXXXXXXXXXXXXXXXX--XXXXXXX--XXXXXXXXX-----------------XXXXXXXXXXXXXXXXXXXXXXXXXXXXXXXXXXXXXXXXXXXXXXXXXXXXXXXXXXXXXXXXXXXXXXXXXXXXXXXXXXXXXXXXXXXXXXXXXXXX--XXXXXXXXXXX-XXXXXXXXXXXX-XX----XXXXXXXXXXXXXXXXXXXXXXXXXXXXXXXX--XXXXX----XXXXXXXXXXXXXXXXXXXXXXXXXXXXXXXX----------XXX---XXXXXXX-----XXXXXXXXXXXXX--XXXXX--XXXXXXXXXXXXXXXXXXXXXXXXXXXXXXXXXXXXXXXXXXXXXXXXXXXXXXXXXXXXXXXXXXXXXXXXXXXXXX------------XXXX--------XXXXSXXXXXXXXXXXXXXXXXXXXXXXXXXXXXXXXXXXXXXXXXXXXXXXXXXXXXX-XXXXXXXXXXXXXXXXXXXXXXXXXXXXXXXXXXXXXXXXXXXXXXXXXXXXXXXXXXXXXXXXXXXXXXXXXXXXXXXXXXXXXXXXXXXXXXXXXXXXXXXXXXXXX-XXXXXXXXXXXXXXXXXXXXXXXXXXXXXXXXXXXXXXXXXXXXXXXXXXXXXXX-XX