------------------------------------------------------------------------------------------------------------------------------------------------------------------------------------------------------------------------------------------------------------------------------------------------------------------------------------------------------------------------------------------------------------------------------------------------------------------------------------------------------------------------------------------------------------------------------------------------------------------------------------------------------------------------------------------------------------------------------------------------------------------------------------------------------------------------------------------------------------------------------------------------------------------------------------------------------------------------------------------------------------------------------------------------------------------------------------------------------------------------------------------------------------------------------------------------------------------------------------------------------------------------------------------------------------------------------------------------------------------------------------------------------------------------------------------------------------------------------------------------------------------------------------------------------------------------
---------------------------------------------------------------------------------------------------------------------------------------------------------------------------------------------------------------------------------------------------------------------------------------------------------------------------------------------------------------------------------------------------------------------------------------S--------------------------------------------------------------------------------------------------------------------------------------------------------------------------------------------------------------------------------------------------------------------------------------------------------------------------------------------------------------------------------------------------------------------------------------------------------------------------------------------------------------------------------------------------------------------------------------------------------------------------------------------------------------------------------------------------------------------------------------------------------------------------------------------------------------------------------------------------------------------------------------------------------------------------------------------------------------------------------------------------------------------------------------------------------------------------------------------------------------------------------
---------------------------------------------------------------------------------------------------------------------------------------------------------------------------------------------------------------------------------------------------------------------------------------------------------------------------------------------------------------------------------------------------------------------------------------S---X----------------------------------------------------------------------------------------------------------------------------------------------------------------------------------------------------------------------------------------------------SSSSSSSSSSSSSSSSSSSSSSSSSSSS------------------------------------------------------------------------------------------------------------------------------------------------------------------------------------------------------------------------------------------------------------------------------------------------------------------------------------------------------------------------------------------------------------------------------------------------------------------------------------------------------------------------SSSSSSSSSSSSSSSSSSSSSSSSSSSS----------------------------SSSSSSS---------SSSSSSSSSSSS----------------------------SSSSSSSSSSSSSSSSSSSSSSSSSSSS------------------------------------------------------------------------------------------------------------------------------------------------oo----------------------
--------------------------------------------------------------------------------------------------------------------------------------------------------------------------------------------------------------------------------------------------------------------------------------------------------------------------------------------------------------------------------------------------------------------------------------oS---------------------------------------------------------------------------------------------------------------------------------------------------------------------------------------------------------------------------------------------------o---------------------------------------------------------------------------------------------------------------------------------------------------------------------------------------------------------------------------------------------------------------------------------------------------------------------------------------------------------ooo----------------------------------------------------------------------------------------------------------------------------------------------------------------------------------------------------------SSSSSSSSSSSSSS---------------------------------------------SSSSSSSSSSS----------------------------SSSSSSSSSSSSSSSSSSS---------------------------------------------------------------------------------------------------------------------------------------------------------------------------------
----------------------------oo--------------------E--------------------------------------------------------------------------------------------------------oo-------------------------------------------------------------------------------------------------------------------------------------------------------------------------------------------------------------------------------------------------------------------------S---------------------------------oo---o---------------------------------------------------------------------------------------------------------------------------------------------------------------------E-------------------------------------------------------------------------------------E------------------------------E------------------------------------------------------------------------------------------------------------------------------------------------------------------------------------E-oo---------------------------------------------------------------------------------------------------------oo--------------------E-------------------------------------------------------------------------------------------------------------oooo------------------------------------------------SSSSSSSSSSSSSS----------------------------X----------------SSSSSSSSSSS----------------------------SSSSSSSSSSSSSSSSSSS--------------E----------------------------------------------------------------------------------------------------------------------------------------------oo--Xo--------------
-----------------------XX-------------------------E--E----------------SSQS--------------SSSSS-------S---------------------------------------------------XX------oX---------?--------------?SSSSS-----SSSS-S----SSS-------------------------------------------------------------XX----------?--------------------------------------------------------S--------------X----------SS--SQ---------------------------------------------SSS-S----SS-------------SSS------------------------------------------?SSS-------------------SSSSSS-----------------SSQSQ--Q----SSS-SSSSS-------------------------------------------------------------------------SQS----S-----------SS---SS-------------SSS---S--oE-----------------------------------SSSSSSSS-----------SSSSS-------SSQSSS-----SSS------S------------------------SS----SSSSS--------------QSSSS------SSS----SS---SSSSSSSSSS---?-----------?---------------------QQSQS--------------------SSSS-SSS----------XXXXX----------------------S?SSS---?----------------------S-----SSSS-----------------SSS---XXX-----------------SSSSS---?-----------QQQQQ-------------SXX-oo--------------------------------------------S-SSSSS-------E---------------------------XXXX------------SS-------------------X-----------------SSSSSSSSSSS-----------------------SSSS----SSS--------SSSSSSSSSSSSSS------S-----------------SS--SSSSSSSSSSSSSSSSSSS--QQQQ-------SQS-------------------------------------------------E------------------------------------------------SSSS-----QS------------SSS--------So--?------------------------
-----------------------XX---------------------------XXX-------------------------------------------------------------------------------------ooX--------------------------------------------------------------------------------------------------------------------------------XX-------------Q-------------------------------------------------------------------SXX----------------------------o----------------------------------ES----SS-------------------------------------oooo---------------------------------------E---------------------------------------------------------------------------------------------------------------------------------------ES----SS-------------------------------------------------------------------------------------------------------------------------------------------------------------------------------------------------------------------XXXX----------------------------------------------------------------------------------ooo-----------------------------------------------------------------------------------------------------------------------------------------------------------------------------------------<>---------------------------------------------------------------XX------------------------------------------------------------------------------------------------------------ES-----------------------------------------------------------------------------------------XXXX----------------------------------------------------------------------------------------------ooooo------
----------------------XXX------------------------------------------------------------------------------------------------------------------------------------------------------------------------------------------------------------------------------------------------------XX------------------------------------------------------------------------------XXXXXX--------------------------E-------------------------------------S------------------------------------------------------------------------------------X--------------------------------------------------------------------------------------------------------------------------------------------------------------------X----XSS--o-----------------------------------------------------------Q------------------------------------X----o-----------------------------------------------------------------------------------------------------------E-----------------------------------------------------------------------------------------------------------------------------------------------------------------------------------------------------oo---------------------------XS-----------------[]---------------------------------------------------------------XX-----------------------------------------------------------S---------E--------------------------------------SS----------------------------------------------------------------------------oo-------------------------------------------------------------------------S----------------------------------------------
---------------------XXXX------------XXX---------------------------------------------------------E----------------------------E--S---------------------------------------------------------------------------------------S-------------------------------------------------XX---X------------------------------ooo---------------------------------------------XXXS-SQ------------------------<>------------------------------------SS----SS-------E--S--SS---EXXXX------------E-----SSSSS---------------------------E---XX---------------oooo-------------------------------------------------E--S-S----E---------------------------E-----E------------------------------SS------------------XX---XXX--oo--------------------------------------------E----E----E-E-E------------------------------------XXX----SSSSS-----------------------------------------------------S-----------------------------------------------<>-------------------------------X------------XX-------------------------------------------SSSSS----------------------SSSS---------------X-X--------?-----------------------------------------------------------S------------------XXX-----------------]-----------------------------------------------------------------X----------------ooo--------------------------------------E--E---------?-------------------------------------SS----?-------------?E--------------------------------E-----oo---oo-----------------------------------------------E----SQS--------------SS-------------SoS-------------E--o-X---oo---------E------------
---------------------XXXX---------------------XXXX---------------------QQQ--------XX------SSSSSSSSSS---QQQ-------------------<>-----E--S--------------------XXXXX-XXX---QooQ-------XXX-XX------------QQQ--QQQ------------------------------Q----------------ooo-----------XXX--XX------------------------X-----------X----S---------E-------Q--------?S-------EXXX------------Q---SQQ---------[]------------------<>---S-------------SSS--SS------<>---------XXX--------------<>------------------------------------<>--XXX-------SS----E--------XX-??QQQ--QQQ--Q--QQ---------E-Q-------Q-----<>--------<>-----------------E--------<>----<>-----------Q-Q------------S---SS--S--------------XXX--XXXX-------------------E------QQQ-----XX-XX--------<>-SSSSSSSSSSSSSSSSQQQ--S?SSS-S--------------------XXXX-SS----------Q------------------QS--SQS--------------SSSSS----------Q--S----XXX------------------ESQQQQQ------[]---S---------<>--------S------XXX----XXXX-----------XX-----------E---------QQQQ--QQQ-------------SSSS-------------------------XXS------------------SSS--SSSSS----QQ?--QQQ------------SQS----XXX--SSS----QQ----------------------XXX-----QQQ----SS--------------------XXXX-----XXX-------------Q---SSS------E------X--XXX---------------SSSSS----SSSS-----E------------------------ESSS--------?SSSSSSSSSSS-------SS--------S--------SS---?SSSS---SSSSSSS??SS--QQQ-------S?S-------E------<>---EX------------------------------------XX----------E----<>-----------------------------?SQQQ--SSS------------<>-------o--o-------<>------------
-------------------XXXXXX--------------------------------------------------------XXX------SSSSSSSSSSS------------------------[]----<>---------------------------------------------XXXX-XX--------------------------------------------------------------------------------XXXX--XX------------------E--E--X--XX-------X------E------<>------------------------XXXXX-------------------------E--[]------------------[]------E-----------------------[]--------XX-X--------------[]---------------------------E--------[]--XXX-----E------<>-------E----------------------------<>---------------[]--E-----[]----------------<>--------[]----[]------------------------------------------------XXXX-XXXXX--------------------------------EXX--XX--------[]-SSSSSSSSSSSSSSSS-------------------------------XXXXX------------------------------------------------------------------------------------------<>------------------[]-------------[]-------------X<]-----------------------------------------------------------------------E------X--------------------------------------SS-----SSS----S-----------------------------------------E------------------XXXX------------------X----------------------o------------------------------E------XX-XXX-----X---------------------------------------------------EE------------------------------------E------E-------------SS----SSSSS---SS---------------------<>------[]---EX----------------XX-----------------------------<>----[]---------------<>--------------------------------E-[]--XX--------------[]---------X--
-------------------XXXXXX---XXXXXXXX-------------------------------------------XXXXX--S----SSSSSSSSSS------------------------[]----[]--------------------------------------------XXXXX-XXX---------X-----------------------------------------------------------------EXXXXXXX--XXX----------------<>-XXX-X--XXX------X-------------[]-----------------------XXXXXX------------------------<>--[]------------------[]-----<>-----------------------[]----<>-XXX-X------------<>[]--------------------------<>--------[]--XXX------------[]------<>----------------------------[]---------------[]-<>-----[]----------------[]--------[]----[]-----------------------------------------------XXXXXXXXXXX---SS---------------X-----------XXX--XXX-------[]-SSSSSSSSSSSSSSSS------------E-----------------XXXXXX--S---------------------------------------------------------------------------------------[]------------------[]-------------[]-------------X[]XXX------------------------------------------------------------------------------------------------------------------SS-----SSS----S----------------------------------------<>-----------------XXXXX------------------X---------------------XXXX---------------------------<>-----XXX-XXX-----XX--X---------------------------------------------------E---XXX--------------------------<>-----<>-------------SS----SSSSS---SS---------------------[]------[]--XXX---------------XXX-------XXX-------------------[]----[]---------------[]----------o-----------------------[]--XQ--------------[]---------X--
-------------------XXXXXX------------------------------------------------------XXXXX---------SSSSSSSS------E-EE----EE-E---E--[]----[]-E---E----------------o--------------------XXXXX--XXXX-------XX----------------------E-EE-E-----E----------------E-E-E-E--------XXXXXXXX--XXX-EE-XX----------[]-XXX-X--XXXX-----X-----E-------[]-----------------------XXXXXX---------X------------E-[]--[]-----------E-EE---[]-----[]-----E-E-E----------E--[]----[]-XXX-X------------[][]---------------E-----E----[]-----E--[]-EXXX------------[]------[]----------------------------[]---------------[]-[]--E--[]---E-E--------E-[]--------[]-E--[]-----------------------------------E-----E----XXXXXXXXXXXX------------E-EE----XE----E----XXXX--XXXX--EE--[]-SSSSSSSSSSSSSSSS------------------E-E-----E--XXXXXXX--S----------------------EE-E----------------E------------------------------------EE------[]------------E-E---[]------EE-E---[]-E-EE-------XX[]X-----------------------------E-------------------E-----------------------------------ooo---------------------------------------oo------------------------------------XX?---[]----------------XXXXXX------------------X------E-----------XXXX--------------------E-EE-E----[]---XXXXX-XXX-----XX-------------EE-------E--------------------E-EE------------XX-E-----------------E------[]-----[]-----E------------SE----ooSSS-----------EE--------[]------[]---XX--------------XXXX-----------------------------[]E---[]---------------[]---SSSSS-------------------E--E---[]--XS-----------E--[]-----X---X--
XXXXX--X-XXX---XXXXXXXXXXXXX------------------------XXXXXXXXXXXXXXXXXXXXXXXXXXXXXXX-XXXXXX-XXXXXXXXXX--XXXXXXXXXXXXXXXXXXXXXXXXXXXXXXXXXXXXX------XXX-------------------XXXXXXXXXXXXX--XXXXXXXXXXXXXXXXXXXXXXXXXXXXXXXXXXXXXXXXXXXXXXXXXXXXXXXXXXXXXXXXXXXXXXXXXXXXXXXXXXXXX---XXXXXXXXXXXXXXXXXXXXXXXXXXXXXXXXXXXXXXXXXXXXXXXXXXXXXXXXXXXXXXXX-XXXXXXXXXXXXXXXXXX-----XXXXXXXXXXXXXXXXXXXXXXXXXXXXXXXXXXXXXXXXXXXXXXXXXXXXXXXXXXXXXXXXXXXXXXXXXXXXXXXXXXXXXXXXXXXXXXXXXXXXXXXXXXXXXXXX-XXXXXXXXXXXXXXXXXXXXXXXXXXXXXXXXXX--XXXXXXXXXXXXXXXXXXXXXXX-XXXXXXXXXXXXXXXXXXXXXXXXXXXXXXXXXXXXXXXXXXXXXXXXXXXXXXXXXXXXXXXXXXXXXXXXXXXXXXXXXXXXXXXXXXXXXXXXXXXXXXXXXXXXXXXXXXXXXXXXXXXXXXXXXXXXXXXXXXXXXXXXX------XXXXXXXXXXXXXXXXXXXXXXXXXXXXXX--XXXXXXXXXXXXXXXXXXXXXXXXXXXXXXXXXXXXXXXXXXXXXXXXXXXXXXXXXXXXXXXX--XXXXXXXXXXXXXXX-XXXXXXXXXXXXXXXXXXXXXXXXXXXXXXXXXXXXXXXXX--XXXXXXXXXX-X-------XXXXXXXXXXXXXXXXXXXXXXXXXXXXXXXXXXXXX-XXXXXXXXXXXXXXXXXXXXXXXXXXX-------------------------XXXXXXXXXXXXXXXXXXXXXXXXXXXX---XXXXXXXXXXXXXX--XXXXXXXXXXXXXXXX--------X---XXXXX---XXXXXXXXXXXXXXXXXXXXXXX--XXXXX----XXXXXXXXXX-----------X----XXXXXXXXXXXX---XXXXXXXXXXXX-XXXXXXXXXXXXXXX--XXXXXXXXXXXXXXXX---------------------XXXXXXXXXXXXXXXXXXXXXXXXXXXXXXXXXXXXXXXX-XXXXXXXXXXXXXXXXXXXXXXXXXXXXXXXXXXXXXXXXXXXXXX-XXXXXXXXXXXXXXXXXXXXXXXXXXXXXXXXXXXXXXXXXXXXXXXXXXXXXXXXXXXXXXXXXXXXXXXXX--XXXX---XXXXXXXXXXXXXXXXXXXXXXXXXXXXXXXXX---XXXXXXXXX-----X---------XXXXX-XX-X---XXXXXXXXXXXXXXXXXXXXXXXXXXXX--X---SXX-XXXXXXXXXXXXXXXXXXXXX--XXX-XXXXXXXXXXXXXXXXXXXXXXXXXXXXSX