------------------------------------------------------------------------------------------------------------------------------------------------------------------------------------------------------------------------------------------------------------------------------------------------------------------------------------------------------------------------------------------------------------------------------------------------------------------------------------------------------------------------------------------------------------------------------------------------------------------------------------------------------------------------------------------------------------------------------------------------------------------------------------------------------------------------------------------------------------------------------------------------------------------------------------------------------------------------------------------------------------------------------------------------------------------------------------------------------------------------------------------------------------------------------------------------------------------------------------------------------------------------------------------------------------------------------------------------------------------------------------------------------------------------------------------------------------------------------------------------------------------------------------------------------------------------
---------------------------------------------------------------------------------------------------------------------------------------------------------------------------------------------------------------------------------------------------------------------------------------------------------------------------------------------------------------------------------------------------------------------------------------------------------------------------------------------------------------------------------------------------------------------------------------------------------------------------------------------------------------------------------------------------------------------------------------------------------------------------------------------------------------------------------------------------------------------------------------------------------------------------------------------------------------------------------------------------------------------------------------------------------------------------------------------------------------------------------------------------------------------------------------------------------------------------S--------------------------------------------------------------------------------------------------------------------------------------------------------------------------------------------------------------------------------------------------------------------------------------------------------------------------------------------
--------------------------------------------------------SSSSSSSSSSSSSS--SSSSSSSSSSSS----oo----------------------------------------------------------------------------------------------------------------------------------------------------------------------------------------------oo-----------------------------------------------------------------------------------S-S------S-E---S--------------------------------------------------------------------------------------------------------------------------------------------------------------------------------------------------------------------------------------------------------------------------------------------------------------------------------------------------------------------------------------------------------------------------------------------------------------------------------------------------------------------------------------------------------------------------------------------------------------------------------------------------------------------------------------------------------------------------------------------oo-------------------------------------------------------------------------------SS-------------------------------------------------------------------------------------------------------------------------------------------------S-----SS-----------------------------------------------------------------------------------------------------------------------------------------------------------------------------------
------------------------------------------------------------------------SSSSSSSSSSSS--------EE-E--------------------------------------------------------------------------------------------------------------------------------------------------------------------o-----------------------E--E-----------------------------?--------?----o--oS------------------------------SS-----Q------SS?---?---oS--------------------------------?-----E--E----------------------------------------------------------------------------------------------------------------------------------------------------------------------------------------------------------------------------------------------------------------------------------------------------------o---------------------------------------------------------------------------------------------------------------------------------------------------------------------------------------------------------------------------------------------------------------------------------------o----------------------------------------------------------------------------------------E--EE------------------------------------------------------------------------SS-----Q--------?----o-------------------------------------------------------------------------------------------------------------------------o---------------S----SS------------------------------------------------------------------------------------------------------------------------------------------------------------------------
------------------------------------------------------------------------SSSSSSSSSSSS-------XXXXXXX------------------------------------------E----------------------------------------------------------------------------------------ooo----------------------------------------------------XXX-oo--oo-----------------------------------------S------------------------------SS--E----------S---------S-------------------------------------XXXXXXX-------------------------------------------------------------------------------------------------------------------------------------------------------------------------------------------------------------------------------------------------------------------------------------------------------------------------------------------o---oo---------------------------------------------------------------------------------------------------------------------------------------------------------------------------------------------------------------------------------------------------------------------------------------------------E----------------------------------XXXXXXXXX----------------------------------------------------------------------SS----------------------------------------------------------------------------------------oo------------------------------------------------------------------------SS---------------------XXXX---------------------------------------oo----------------oo-----------E-----------------------Eoo----------------------------------------------
--------------------?--------------------------------------------------SSSSSSSSSSSSS------------------------------------------------XX------S---SQS------------------------------------------------------S-----------SSSSSSSS-------XXXXX-----E----------------------XXX----------------o---------------------SS-----S-?-------------S---SSS---S----------------------------SS----SS---------S--SS-----S----------------------------XX------------------------------------?SSS------------------------------------------------------------------SSSS-----------------------------?SSS---------SSSSSSS----------------------------SSS----SS-?-----------------------------------------------------------------------------SSS---------------------------S--SSS------------------------------------------E-----------------------------XX-----------------------------------------------------------------------------------------------------------SSS---------------------------QQQQQQ------------------------------------------SS---SSSSSS-----Q?SSS------SSS---SSSSSSS----------S--------------------------QS----SSS--XX--------------------------------------------------SSSS-----------------------------------------S----SS-------------SSS---S---SSS-----SS---------QQQ------------------------SSSSSS-o----------------------------------------------------------SQQ--------------SSSSS-----------------------------------------------------------oo----------------oo------------------SQS--SQSS--------S--------XXXX------E-------------------------------------
-------------------------------o---o----o------------------------------------------------------------ooo---------------------------XXXX-----S--------------------------------------------------------------------------------------------------------------------X--------------------------------------------------ES-------------------SS---------------------------------SS----SS------------SS----------------------XS----------------E--------------oooo--------------------------------------------------------------------------------------------------------------------------------------------------------------------S------------Qooo--------------------------------------oo------------------------------------------------------------------------------XSSS---------------------------XXXXXX------------------------X------------------------------------------------------------------------------------------------oooo-----o------------------------------------------E------------------------X--------------------------------------------------------------------------------E-------------------XXSS--------------------------oooo--------------------------------------------------------------ES----SS---------------------------------------------------------------------------------------------------------------------------------------S-----------------S----------------------------------------------------------------------------XX---------------------------------------------------------<>-------------------------------------
------------------------------XXX-XXX-XXXX-XX---------------------------------------XXXXX------------------------------------------XXXX--------------------------------------------------------------------------------------------------XXX---------------------------------------------------------------------------------------------SS----------------------------------S--E-SS------------SS---------------------XXX------------XXXXX-------------------------------------------------------------------------------------------E------------------------------------------------------------------------------------------SS------------------------------------------------------------------------------------------------------------------------------------XXX-----------------------------------------------------------XX--------------------------------------------------------------------------------E------------------------------------------------------------------------------------------EX---------------------------------------------------------------------------------S----------------XXXX--------------------------------------------------------------------------------------S--------S--E-SS-------------------------------------------------------------------------------------------------------------------------------------S-S----------------S------------------------------------------------oo--------------------------------------------------------------------------------------[]-------------------------------------
------------------------------------------------------------------------------------------------------------------------------E-E--XX-X--------------------E-----------X-------------------------E----------------------------------------------------------QQSSSSSS--------------------XXX------------------SSSSSSS---------------------SS-----XSSSQS---------------------ESS----S---E--o---??-SS---EE--------------XXXXX--S--------------------------E------------------------E--------------------------------S-------------------<>-------E------------------------------E---------------------------------------------------------X----E------------------oo----------E--S--------------SSS----------------------E-------------------------------------oS--------XXXS--S-------------------------------------------------------XXX--oo---------------------------------------------------------------------------<>------------E------------------oo--------------------------------------------------------<>X--------------------------------------------------------------------------------SS--------------XXXXXX--------------------------------------------------------------------------------E-----S--------S----SS-------E--S--SS----------------------o-----------S-SQS---------------------XXX-SQSS--------E-----S---S---------------------------------SoS-----------ooooS--Qoo-E--------------------E-------------------------------E--X------------------XX---------------------------------------S----S--E----[]----------------------------------E--
---------SQS-------------------------------------------------------E-------SSSSSSS------------------------------------------------XXX-----------SSS---S---<>----------XX---------------S--------<>---oo--------XX--X----------------------------------X-----------------S----X----------S--E-----------------------------------XX-XX--------o--X---------------E--S-------------SSS--<>------?--SS--SSSSoo----------XXXXXX-----------------oo---------<>------------QQQ-----S----XX-X-------Q-----------X--X-------------------------[]-----E<>---QQ--------Q------S--------<>---ESSS--------------S----------------------------------XX---<>-----------------------------<>-----E--------------------ESS------------<>---QQ----------------------X--XX-------------XXXXXX---------------------XXXXXX-------------------------------XXX---------------------------------QQQ----------------------XXX---------------E--[]-----E-----<>---------------------------------------------QQQ------------------------<>--[]X-ooQ-----------X-----SS-----QQ--Q-Q--------X------------Q---S?S-----------E------S------S?S-----XXXXXX---------X---------------------------------------Q-------<>----E-Q-------------<>-----SS-------SSS-SSS--S---<>---------X-X-----E--Q---------Q--QQQQ-----------------------------XX--------------<>------------------------------------------ESSS------X-----------SSS->-------------------<>------------------S-----------<>-----------XXX------------------------------EQQQQ--QQQQ-------QQQ----SS----XX---------------------S-----------<>--
---------------------------XX-------------------------------------<>--------------------------------------------------------------XXX---------------------[]--E------XXX------------------------[]------------XXX--XX----------------XXX-?--------------------------------E--X--XX--------<>---E-----------------------------XXXX-XXX-------E--X--------------<>----X----------------[]------------EE--------------XXXXXXX-----------------------E----[]----------------------E--X--XX----------------XXX--XX--------XX--------------[]----<>[]-----------------------------[]-------------------------------------------------------XXX---[]-------------------------<>--[]----<>-------------------<>--------------[]-------------------------XXXX-XXX-----------XXXXXXX---------X-----------------------------------------------XXXX---------------------------------------------------------XXXX--------------<>--[]----<>-----[]------------------------------------------------------------------E-----[]X-[]X------------XX-XX--E-------X---------------X-----------------------E-----<>-------------------XXXXXXXX--------XX---E---E-----------------XX--------------------[]------------------E-[]----<>---------------------[]--------EX-X-----------------------------------------------------XXX--------------[]--------------------------------------------------XXX---------------X-----------XXX-----[]---------------------------XX-[]-------------------------------------------------------------------E----E--XX--XX--------------------E-Q---X--[]--
---------------------------XX-------------------------------------[]--------------------------------------------------------------XXX---------------------[]-<>--<>-XXXX------------------------[]-----------XXXX--XXX----------------------------------XXXX-----------------X--XXX-------[]--<>------<>--------------------XXXXX--XXX---------X--------------[]----X----------------[]---------------------------XXXXXXXX---------X------------------[]-------------------------X--XXX---------------XXX--XXX------XXX--------------[]----[]-------------------------------[]-------------X-------------------------------X-X------XXXX---[]-------------------------[]--[]----[]-------------------[]--------------[]-------------------------XXXX-XXX----------XXXXXXXX--------XX-----------------------------------------------XXXX---------------<>-------------------------<>------------XXXXX--------------[]--[]----[]-----[]-----------------------------------------------------------------<>-----[]X-XXX-----------EXX-XX------E---X-----------X---X-X--------------------<>-----[]------------------XXXXXXXXX-------XXX--<>--<>--------------------X------------------[]-----------------<>-[]----[]---------------------[]-------XXX-X----------------------------------------------------XXXX--------------[]-------------------------------------------------XXXX---------------X-------------------[]--------------------------XXX-[]---------------XXXX-------------------<>-------------------------------E---XX----XX-----------------<>----X---[]--
----------------------E-E--XX-------------------------------E-EE--[]---------------------------E-------------E---------------E----XXX--------E-E-------E--[]-[]--[]XXXXX------E-E------------E--[]--E-------XXXXX--XXXX------------------------------------------------------X--XXXX------[]--[]----E-[]------------E------XXXXXX-XXXXX--------X---------E----[]----X--X----E--E-E---[]----------------X---------XXXXXXXXX---EE---XX------------------[]-------E-------------E---X--XXXX-------EE----XXXX--XXXXE---XXXX----EE--------[]----[]------------EE--------E-----E--[]-------------X-E-------------X---EE-E----E-E-X-XX----XXXXXE--[]----E-E------------------[]--[]----[]-------------------[]-----------E--[]-------------EE-E--------XXX--XXX---------XXXXXXXXX--S----XXX-----------------------------------------------XXXX--------EE-E---[]-------------------EE-E--[]-----------XXXXXX-EE-E-------E-[]--[]----[]--E--[]---------E-----------XX----------------------------------E--E----[]-----[]XXXXX-----------XXX-XXS--------XX-----------X-E-X--X-------------------[]-----[]------------E----XXXXXXXXXX---E--XXXX--[]--[]--------------------X------EE-E--------[]-----------E-E---[]-[]----[]--------EE--------E--[]-------X-X-X-------------------------------E-----E-E--E--------XXXXX--------------[]--------------------------EE-E-----------E------XXXXXE-X--X---E-----X-------------------[]--------------E--------EE-XXX-[]------XXXXXXXXXX----------------------[]-----------E-----------------------XX?---XE-E---------------[]ooE-X-X-[]--
X--XXXXXXXXXX----XXXXXXXXXXXX-----X-XXXXXXX-XXXXX--XXXXXXXXXXXXXXXXXXXXXXXXXXXXXXXXXXXXXXXXXXXXXXXXXXXXXXXXX-XXX----X-XXXXXXX--XXXXXXXXXXXXXXXXXXXXXXXXXXXXXXXXX-XXXXXXXXXXXXXXXXXXXXXXXXXXXXXXXXXXXXXXXXXXXXXXXX-XXXXXXXXXXXX-XXXX------XXX----XXXXXXX-----XXXXXXXXXXXXXXXXXXXXXXXXXXXXXXXXXXXXXXXXXXXXXXXXXXXXXXXXXXXXXXXXXXXXXXXXXXXXXXXXXXXXXXXXXXXXXXXXXXXXXXXXXXXXXXXXXXXXXXXXXXXXXXXXXXXXXXXXXXXXXXXXXXXXXXXXXXXXXXXXXXXXXXXX------XXXXXXXXXXXXXXX-XXXXXXXXXXXXXXXXXXXXXX-X--XXXXXXXXXXXXXXXXXXXXXXXXXXXXXXXXXX-XXXXXXXXXXXXXXXXXXXXXXXXXXXXXXXXXXXXXXXXXXXXXXXXXXXXXXXXXXXXXXXXXXXXXXXXXXXXXXXXXXXXXXXXXXXXXXXXXXXXXXXXXXXXXXXXXXXXXXXXXXXXXXXX---XXXXXXXXXXXXXXX-XXXXXXXXXXXXXXXXXX----XXXXXXXXXXXXXXXXXXXXXXXXXXXXXXXXXXXXXXXXXXXXXXXXXXX--XXXXXXXXXXXXXXXXXXXXXXX-XXXXXXXXX-XXXXXXXX-------------XX--XXXXXXXXXXXXXXXXXXXXXXXXXXXXXXXXXXXXXXXXXXXXXXXXXXXXXXXXXXXXXXXXXXXXXXXXXXXXXXXXXXXXXXXXXXXXXXXXXXXXXXXXXXXXXXXXXXXXXXXXXXXXXXXXXXXXXXXXXXXXXX--XXXXXXXXXXXXXXXXXXXXXX--XXXXXXXXXXXXXXXXXXXXXXXXXXXXXXXXXXXXXXXXXX-XXXXXXXXXXXXXXXXXXXXXXXXXX-XXXXXXXXXXXXX-XXXXXXXXXXXXXXXXXXXXXXXXXXXXXXXXXXXXXXXXXXXXXXXXXXXXXXXXXXXXXXXXXXXXXXXX--XXXXX-----X--XXXXXXXXXXXXXXXXXXXXXXXX-XXXXXXXXXXXXXXXXXXXXXXXXXXXXXXXXXXXXXXXXXXXXXXXXXXXXXX-XX-XXXXXXXXXXXXXXXXXXXXXXXXXXXXXXXXXXXXXXXXXXXXXXXXXXXXXXXXXXXXXXXXXXXXXXXXXXXXXXXXXXXXXXXXX---XXXXXXXXXXX--XXXXXXXXXXXXXXXXXXXXXXXXXXXXXXXXXXXXXXXXXXXX----XXXXXXXXXXXXXX---XX-XXXXXXXXXXXXXXXXXXXXXXX--------------------------XXXXXXXXXXXXXXXXXXXXXXXXXXXXXXX-XXXXXXXX-XX--XXXXXXXXXXXXXXXXXXXXXXXXXXXXXXXXXXXXXXX