-----------------------------------------------------------------------------------------------------------------------------------------------------------------------------------------------------------------------------------------------------------------------------------------------------------------------------------------------------------------------------------------------------------------------------------------------------------------------------------------------------------------------------------------------------------------------------------------------------------------------------------------------------------------------------------------------------------------------------------------------------------------------------------------------E------------------------------------------------------------------------------------------------------------------------------------------------------------------------------------------------------------------------------------------------------------------------------------------------------------------------------------------------------------------------------------------------------------------------------------------------------------------------------------------------------------------------------------------------------------------------------------------------------------------------------------------------------------------------------------------------------------------------------------------------------------------------
------------------------------------------------------------------------------------------------------------------------------------------------------------------------------------------------------------------------------------------------------------------------------------------------------------------------------------------------------------------------------------------------------------------------------------------------------------------------------------------------------------------------------------------------------------------------------------------------------------------------------------------------------------------------------------------------------------------------------------------------------------------------------------------------------------------------------------------------------------------------------------------------------------------------------------------------------------------------------------------------------------------------------------------------------------------------------------------------------------------------------------------------------------------------------------------------------------------------------------------------------------------------------------------------------------------------------------------------------------------------------------------------------------------------------------------------------------------------------------------------------------------------------------------------------------------------
------------------------------------------------------------------------------------SSSSSSSSSSSSSSSSSSSSSSSSSSS----------------------------------------------------------------------------------------------------------------------------------------------SSSSSSSSSSSSSSSSSSSSSSSSSSS----------------------------------------------------------------------------------------------------------------------------------------------------------------------------------------------------------------------------------------------------------------------------------------------------------------------------------------------------------------------------------------------ooo------------------------------------------------------------------------------------------------------------oo-----------------------------------------------------------------------------------------------------------------------------------------------------------------------------------------------------------------------------------------------------------------------------------------------------------------------------------------------------------------------------------------------------------------------------------------------------------------------------------------------------SSSSSSSSSSSSSSSSSSSSSSSSSSSS--------------------------------------------------------------------------------------------------------------------------------------------------------------------------------------------------------------------------------
--------------------------------------------------------------------------------------------------------------------------------------------------Q----------------------------------------------------------------------------------------------------------SSSSSSSSSSSSSSSSSSSSSSSSSSS-----------------------------------------------------------------------------------------------------------------------------------------------------------------------------------------------------------------------------------------------------------------------------------------------o-------S----------o---------------------------------------------------------------------------XXXX-----------------------------------------------------------------------------------------------o-------------X-------------------------------------------------------------------------------------------------------------------------------------------------------------------------------------------------------------------------------------------------------------------------------------------------------------------------------o-----------------------------------------------------------------------------------------------------------------------------------------------------------------------SSSS-------SSS------S------------------------------------------------------------------------------------------------------------------------------------------------------------------------------------------------------------------------------------
--------------------------------------------------------------------------------------------------------------------------------------------------------------------------------------------------------------------E---------------------------------------XSSSSSSSSSSSSSSSSSSSSSSSSSSS------------------------------------------------------------------------------------------------------------------------------------------------------------------------------------------------------------------------------------------------------------------------------------------------------------------------------------------------------------------------------------oo--oo-----------------------------------------------------------------------------------------------------------o------------------------------------------------------oo--oo---------------------------------------------------------------Eooo-----------?----------------------------------------------------------------------------------------------------------------------------------E-----------------------------------------------------------------------------------------------------------------------------------------------------------------------------------------------------------------------------------SSSS--E---SSSS--------------------------------------------------------------------------------------------------------------------------------------------------------------------------------------------------------------------------XXXXX------------
----------------SS-----SSSSS------------------------------------------------------------------------------------SSSS----?QSQS---------------------------XXo------?-------S---SS--------------SSSS----?SSS--------SSSQSSS------SS--------S-----------------XoSSSSSSSSSSSSSSSSSSSSSSSSSSSS----S-----?SSS---------------------------------SS-----ES------------------------------SSSS--------SQSS---?------E?SSS-------------oo-----------------------------------------------------S----SS--------------------------------------------------------------------------------------------XX--------------------------------SQS----------------------------E--------------o---------------------------Q-----------------SXSSX-----------------------SSSSS------------------------------------S----XXX----------------------------------------------SSSS------------------------------------------------------------------------XXXXX------S------------------------------------------------SS--------------------------------SQQS--------------------S--------------------------SS-----------------SSSSSS-----------E---------SSQ--------SSSSSS----------------SSSS-----------------------------------------------SSSS-SSSSSSS-S-------------------S-----------------------S------------Q-------------------------S--------SS-----------------SSSSS-----------SS-----S-------?----------------X--------SSS--S-----------------------------------SSS---------Q---------------------------Q--------------------------------S---Q----SSSSSSSSSS----------------------------------
------------------------------------------------------------------------------------------------------------------------------------------------------------------------E---------------------------------------------------------------------------------XX---S-----------------------------------------------------------------------------<>S----------------------------------------------------------------------------------XX--------------------------------------------------------------------------------------------------------------------------------------------------------o---o--------------------------------oooo---------------<>--o---------------------------------------------------------------------------------------------------------------------------------------------------------------------E------------------------------oS---------------------------------------------------------------------------------------------------------E------------------------------------------------------------------------------------------------------------------------------------<>---------------------------------------------------------------------------------------------------------------------------------------------------------------------------------------------SS-------SS-------------------------------------------------------------------------------------------------------------------------------------------------------------------------------------------------------------------------------------------------
--------------------------------------------------XSS--------------------------------------------------------------------------------------------------------------------------------------E------------------------------------------------------------XXXX-SSS--E--------------------------------------------------------------------------[]S-------------------------------------------------------------------------------oooo----------------------------------------------------------------------------------------------------------------------------------------------------X-------ooo---------------------------------------XXS--------[]-XXX----------------------------------XXXX-------------------------------------------------------------------------------------------------o------o-------------------------------------------------------------------------------------------------------------------------------------------------------------XXXX---------X-S-----------------------------------------------------------------------------------------------------------------------[]---------------------------------------------------------------------------------------------------------------------------------------------------------------------------------------------S--------SS----------------------------------------------------------------XXXX----------------------------------------------------------------------------------------------------------------XX-----------------------------------------------------------
---------E--------------SSSS---------------------XXX---------------<>-------------E---------------------------oo------------------------E---XX--------------------------SS-------------E--<>-SQ---------------------------------------------------------XXXX---S----EEE----?---oooo-o-------------------------------------------ooo----------[]S--SSSSS--------E--SSSS-----------------------------------SSSSS--------------------------SS-----------------------S-------------------S--------------------------------------------------------XX-So--------------------------------------------------o---------E---------------E---------XXX--------[---------------XX-----------------------------------o----------------------------------------------------------------------------------------------------------------------------------------------------S-SQ-------S---------------------------------------------------XX------------------------SSS------------------------XXXSoo-----------------------------------------oo-----------E--------------------------------------------------------------[]------o-------------------------------------------------o-----------------------------------------------X---------------E-------------------------o-------------------------------o----------SE-------S---------------------------E-----------SQ---------------------------X--------------------E---SSSS---------------oo---------------------------E-----------------oo----o--------------XXX--------------------------------------------------------oo-
---E----<>----E---------------------------------XXXX---------------[]-------E----<>---E----------------------o-------Q--QSQS-----------<>---S---------------XXX--SSS--------SSS-------<>--[]-----------------Q--Q--S--Q-QS----------------------------XXXXXXSSSSSSSSSSSSSS-??SSSSSS--SS-------Q-----S------------------------<>--------------[]S--------------<>----------------SS------Q--Q--Q--QQQ-----------------XXXXX---SSS-----------------------------------------------E--S------------------------E-----------X---------------------XXX----------------S--S---------E--------------XX----------------<>------S-S----E<>-----E---XXX-S-----SXXS----------------------XXX--------------------------------------QQQ---S------E--------SS---------E--------------------------XX-----XXS--SSS-------X-------QQ--------------------------------S?SXXX-----------------------XX-------------------------------------------XXXX---E-Q--Q----------------------------------------XXX---E--------------------------------SSS------------------<>---------------------<>------QQ-------------------QQQ-------SS[]---E---SSSS--------SS--SS-------XX--X------------------------------X-------------------EXX--S----------XXQQQQ----------<>---------------------<>------------------QQQ------------------------SSS-----X------SS-------------------<>---E--S------------o---------X-----------------QQQ--S-------<>---------------------------------SSSSS------------<>------------QSQS---------------------XXXX------QQ--Q-Q--Q--Q-----------X------XXX----------E--------
--<>----[]---<>-------------X------------------XXXXX---------------[]------<>----[]--XXXXX---XXXX--------------------------------------[]----------E----------------------------------[]--[]-----------------------------------X---------------------EXXXXXXSSSSSSSSSSSSSS---SS-----------------------E----------------------[]--------------[]S--------------[]--------------------------------------------------------------------------------------------------------------<>--------------------------<>--------XX-X-----XXX-?-----------XXX----------------------------<>----XXXXX----------E------------[]-----------E<>[]----<>--XXXX-------------E-----X--------------------------o---------------------------------------<>-----------E--------------XXX-?-------------------------------E--X--XX-----------------------------------------------------------------------------E-----------------------------------XXXXX------------------E-<>--------------------------XXXX----------------------------EXX--------------------------[]------E--------E-----[]---------------------------------------[]--<>------------E--------------XXX--XX-----------------------------X------------------<>XX--XX--------XXX--------------[]---------------------[]---------------------------------------------------EXX----------------E----------[]--<>------------------------XX--X-----X---------------------[]---------------------------SS---------------E-----[]--------E---------------------------XXXXX-----------------------------XX-------------E----<>--------
--[]----[]---[]-------------X-----------------XXXXXX---------------[]------[]----[]----------------------------------------------------[]---------<>----------------------------------[]--[]-----------------------------------X--------------------XXXXXXXXSSSSSSSSSSSSSS---S-----------------------------------------------[]-------------X[]S--------------[]-------------------------------------------------------------------------------------E------------------------[]--------------------------[]-------XXX-X--------------------XXXX------------------------X---[]--XXXXX-------------------------[]----------<>[][]----[]--XXXX------------<>---X-X-----------------------------XXX----------------------------------[]-------------------X---------------------------------------------X--XXX---------------------------------------------------------------------------<>----------------------------------XXXXXX--------------<>-<>-[]-------------------------XXXXX--------------------------EXXXX--------------------------[]-----<>-------<>-----[]---------------------------------------[]--[]--------------------------XXXX--XXX---------X------------------X--------X---------[]XX--XXX------XXXX--------------[]-----------E---------[]--------------------------------------------------XXXX---------------------------<---[]-----------------------XXX--XX----X-X-------------------[]-------------------------------------------<>-----[]-------<>--------------------------XXXXXX----------------------------XXX------------<><>--[]--------
--[]----[]---[]-------E-----X-------E--------XXXXXXX-----------EE--[]------[]----[]----------------------------------------------------[]---------[]---------------------EE--------E--[]--[]------------------------------E----X----------------E--XXXXXXXXXSSSSSSSSSSSSSSoooSSE--------------------------------------E--E---[]------------XX[]S--------------[]--------------------------------------XX---------------------------------------------X---------------------E--[]------------------EE-E----[]-E----XXXX-X-------------------XXXXX------------EE----EE-EE-X---[]--XXX---------------------------[]----------[][][]----[]--XXXX-------E----[]-----X-----------------------SSSSS--------------------------------------[]---E---------------X-------------------E-------------------------X--XXXX---------------------------------------------------SSS--------------------[]------------------E--------------XXXXXXX--------------[]-[]-[]---------------------E--XXXXXX----------E-----E---------XXXXX-----EE-------------------[]-----[]-------[]-----[]---------EE-E----E-------E-EE-------E--[]--[]-----E-----------EE------XXXXX--XXXX-------XX------------E-EE--X--------X---EE-E--[]XX--XXXX----XXXXXE-------------[]---------------E--E--[]--------------------------------------------------XXXX--------------------EE-E-------[]----------------------XXXX--XXXX--X-X-------------------[]-------------------------------------------[]-----[]-------[]-------------------------XXXXXXX---------------------------XXXX------------[][]--[]--------
XXXXXXXXXXXXXXXXXXXXXXXXXXXX----XXXXXXXXXXXXXXXXXXXXXXXXX---XXXXXXXXXXXXXXXXXXXXXXXX-------XX-----XXXXXXXXXXXX-XX-XXXXXXXXXXXXXXXXXXXXXXXXXXXXXXXXXXXX-XXXXX-----XXXX---XXXXXXXXXXXXXXXXX-XXXXXXXX-XXXXXXXXXXXXXXXXXXXXXXXXXXXXX----XXXXXXXXXXXXXXXXXXXXXXXXXXXXXXXXXXXXXXXXXXXXXXXXXXXXXXXXXXXXXXXXXXXXXXXXXXXXXXXXXXXXXXXXXXXXXXXXXXXXXXXXXXXXXXXXXXXXXXXXXXXXXXXXXXXXXX--XXXXXXXXXXXXXXXXXXXXXXXXXXXXXXXXXXXXXXXX---------XXXXXXXXXX-XX-XX-XXXXX--XXXXXXXXXXXXXXXXXXXXXXXXXXXXXXXXXXXXXXXXXXXXXXXXXXXXXXXXXXXXXXXX---XXXX-----XXXX--XXXXXXXX----XXXXXXXXXXXXXXXXXXXXXXXXXXXXXX----------XXXXXXXXX-X-XX---XXXXXXXXXXXXXXXXXXXXXXXXXXXXXXX------XXXXXXXXXXXXX-X--XX--XX---------XXXX-------XSS-XXXXXXXX---XXXXXXXXXXXXXX---XXXXXXXXXXXXXXXXXXXXXXXX---XXXXXX-----XXXXXXXXXXXXXXXXXX-XXXX-----XXXXX-XX--XXXXXXXXXXXX--XXXXXX----XXXXXXX-XXXXXXXXXXXXXXXXXXXXX-------XXXX--XXXXXXXXX-XXXXXXX-XX---------XXXXXXXX-X----XXXXXXXXX--XXXXXXXXXXXXXXXXXXXXXXXXXXXXXX--X--X-X-XX--X-XXXXXX--------XXXXXXXXXXXXXXXXXXXXXXXXXXXXXXXXXXXXXXXXXXXXXXXXXXXXXXXXXXXXXXXXXXXXXXXXXXXXXXXX-XXXXXXXXXXXXXXXXXXXXXXXXX---XXXXXXXXXXXXXXXXXXXXXXXXXXXXXXXXXXXXXXXXX--XXXXXXXXXXXXXXXXXXXXXXXXXXXXXXXXXXXXXXXXXXXXXXXXXXXXXXXXXXXXXXXXXXXXXXXXXXXXXXXXXX-XXXXXXXXXXX--XXXXXXXXXXXXXXXXXXXXXXXXXXXXXXXXXXXXXXXXXXXXXXXXXXXXXXXXXXXXXXXXXXXXXXXXXXXX--XXXXXXXXXXXXXXXXXXXXXXXXXXXXXXXXXXXXXXXXXXXXXXXXXXXXXXXXXXXXXXXXXXXXXXXXXXXXXXXXXXXXXXXX--XXXXXXXXXX---XXXX----XXXXXXXXXXXXXXXXXXXXXXXXXXXXXXXXXXXX---XXX---XXXXX-XXXXXXXX-XXXX--XXXXXXXXXXXXXXXXXXXXXXXXXX-XXXXXX-----XXXXX-XXXXX-----