--------------------------------------------------------------------------------------------E---------------------------------------------------------------------------------------------------------------------------------------------------------------------------------------------------------------------------------------------------------------------------------------------------------------------------------------------------------------------------------------------------------------------------------------------------------------------------------------------------------------------------------------------------------------------------------------------------------------------------------------------------------------------------------------------------------------------------------------------------------------------------------------------------------------------------------------------------------------------------------------------------------------------------------------------------------------------------------------------------------------------------------------------------------------------------------------------------------------------------------------------------------------------------------------------------------------------------------------------------------------------------------------------------------------------------------------------------------------------------------------------------------------------------------------------------------------------------
------------------------------------------------------------------------------------------------------------------------------------------------------------------------------------------------------------------------------------------------------------------------------------------------------------------------------------------------------------------------------------------------------------------------------------------------------------------------------------------------------------------------------------------------------------------------------------------------------------------------------------------------------------------------------------------------------------------------------------------------------------------------------------------------------------------------------------------------------------------------------------------------------------------------------------------------------------------------------------------------------------------------------------------------------------------------------------------------------------------------------------------------------------------------------------------------------------------------------------------------------------------------------------------------------------------------------------------------------------------------------------------------------------------------------------------------------------------------------------------------------------------------------------------------------------------------
------------------------------------------------------------------------------------------------------------------------------------------------------------------------------------------------------------------------------------------------------------------------------------------------------------------------------------------------------------------------------------------------------------oo---------------------------------------oo-------------------------------------------------------------------------------------------------------------------------------------------------------------------------------------------------------------------------------------------------------------------------------------------------------------------------------------------------------------------------ooo---------------------------------------------------------------------------------------------------------------ooo------------------------------------------------------------------------------------------------------------------------------------------------------------------------------------------------------------------------------------------------------------------------------------------------------------------------------------------------------------oo------------------------------------------------------------------------------------------------------------------------------------------------------------------------------------------------------------------------------------S-S--------------
--------------------------------------------------------------------------------------------------------------E--------------------------------------------------------------------------------------------------------------------------------------------------------------------------------------------------------------------------------------------------------------------------------------------XXX----------------------------------------------------------------------------------------------------------------------------------------------------------------------------------------------------------------?--------------------------------------------oo---------------------------------------------------o-----------------------------------------------------------------------------------------------XX----------------------------------------------------------------------------------------------------oo----------XXXX---------------------------------------------------------------------------------------------------------------------------------------------------------------------------------------------------------------------------------------------------------------------------------------------------------------------------------------------------------------E--E------------------------------------------------------------------------------------------------------------------------------------------------------------------------------------------------------------------------o----------------------
--------------------------------------------------------------------------------------XX-----------------------------------------------------------------------------------------------------------------E------------------------------------------------oo--------------------------------------------------------------------------------------------------------------------------------------------------------------------------------------------------------------------------------------------------------------------------------------------------------------------------------------------------------------------------------------------------------------------------------------------------------------------------------------------------------------E---------X---E---------------------------o-----------------------E------------------------------Eooo------------------------------------------------------------------------------------------------------------------------------------------------------------------------------------------------------------------------------------------------oo------------------oo-------------------------------------------------------------------------------------------------------------------------------oooo-------------oooo-----------XXXXXX--------------------------------------------------oo--oo-------------------------------------------------------------------ooo------------------------------------------------------------------------------------X---ES--E-------------------
SS------------------------SS----------------------------Q---QQSSS--------------SSSSS-----XXX------XXXX----XXX-------------XXX----ooo------------------------------------------------------SSSSS---------SQS-SS?-------E------?-------o--XXX-------oo--------SS----------XXoo----ooo-------Q------------------------------------SSS-------------------------------------------------------------------------------------------------S----------------------------------------SS--SSS--------------------SSS---------E----S---------------------------SSS--------E--------?-----------------------------------SS-------------------------S------------XX-----------------------XXXX-----o---------Q--------------SSSSSSSSS-----?SSS-------SS-------SSSSS--SS?S-------------SQSSSSS-------S?SSS------SSSSS--?---------XX--X-XX---------XXX-----SS---QS--------------XX--------XXXXX----------oo-------------------S-S----------------SSS---SXX----------------------------------SSSSS---------------------------------------------SSS---SS--------------------------------------------------------------------XX---------XXXX---XXoo------------------------------------------------------SS-------------------------------------------------------------------------------------------XXXX------XX----XXXXX----------------------------------------SSSS---------------o--------------------------------------------------------------------------------------------?SSSS--------------SS----------------------SSSS-----S-----SSSSSSSSSSS---------SSS--S-------------------
--------------------------------------------------------------------------------------------------------------------XXX----------------------------------------------------------------------------------------------<>------------X-----------------------------------------------XXX----------------------------------------------------------------------------------------------------------------------------------------------------------------------------------------------------------------------------<>--------------------<>-----XX-------------<>------------------------------------------------------------------------------------------------------XXXX------------------------------------------------------------------------------SS-------------------------------------------------------------------------XXXSS----S--------------------------------------------------------------------------------------------------------------------------------------------------------------------------------------------------------------------------------------------------------------------------------------o---------------------oo---------------------------------------------------------EE-o---------------------------------------------------------------------------------------------------------oooo------XX-----------------------------------------SS--------------------------o-------------------------S---------------------------------------------oooo-------------------------------------------------S---ES-------------------
----------------------------------------------------XXX--------------------------------------------------------------------------------------------------------------------------------------------------------------[]--------------------------------------------------------------------------------------------------------------------------------------------------------------------------------------------------------X---------------------X----------XX------------------------------------------------[]--------------------[]--------------------[]----------------------------------------------------------------------------------------------------------------------------------------------------------------------------------------SS-------------------------------------------------------------------------XXX---------------------------------------------------------------------------------------------------------------------------------------------XXXXX-------------------------------------------------------------------------------------------------o--------XS---------------------------------------------------E---------------------------------------------------------XXXXXXX-------------------------------------------------------X----------------------------X--o-----------------------------------------------------------------------------------------------------------------------------------------------------------------------------------------------------------------------------SSS----S-------------------
---------------E----------XX---------------------------X---------------------------------------------------------------------------XXX-----------------------------E-------------------------E------S----------------[]------------------------------QQ----------------------------------------------------------------------------------------------------------------XX-----------------------------------------------------XSS-------------------XX----------S-------------------------------------------------[]--o-S---------------[---------------------[]------------E----------------------------o--------------oooo------------Q---------------------------QSS----------------XXXX-------------------------------------------------------------SS--------------------EE-------------------------------------------------XXXXX------SS-----------------SSSSS---------------------------------SQSQS---------------------XS--------------------Q---------------------------------------------------------------S-------------------------Xoo----o------------------------------------------XXX-oo-------------XXXXX-----------SSS---------------<>----------XX-----------------------------------------S--------------------------ESS------------------------E----------XX-------------------------------------E---------E--------SSSSSS--------------XX------X---oS----------XSS--Q-----------------------------------SSSSS------------XXX-----------------------------E---------E------------------------------------------------------So??---------------------
-S------------<>----------XXXX-------------o------------Q--E?QQQQ------Q------QQQ---XX-----XXXX--------------XXX--------XXXXXXXXX---------------------------------<>---------------XXXXXXXX-SSSS--------QQQ-----S----[]---E--------------------XX----------------------XXX--XXXX--XXXXX-QQQQ-----------------------X---QQQQ----S------E---E--SS-----------------------XXXX---------EEE---------------X--QQ-------------------XXX------------------XXXXX-------------------------S---------X-----Q-Q---SQS--------X[]-------E-------S----XXS-------------SS----XXSSSS-------<>--X----------------------------oS--------E---------------SS---E-------X--------------------------X-S----------------------E-XX----SSSSSSS----------S?S----XXX-XXX----------SSSS-------XE----S--SSSSS------S?S---------------SQSS--------XXXX--------XXXXX------SS--S?SSS-------------------------XXX-----XXX-------------------------------------XX-----?SS----S----------------------o--o---------------------------------------------------------S-------------XX-----------------X----------------------S----X--XXXX--------XXXXXX---------XXXX--XXX------------------[]-----------------------------------------------------------------------------------X----------------------<>----------XX-------XXXXX------------------------<>--------<>-----------------------------------X------o--------XXX---------------ooooo---E-----------------------XXX-------------------QQQQ--QQQ---S----E<>---Q----<>----------S----E----------QQQQ------------SS------X---SSS---------S---E--------
--------------[]--------XXXX-------------------------------------------------------------------------------------------------------------------------------E------[]--------------XXXXX----------------------------------<>----------------------XX----------------------------------------------------------------X-----------------<>--<>----------<>--------------XXXXX------XXXXXXXXXXXX--------X-----------------------XXXX-SXX------------XXXXXXX-----------------------------------X--------------------XXX[]-XXX--<>-----------------------XXX---------------E-----[]--X---XXXXX------------------------E----<>-------------------<>--------------------------------------------------------X-<>-XX---------------------------XXXX-XXX------------------EXXX---X-E-EE------X--------------------------------------------XXXXXX---S--------------------------------S-------------------------------------------E------XXX----------------------------------------E-------------------XX-----------------------------------------------XXX----------------XX-----------------------------XXXXX--------------------------------------------------[]-------------------------------------------------XX--XX----------------o-XXXXXXXX--X----------------------[]--E-----XXXX------------------o-----o-----------[]--------[]----------------------------------XX--------------XXXX------------------------------------------------------------------------------------E<>[]--------[]------E------E<>--------------------------E------XX------------------<>--------
--------------[--------XXXXX-----------XXXXXX--X----XXXX-------------------------------o------------------------------------------------------------------<>------[]-------------XXXXXX--------Eo-Eo---------------------[]----------------------XXX---------------------------------------------------------------X-----------------[]--[]----------[]-------------XXXXX---------------------------XX---------------------XXXXX-SSS-----------XXXXXXXX-----------------------------------X-------------------XXXXXX--XQ--[]----------------------XXXX---SS---------<>-----[]--X-------------------------------<>----[]-------------------[]-------------------------------------------------------XX-[]-XXX-------------------------XXXXX-XXX---------o------XXXXXX---------------X-------------------------------------------XXXXXXX--------------------<>-----------------------------XXX-------------------------<>-----XXXX------------------------------------------------------------X-----------------------------------------------XXXX---------------XXX---------------------------XXXXXX---------------------------------------------------[]------------<>--------------------------------XXXXX------X----E-------XXXXXXXX-----X----------------------[]-<>----XXXXX-----------------XXX---XXXXX--------[]--------[]---------------------------------XXX-------------XXXXX----------------------------------------------------<>-----------------------------<>[][]-----X--[]-----<>-----<>[]------------------XX--X----------XX------------------[]--------
---EE-E-------X-------XXXXX---------------------------------EE------------E-----------XXX------------EE------X-----X------------------------------EE-E----[]------[]------------XXXXXXXX-SS-------XX-------E-------E-EEE-[]-E--E-----------------XX---SSSS---------ooo---------------------------------------------X-------E---------[]--[]-----E----[]--------EE-E-XXXXX---------------------------X---E--------------E---XXXXX-SSS----------XXXXXXXXX-------XX-------E-E--EE-E----------XX-----------------XXXXXXX--XS--[]---------------------XXX-----------E----[]-E-E-[]--X---------------------------E---[]----[]--------E----------[]------------------------------------------------------XXX-[]-XXX----------------E-------XXXXXX-XXX--------XXE-E--XXXXXXXE--------------X---------------------EE-------ooo---------XXXXXXXX--------------------[]--------------E-------------------S--S-----E-------E-----[]----XXXXX-------------------SSS--E-----------------------------------X-------------------------------EE-E-----------XXXXX--------------XXXX---SSS---------------------XXXXXX---------------------------------------------------[]------------[]----------------------------XXXXXXXXX-------------EE---XXXX----------X----------------------[]-[]---XXXXXX------o---X---------------------E---[]--------[]--------------------------------XXXX------------XXXXXX--SS-------------------------------E----------------[]---------------------------E-[][][]--------[]---E-[]-----[][]-----------------XXXE-X----------XX------------------[]----E---
XXXXXXXXXXXXXXXXXXXXXXXXXXXX----------------------------XXXXXXXXXXXX-XXXXXXXXXXXXXXX--------------XXXXXX-X-X---------------------------------XXXXXXXXXXXXXXXXXXXXXXXXXXXXXXXXXXXXXXXXX---S---XXXXXXXXXXXXXXXXXXXXXXXXXXX-XXXXXXX----XXX-XXXXXXXXXXXXX----XX---XXXXXXXX------------------XXXXXXXXXXXX---XXXXXXXXX----XXXXXXXXXXXX---XXXXXXXXXXXXXXXXXXXXXXXXXXXXXXXXXXXXXX--X-XXX-------------XXXXX-----XXXXXXXXXXXXXXXXXXXXXXXX--SSXXXXXXXXXXXXXXXXXXXXX-XXXXXXX--XXXXXXXXXXXXXXXXXXXXXXXXXXX-XXXXXXXXXXXXXXXXXXX-XX-XXXXXXXXXXXXXXXXXXXXXXXXXXXXXXXXX-----XXXXXXXXXXXXXXXXXXXXX-X-------X-XX-XX-X----XXXXXXXXXXXXXXXXXXXXXXXXXXXXXXXXXXXXXXXXXXXX----------XXXXX---XXXX-XX-X-XX----XXX---------XXXXXXXXXXXXXXXXXXXXXXXXXXXXXXXXXXXXXXXXXXXXXXXXXXXXXXXXXXXXXXXXXXXXXXXXXXXXXXXXX--XX-XXXXXXXXXXXXXXXXXXXXXXXXXX--XXX-----XXXXXXXXXXXXXXXXXXXXXXXXXXXXXXXXXXX-XXXXXXXXXXXXXXXXX------------------X--XXXXXXXXXXXXXXXXXXXXXXXXXXXXXXXXXXXXXXXXXX----------XXXXXXXXXXXXXXXXXX-----XXXXXXXXXXXXXXXXXXXXXXXXXXXXXXXXXXXXX----XXXXXXXXXE----XXXXXXXXXXXXXXXX--XXXXXXXXXX-----XXXXXXXXXXXXXXXXXXXXXXXXXXXXXXXXX----------------------------XXXXXXXXXXXXXXXXXXXXXXXXXXXXXXXXXXXXXXXXXXXXXXXXXXXXXXXXXXXX------XX------------XXXXXXXXXXXX-----------XXXXXXXXXXXXXXXXXXXXXXXXXXXXXXXXXXXXX--X-XXX---------------------XXXXXXXXXXXXXXXXXXXXXXXXXXXXXXXXXXXXXXX----------XXXXXXXXXXXXXXXXXXXXXXXX-------XXXXXXXXXXXXXXXXXXXXXXXXXXXXXXXXXXXXXXXXXX--XXXXXXXXXXXXX---XXXXXXXXXXXXXXXXXXXXXXXXXXXXX--XXXXXXXXXXXXXXXXXXXXXXXXXX---XXXXXXXXXXXXXXXXXXXXXXXX--XXXXXXXXXXXXXXXXXXXXXXXXXX