------------------------------------------------------------------------------------------------------------------------------------------------------------------------------------------------------------------------------------------------------------------------------------------------------------------------------------------------------------------------------------------------------------------------------------------------------------------------------------------------------------------------------------------------------------------------------------------------------------------------------------------------------------------------------------------------------------------------------------------------------------------------------------------------------------------------------------------------------------------------------------------------------------------------------------------------------------------------------------------------------------------------------------------------------------------------------------------------------------------------------------------------------------------------------------------------------------------------------------------------------------------------------------------------------------------------------------------------------------------------------------------------------------------------------------------------------------------------------------------------------------------------------------------------------------------------
------------------------------------------------------------------------------------------------------------------------------------------------------------------------------------------------------------------------------------------------------------------------------------------------------------------------------------------------------------------------------------------------------------------------------------------------------------------------------------------------------------------------------------------------------------------------------------------------------------------------------------------------------------------------------------------------------------------------------------------------------------------------------------------------------------------------------------------------------------------------------------------------------------------------------------------------------------------------------------------------------------------------------------------------------------------------------------------------------------------------------------------------------------------------------------------------------------------------------------------------------------------------------------------------------------------------------------------------------------------------------------------------------------------------------------------------------------------------------------------------------------------------------------------------------------------------
SSSSSSSSSSSSSSSSSSSSSSSSSSSS------------------------------------------------------------------------------------------------------------------------------------------------------------------------SSSSSSSSSSSSSSSSSSSSSSSSSSSSSSSSSSSSSSSSSSSSSSSSSSSSSSSS--------------------------------------------------------SSSSSSSSSSSSSSSSSSSSSSSSSSSSSSSSSSSSSSSSSSSSSSSSSSSSSSSS------------------------------------------------------------------------------------SSSSSSS--------------S------------------------------------------------------------------------------------------------------------ooo-------SSSSSSSSSSSSSSSSSSSSSSSSSSSS--------------------------------------------------------------------------------------------------------------------------------------------------------------------------------------------------------------------------------------------------------------------------------------------------------------------------------------------------------------------------------------------------------------------------------------------------------------------------------------------------------------------------------------------------------------------------------------------------------------------------------------------------------------------------------------------------------------------------------------------------------------------------o-----------------------------------------------------------------------------------------------------------------------------------------------------
-----------------------------------------------------------------------------------------------------------------------------------------------------------------------------------------------------------------------SSSSS--SS--SSSS-----?oS--SSSSSS--SSSS----------------------------------------------------------------------------------------------------------------------------------------------------------------------------------------------------------------------------------------------------------------------------------------------------------------------------E--E------XXXX--------------------------------------------------------------------------------------------------------------------------------------------------------oo----------------------------------------------------o--o-------------------------------------------o-----------------------------------------oo--------------------------------------------------XX--------------------------------------------------------------------------------------o--------------------------------------------------------------------------------------------------------------------------------------------------------------------------------------------------------------------------------------------------------------------------------------------------------------------------------------------oo-------------------------------------------------------o--------------------------------------------------------------------------------------------------------
------------------------------------------------------------------------------------------------------------------------------------------------E---------------------------------------------------------------------SSSSSS--SS--SSSS--E---SS--SSSSSS--SSSS----------------------------------------------------------------------------------------------------------------XX-----------------------------------------------o----------------------------------------------------------------------------------------------------------E----------------------------------------------XXXXXXX----------------------------------------------------------------------oo-------------------o-----------------------------------------------------------------------------------------------------E---------------------------------------------------------------------------------------------------------------------------------------------------------E--------------------------------------------------------------------------------------------------------------------------------------------------------------------XXX----------------------------------------------------------------------------------------------------------------------------------------------------------------------------------------------------------------------------------E----E-------------------------------oo---------------------------------------------------------------------------------------------------------------------------oooo--------E----------------------
--------------------------------------X---------------------------------------------------------------XXX----------------------SSS--------SS---SQS----SSQS-------------------------SS--SSSSS------SS-ooo------o-oo-------SSS--SS---S----S-----------SS---SSS----------------------------------------------------SSSS------------------------------------------------------SS-XXXX-------------oo----------------------XX--------------------------------------XX--------------SSS---------------SS----?SSS---X--------------SS--------SSQS---?----SS--SSS------------------SSSSS------------------------------------------------------------------------------------XX------------------XXX-------------------------XXX----------------------------SSSSSE--------XXX------o-------------------SQS----------------?SSS-------------------------S---SS??--SS---S---SSS----------------------XXX------------------XXX-----SXXX----------------------------SSSSS---?-----------------------------QS------------------------------------XXX-----EQQQ------oo---XXXX-----o-------------------------S-------SSS----------------------------SSSSQ--S------SSSSSSSSSSS--------------S------------------SQQ------------------S-------------------Q---------------SQQS-----------------SSSS--------------------------------------------------------------------E--S----------SQQ?SSQS----SSSS--------------??SSS---XXXX----------------QSSS-------XXX----S-SS-----------------------------------------------------------------------------------XXXX-------SSS-?S?SSS--------------
------------------------------------------------XSS------------------------------------X--------------XXX----------------------------------------------------------------------------------------------------------------SSS--SS-------SSS----------SS--------------------------------------------------------------------------------------------------------------------SS--------------------------XXo----------------------------------------------------XXX--------------------------------------------XX-----------------------------------------------------------------------------------oooo---------------------------------------------------------------------------------------o----------------oo----XXXX--------------------------------E---XXXX-----------------------------------------------------------------------------------SS--------------------------------------XSS--------oo-----------------------------------------------------------------------------ES--------------------------------------E--------------------X--XX----------------XXXXXX-----------------------------------------------------------------------------------------------------------------------------------------------------------------------------------------------------------------------------------------------------------------------<>---------------------------------------------------------------------------------------------------------------------------------------oooo------------XX----------------XX----------o-----------------------------
-----------------------------------------o-----XX-------------------------------X-------------------X-XXX-----------------------------------------------------------------------------------------------------SSSS-------SSS--SS--------S-----------SS-------------------------E--------------------------------------------------------------------------------------E---SS--------------------------o-----------------------------------------------------XXXX-------------------------------------------XXX--------------------------------------------------------------------------------------------------------------------------------------------------------XXX----------------------------------------XXXXXX---------------------------------------------------------------------------------------------------------------------------SS-------------------------------------XX---------------------------------------------------E-----------------------------------X--S-Q----------------------------E------<>-------------------------------------------------------------------------------------------------------------------------------------------------------------------E--------------E------------------------------------------------------------------------------o----------------------------------------------------[]-----------E-------------------------------------------------------------------------------------------------------------------------------------------XX---------------------------XXX----------------------------
------------ooooo------------------------------XSS-------------o----------E---XXX---------------------XXS-----------------------------E-----S-----------------------------------------------------E-------S------S---SoooSoS--SX---ooooSS-----oooooooS------SSSSS------------E<>-----E-----------------------E--------------SSSS-------------------------SS----oo---------SS-----------o------------------------------XX-----------------------------------XXXXX--E--------------------------------------X-XXX---------------------------------------------------------------------------------E----------------------ooo----------------------------------------oo--------XXXX----------------------------------XXXXXX-------------------E-------E----S------------------------------<>------------------------SSSSSS---------------SSSSSSS?-ooo-SS-------------S------oo---oo---------XXX--------------SS----------------------------------<>----------------------------------XX--S-----------------E------------E------[]--------------------------------------XXXXX------------------E------------------------E------------E-----------------------------------------------------E-----------------------<>----------------------------------------------------------------------------------------------------------E---------E--o-----------[]-------E--<>-----------------------------------------------------------------------------------------S-S--------------S---------------------------S----XX----------------------------------------------------------
----------E-------------E?------------SSS-----XXX------------------------<>----XX------------------XX-XX-------------------Q-----S---<>-----S--QQQ--QQ-QQ------------------------------SS---E----<>----XXXX----------SS-SSSS--SS---SSSSSS-------SSSSSS--SSS----------------E<>[]----<>-------E--------E-----<>------SS----------------------------------------------------SS-------<>-----XXX------------------XXX-----------------------------<>---S-----XXX-XX-<>---SS----SSQS---------S?S---QQQQ----XXX-XXX---------X----------------QQQ-------------------E----------S------------XXXXX---<>--------------------------------------------------------------------XX-----------------XX------------------------XXXXXX------------------<>------<>---Q-------------XXXXX-------------[]---QQQQQ---QQQ---------o------------------------------SSSSSS-----------------------------------XXXX--------X--------------XXXXXXSSSSS----S--------E--[]--------------Q---------------X--XXX--SS-----SSE-------<>---E----<>---------[]-----------XX-SSSS------------XXXXX-------------------------<>-----E------?----------<>-----------SSSS--SSSSS-------SSSS--SSSSSS---------------S--S-----<>-------S?S-E--------E--[]---------------QQ---QQQQ---------------SSS------X--X-------------Q------Q--SSS--------------------------E<>-----E-E<>----<>-------SXXX--E--<>--[]-?----SQS-QQQ--Q--Q---E-------------XX---------------------QQQ-----------XXXXXXX--XS---------------S---------E--S------------------------E-XX-------XXXXXXX--------------------SQS--Q------------------
---------<>----------------------------------XXXX--SS--------------------[]--XXXX----------------XXXXXXX--S--------------------------[]--------------------------------------------<>------<>----[]---XXXXX--XX-----------------------------------------------------------<>[][]----[]------<>-------<>-----[]----------X----------------------------------------------------------[]--XX-------------------XXXX---------------XXXXX-----------[]--------XXXX-XX-[]------------------------------------XXX-XXX--------XX-------------------------------------<>-------------------------------[]-----------------------------XXX-----------E-----------E--------------------------------------------------------XXXXXXX------------------[]------[]-----------------------------------[]-------------------------------------------------------------------------------------------E-XXXXXX-------XX-------------------------------------<>--[]---------------------------E--X-XXXX----S--------------[]--<>----[]--X------[]------------------------------------------------------------[]----<>-----------------[]----------E------------------------------------------------------[]--E----------------<>--[]------------------------------------------------X--XX--------------------------------------------------<>[]----<><>[]----[]------------<>--[]--XX---------------------<>-----E-------------------------------------------------------------------------------<>----------E---------------<>-XX--------------XXXX---o------------------------------------
---------[]-----------------XXXX------------XXXXX------------------------[]--XXXX-----------------X-XXXXX----------------------------[]--------------------------------------------[]------[]----[]--XXXXXX--XX--------------------------XXX------------------------------[][][]----[]------[]-------[]-----[]---------XXX---------------------------------------------------------[]---XX-------------------------XXXX-------X----------------[]-------XXXXX-XX-[]-----------------------------------XXXX-XXX-------XXX---------------------------X---------[]----------------X--------------[]------------------------------------------<>----------<>---------------XXXXX-----------------------------------XXXXXXXX------------------[]------[]-----------------------------------[]---------------------------------------------------------------X---X----------------------<>-XXXXXX------XXX-------------------------------------[]--[]----------X---------------X-X-XXXXXX---SS--------------[]--[]----[]--X------[]----------------------XX------------o-----------------------[]----[]-----------------[]-----------------------------------------------------------------[]-<>----------------[]--[]------------------------------------------------X--XXX------------------------------------------<>-----[][]----[][][]----[]------------[]--[]-------------------------[]----<>-------------------------------------------------------------------------------[]---------<>---------------[]-XXX-------------------XXXXX---------------------------------
---EE-EE-[]--------EE----------------------XXXXXX------------------------[]--XXXX-------------------XXXX----E--------E--E------EE-E--[]---------------------------E-E-E-----EE-E---[]------[]-E--[]-XXXXXXX---X---------E-E--E------------XX-------E--E------E--------E-E-[][][]----[]------[]-------[]-EE--[]----------X------------------------E-----------------------E------E--[]--XXX--------------------------------------------------E--[]------XXXXXX-XX-[]---------E-----E-EE-----E---------XXXX--XXX---E--XXXX----------------------E----X---EE-E--[]-E-E------------X--------------[]------------------------------------------[]----------[]-----------------------------------------------------E--XXXXXXX---------E--------[]--E---[]-----------o-o---------------------[]------------------E-E--------------------------------E---------X-E-XXEXE------------------[]XXXXXXX-----XXXX----------------------------------E--[]--[]----------X--E-------E---XXXX-XXXXXX---SS-E-E----------[]--[]----[]--X------[]-----------------------------------XXX------------EE--------[]----[]-----------------[]----------E-----E---------------------------------E--E-E---E-E---[]-[]---EE-----------[]--[]------------------E-------------EEE-----E-------X--XXXX-------XX-----EE-E---------------E-------[]-----[][]----[][][]----[]------------[]--[]--------E----------------[]----[]-Eoo---------------------EE---------------------------------------E------E-EE--[]---------[]----------EE-E-[]-XXX--------------------------------E--------------------E---
XXXXXXXXXXXXXXXXXXXXXXXXXXXX---------XXXXXXXXXXXXXXX-XXX---XXX---XXXXX-XXXXXXXXXX--XXX---XXXXXXXXXXXXXXXXXX---XEXXXXXXXXXXXXXXXXXXXXXXXXXXXXXXXXXXXXXXXXXXXXXXXXXXXXXXXXXXXXXXXXXXXXXXXXXXXXXXXXXXXXXXXXXX---XXXXXXXXXXXXXXXXXXXXXXXXXXXXXXXXXXXXXXXXXXXXXXXXXXXXXXXXXXXXXXXXXXXXXXXXXXXXXXXXXXXXXXXXXXXXXXXXXXXXXXXXXXXXXXX----XXXXXXXXXXXXXXXXXXXXXXXXXXXXXXXXXXXXXXXXXXXXXXX--XXXXXXX------------XXXX-------------------------------XXXXXXXXXXXXXXXXXXXXX--XXXXXXXXXXXXXXXXXXXXXXXXXXXXXXXXXXXXXXXXXXX--XXXXXXXXXXXXXXXXXXXXXXXXXXXXXXXXXXXXXXXXXXXXXXXXXXXXXXXXXXXXXXXXXXXXXXXXXXXXXXXXXXXXXXXXXXXX-----XXX--XXXX----X-------XXXXXXXXXXXXX-X----XXXXXXXXXXXX------------------------------------XXXXXXX-XXXXXXXXXXXXXXXXXXXXXXXXXXXXXXXXXXXXXXXXXXXXXXXXXXXXX---------------XXXXXXXXXXXXXXXXXXXXXXXXXXXXXXXXXXXXXXXXXXXXXXXXX-------XXXXXXXXXXXXXXXXXXXXXXXXXXXXXXXXXX-XX---XXXXXXXXXX--XXXXXXXXXXXXXXXXXXXXXX-------XXXX---XXXXXXXXXXXXXXXXXXXXXXXXXXXXXXXXXXXXXXXXXXXXXXXXXXX--SXXXXXXXXXXXXXXXXXXXXXXXXXXXXXXXXXXXXXXXX-----XXXX-------------------------------------XXXXXXXXXXXXXXXXXXXXXXXXXXXXXXXXXXXXXXXXXXXXXXXXXXXXXXXXXXXXXXXXXXXXXXXXXXXXXXXXXXXXXXXXXXXXXXXXXXXXXXXXXXXXXXXXXXXXXXXXXXXXXXXXX-XXXXXXXXXXXXXXXXXXXXXXXXXXXXXXXXXXXXXXXXXXXXXXXXXXXXXXXXXXXXXXXXXXXXXXXXXXXXXXXXXXXXXXXXXXXXXXXXXXXXXXXXXXXXXXXXXXXXXXXXXXXXXXXXXXXXXXXXXXXXXXXX-XXXXXXXXXXXXXXXXXXXXXXXXXXXXXXXXXXXXX----XXXXX------XXX-XXXXXXXXXXXXXXXXXXX--------X-X---XXXXXXXXXXXXXXXXXXXXXXXXXXXXXXXXXXXXX-XXXXXXXXXXXXXXX---XXXXX-----------------------XXXXXXXXXXXX-X---XXXXXXXXXXX